;class;xmin;ymin;xmax;ymax;file;defect_x_center;defect_y_center;defect_width;defect_height;image_width;image_height;width_ratio;height_ratio;path;category_codes
0;missing_hole;2459;1274;2530;1329;.\data\pcb_defects_kaggle\Annotations\Missing_hole\01_missing_hole_01;0.8221819380355966;0.8206179066834804;71;55;3034;1586;0.023401450230718525;0.03467843631778058;.\data\pcb_defects_kaggle\images/Missing_hole/01_missing_hole_01.jpg;1
1;missing_hole;1613;334;1679;396;.\data\pcb_defects_kaggle\Annotations\Missing_hole\01_missing_hole_01;0.5425181278839816;0.23013871374527112;66;62;3034;1586;0.021753460777851022;0.03909205548549811;.\data\pcb_defects_kaggle\images/Missing_hole/01_missing_hole_01.jpg;1
2;missing_hole;1726;794;1797;854;.\data\pcb_defects_kaggle\Annotations\Missing_hole\01_missing_hole_01;0.5805866842452209;0.519546027742749;71;60;3034;1586;0.023401450230718525;0.03783102143757881;.\data\pcb_defects_kaggle\images/Missing_hole/01_missing_hole_01.jpg;1
3;missing_hole;2584;232;2650;298;.\data\pcb_defects_kaggle\Annotations\Missing_hole\01_missing_hole_02;0.8625576796308504;0.16708701134930642;66;66;3034;1586;0.021753460777851022;0.0416141235813367;.\data\pcb_defects_kaggle\images/Missing_hole/01_missing_hole_02.jpg;1
4;missing_hole;2366;803;2406;860;.\data\pcb_defects_kaggle\Annotations\Missing_hole\01_missing_hole_02;0.7864205669083718;0.5242749054224464;40;57;3034;1586;0.013183915622940013;0.035939470365699874;.\data\pcb_defects_kaggle\images/Missing_hole/01_missing_hole_02.jpg;1
5;missing_hole;1506;802;1559;856;.\data\pcb_defects_kaggle\Annotations\Missing_hole\01_missing_hole_02;0.5051087673038892;0.5226986128625473;53;54;3034;1586;0.01746868820039552;0.034047919293820936;.\data\pcb_defects_kaggle\images/Missing_hole/01_missing_hole_02.jpg;1
6;missing_hole;2651;487;2700;531;.\data\pcb_defects_kaggle\Annotations\Missing_hole\01_missing_hole_03;0.8818391562294001;0.3209331651954603;49;44;3034;1586;0.016150296638101518;0.027742749054224466;.\data\pcb_defects_kaggle\images/Missing_hole/01_missing_hole_03.jpg;1
7;missing_hole;1342;749;1393;796;.\data\pcb_defects_kaggle\Annotations\Missing_hole\01_missing_hole_03;0.4507251153592617;0.48707440100882726;51;47;3034;1586;0.016809492419248517;0.029634300126103404;.\data\pcb_defects_kaggle\images/Missing_hole/01_missing_hole_03.jpg;1
8;missing_hole;2082;582;2135;620;.\data\pcb_defects_kaggle\Annotations\Missing_hole\01_missing_hole_03;0.6949571522742255;0.37894073139974777;53;38;3034;1586;0.01746868820039552;0.02395964691046658;.\data\pcb_defects_kaggle\images/Missing_hole/01_missing_hole_03.jpg;1
9;missing_hole;1619;225;1673;278;.\data\pcb_defects_kaggle\Annotations\Missing_hole\01_missing_hole_04;0.5425181278839816;0.1585750315258512;54;53;3034;1586;0.017798286090969017;0.033417402269861285;.\data\pcb_defects_kaggle\images/Missing_hole/01_missing_hole_04.jpg;1
10;missing_hole;337;754;386;814;.\data\pcb_defects_kaggle\Annotations\Missing_hole\01_missing_hole_04;0.11914963744232036;0.4943253467843632;49;60;3034;1586;0.016150296638101518;0.03783102143757881;.\data\pcb_defects_kaggle\images/Missing_hole/01_missing_hole_04.jpg;1
11;missing_hole;217;1009;277;1067;.\data\pcb_defects_kaggle\Annotations\Missing_hole\01_missing_hole_04;0.08141067897165458;0.6544766708701135;60;58;3034;1586;0.01977587343441002;0.03656998738965952;.\data\pcb_defects_kaggle\images/Missing_hole/01_missing_hole_04.jpg;1
12;missing_hole;804;298;860;365;.\data\pcb_defects_kaggle\Annotations\Missing_hole\01_missing_hole_05;0.2742254449571523;0.20901639344262296;56;67;3034;1586;0.01845748187211602;0.04224464060529634;.\data\pcb_defects_kaggle\images/Missing_hole/01_missing_hole_05.jpg;1
13;missing_hole;279;294;353;374;.\data\pcb_defects_kaggle\Annotations\Missing_hole\01_missing_hole_05;0.1041529334212261;0.21059268600252207;74;80;3034;1586;0.024390243902439025;0.05044136191677175;.\data\pcb_defects_kaggle\images/Missing_hole/01_missing_hole_05.jpg;1
14;missing_hole;1068;1051;1110;1107;.\data\pcb_defects_kaggle\Annotations\Missing_hole\01_missing_hole_05;0.35893210283454186;0.680327868852459;42;56;3034;1586;0.013843111404087014;0.03530895334174023;.\data\pcb_defects_kaggle\images/Missing_hole/01_missing_hole_05.jpg;1
15;missing_hole;1613;392;1677;460;.\data\pcb_defects_kaggle\Annotations\Missing_hole\01_missing_hole_05;0.542188529993408;0.2686002522068096;64;68;3034;1586;0.02109426499670402;0.04287515762925599;.\data\pcb_defects_kaggle\images/Missing_hole/01_missing_hole_05.jpg;1
16;missing_hole;1446;480;1504;542;.\data\pcb_defects_kaggle\Annotations\Missing_hole\01_missing_hole_06;0.486156888595913;0.32219419924337955;58;62;3034;1586;0.01911667765326302;0.03909205548549811;.\data\pcb_defects_kaggle\images/Missing_hole/01_missing_hole_06.jpg;1
17;missing_hole;1326;1203;1386;1269;.\data\pcb_defects_kaggle\Annotations\Missing_hole\01_missing_hole_06;0.44693473961766644;0.7793190416141236;60;66;3034;1586;0.01977587343441002;0.0416141235813367;.\data\pcb_defects_kaggle\images/Missing_hole/01_missing_hole_06.jpg;1
18;missing_hole;2070;800;2140;860;.\data\pcb_defects_kaggle\Annotations\Missing_hole\01_missing_hole_06;0.6938035596572182;0.5233291298865069;70;60;3034;1586;0.023071852340145024;0.03783102143757881;.\data\pcb_defects_kaggle\images/Missing_hole/01_missing_hole_06.jpg;1
19;missing_hole;1737;340;1793;394;.\data\pcb_defects_kaggle\Annotations\Missing_hole\01_missing_hole_07;0.5817402768622281;0.23139974779319042;56;54;3034;1586;0.01845748187211602;0.034047919293820936;.\data\pcb_defects_kaggle\images/Missing_hole/01_missing_hole_07.jpg;1
20;missing_hole;1390;1042;1470;1122;.\data\pcb_defects_kaggle\Annotations\Missing_hole\01_missing_hole_07;0.4713249835201055;0.682219419924338;80;80;3034;1586;0.026367831245880026;0.05044136191677175;.\data\pcb_defects_kaggle\images/Missing_hole/01_missing_hole_07.jpg;1
21;missing_hole;2580;238;2648;294;.\data\pcb_defects_kaggle\Annotations\Missing_hole\01_missing_hole_07;0.8615688859591298;0.1677175283732661;68;56;3034;1586;0.02241265655899802;0.03530895334174023;.\data\pcb_defects_kaggle\images/Missing_hole/01_missing_hole_07.jpg;1
22;missing_hole;2757;700;2817;767;.\data\pcb_defects_kaggle\Annotations\Missing_hole\01_missing_hole_08;0.9185893210283455;0.462484237074401;60;67;3034;1586;0.01977587343441002;0.04224464060529634;.\data\pcb_defects_kaggle\images/Missing_hole/01_missing_hole_08.jpg;1
23;missing_hole;2637;1336;2700;1391;.\data\pcb_defects_kaggle\Annotations\Missing_hole\01_missing_hole_08;0.8795319709953856;0.8597099621689785;63;55;3034;1586;0.02076466710613052;0.03467843631778058;.\data\pcb_defects_kaggle\images/Missing_hole/01_missing_hole_08.jpg;1
24;missing_hole;482;1125;539;1183;.\data\pcb_defects_kaggle\Annotations\Missing_hole\01_missing_hole_08;0.1682597231377719;0.7276166456494325;57;58;3034;1586;0.018787079762689517;0.03656998738965952;.\data\pcb_defects_kaggle\images/Missing_hole/01_missing_hole_08.jpg;1
25;missing_hole;1222;620;1293;689;.\data\pcb_defects_kaggle\Annotations\Missing_hole\01_missing_hole_09;0.4144693473961767;0.4126733921815889;71;69;3034;1586;0.023401450230718525;0.043505674653215635;.\data\pcb_defects_kaggle\images/Missing_hole/01_missing_hole_09.jpg;1
26;missing_hole;482;1118;539;1180;.\data\pcb_defects_kaggle\Annotations\Missing_hole\01_missing_hole_09;0.1682597231377719;0.7244640605296343;57;62;3034;1586;0.018787079762689517;0.03909205548549811;.\data\pcb_defects_kaggle\images/Missing_hole/01_missing_hole_09.jpg;1
27;missing_hole;162;482;222;542;.\data\pcb_defects_kaggle\Annotations\Missing_hole\01_missing_hole_09;0.06328279499011207;0.3228247162673392;60;60;3034;1586;0.01977587343441002;0.03783102143757881;.\data\pcb_defects_kaggle\images/Missing_hole/01_missing_hole_09.jpg;1
28;missing_hole;1624;402;1673;454;.\data\pcb_defects_kaggle\Annotations\Missing_hole\01_missing_hole_10;0.5433421226104153;0.2698612862547289;49;52;3034;1586;0.016150296638101518;0.03278688524590164;.\data\pcb_defects_kaggle\images/Missing_hole/01_missing_hole_10.jpg;1
29;missing_hole;331;751;388;816;.\data\pcb_defects_kaggle\Annotations\Missing_hole\01_missing_hole_10;0.11849044166117337;0.49401008827238335;57;65;3034;1586;0.018787079762689517;0.040983606557377046;.\data\pcb_defects_kaggle\images/Missing_hole/01_missing_hole_10.jpg;1
30;missing_hole;866;623;915;682;.\data\pcb_defects_kaggle\Annotations\Missing_hole\01_missing_hole_10;0.293506921555702;0.4114123581336696;49;59;3034;1586;0.016150296638101518;0.03720050441361917;.\data\pcb_defects_kaggle\images/Missing_hole/01_missing_hole_10.jpg;1
31;missing_hole;2073;685;2146;752;.\data\pcb_defects_kaggle\Annotations\Missing_hole\01_missing_hole_11;0.6952867501647989;0.4530264817150063;73;67;3034;1586;0.024060646011865524;0.04224464060529634;.\data\pcb_defects_kaggle\images/Missing_hole/01_missing_hole_11.jpg;1
32;missing_hole;1500;736;1559;800;.\data\pcb_defects_kaggle\Annotations\Missing_hole\01_missing_hole_11;0.5041199736321688;0.4842370744010088;59;64;3034;1586;0.01944627554383652;0.0403530895334174;.\data\pcb_defects_kaggle\images/Missing_hole/01_missing_hole_11.jpg;1
33;missing_hole;482;843;562;916;.\data\pcb_defects_kaggle\Annotations\Missing_hole\01_missing_hole_11;0.17205009887936717;0.5545397225725095;80;73;3034;1586;0.026367831245880026;0.046027742749054225;.\data\pcb_defects_kaggle\images/Missing_hole/01_missing_hole_11.jpg;1
34;missing_hole;1062;1047;1117;1112;.\data\pcb_defects_kaggle\Annotations\Missing_hole\01_missing_hole_12;0.3590969017798286;0.6806431273644389;55;65;3034;1586;0.01812788398154252;0.040983606557377046;.\data\pcb_defects_kaggle\images/Missing_hole/01_missing_hole_12.jpg;1
35;missing_hole;2633;932;2702;989;.\data\pcb_defects_kaggle\Annotations\Missing_hole\01_missing_hole_12;0.8792023731048121;0.6056116015132409;69;57;3034;1586;0.022742254449571522;0.035939470365699874;.\data\pcb_defects_kaggle\images/Missing_hole/01_missing_hole_12.jpg;1
36;missing_hole;2460;1220;2528;1276;.\data\pcb_defects_kaggle\Annotations\Missing_hole\01_missing_hole_12;0.8220171390903098;0.7868852459016393;68;56;3034;1586;0.02241265655899802;0.03530895334174023;.\data\pcb_defects_kaggle\images/Missing_hole/01_missing_hole_12.jpg;1
37;missing_hole;1384;296;1460;362;.\data\pcb_defects_kaggle\Annotations\Missing_hole\01_missing_hole_13;0.46868820039551745;0.20744010088272383;76;66;3034;1586;0.025049439683586024;0.0416141235813367;.\data\pcb_defects_kaggle\images/Missing_hole/01_missing_hole_13.jpg;1
38;missing_hole;1340;738;1397;802;.\data\pcb_defects_kaggle\Annotations\Missing_hole\01_missing_hole_13;0.4510547132498352;0.4854981084489281;57;64;3034;1586;0.018787079762689517;0.0403530895334174;.\data\pcb_defects_kaggle\images/Missing_hole/01_missing_hole_13.jpg;1
39;missing_hole;708;620;768;683;.\data\pcb_defects_kaggle\Annotations\Missing_hole\01_missing_hole_13;0.24324324324324326;0.41078184110970994;60;63;3034;1586;0.01977587343441002;0.03972257250945776;.\data\pcb_defects_kaggle\images/Missing_hole/01_missing_hole_13.jpg;1
40;missing_hole;2295;640;2359;712;.\data\pcb_defects_kaggle\Annotations\Missing_hole\01_missing_hole_14;0.7669742913645353;0.4262295081967213;64;72;3034;1586;0.02109426499670402;0.04539722572509458;.\data\pcb_defects_kaggle\images/Missing_hole/01_missing_hole_14.jpg;1
41;missing_hole;159;751;220;812;.\data\pcb_defects_kaggle\Annotations\Missing_hole\01_missing_hole_14;0.06245880026367831;0.4927490542244641;61;61;3034;1586;0.02010547132498352;0.038461538461538464;.\data\pcb_defects_kaggle\images/Missing_hole/01_missing_hole_14.jpg;1
42;missing_hole;864;623;917;680;.\data\pcb_defects_kaggle\Annotations\Missing_hole\01_missing_hole_14;0.293506921555702;0.41078184110970994;53;57;3034;1586;0.01746868820039552;0.035939470365699874;.\data\pcb_defects_kaggle\images/Missing_hole/01_missing_hole_14.jpg;1
43;missing_hole;2075;1034;2139;1087;.\data\pcb_defects_kaggle\Annotations\Missing_hole\01_missing_hole_15;0.6944627554383652;0.6686633039092056;64;53;3034;1586;0.02109426499670402;0.033417402269861285;.\data\pcb_defects_kaggle\images/Missing_hole/01_missing_hole_15.jpg;1
44;missing_hole;2470;1105;2526;1158;.\data\pcb_defects_kaggle\Annotations\Missing_hole\01_missing_hole_15;0.8233355306526038;0.7134300126103404;56;53;3034;1586;0.01845748187211602;0.033417402269861285;.\data\pcb_defects_kaggle\images/Missing_hole/01_missing_hole_15.jpg;1
45;missing_hole;2077;514;2135;572;.\data\pcb_defects_kaggle\Annotations\Missing_hole\01_missing_hole_15;0.6941331575477917;0.34237074401008827;58;58;3034;1586;0.01911667765326302;0.03656998738965952;.\data\pcb_defects_kaggle\images/Missing_hole/01_missing_hole_15.jpg;1
46;missing_hole;1499;729;1559;794;.\data\pcb_defects_kaggle\Annotations\Missing_hole\01_missing_hole_16;0.503955174686882;0.4801387137452711;60;65;3034;1586;0.01977587343441002;0.040983606557377046;.\data\pcb_defects_kaggle\images/Missing_hole/01_missing_hole_16.jpg;1
47;missing_hole;644;720;702;783;.\data\pcb_defects_kaggle\Annotations\Missing_hole\01_missing_hole_16;0.2218193803559657;0.47383354350567464;58;63;3034;1586;0.01911667765326302;0.03972257250945776;.\data\pcb_defects_kaggle\images/Missing_hole/01_missing_hole_16.jpg;1
48;missing_hole;2517;698;2584;763;.\data\pcb_defects_kaggle\Annotations\Missing_hole\01_missing_hole_16;0.8406394199077126;0.46059268600252207;67;65;3034;1586;0.022083058668424523;0.040983606557377046;.\data\pcb_defects_kaggle\images/Missing_hole/01_missing_hole_16.jpg;1
49;missing_hole;917;292;984;369;.\data\pcb_defects_kaggle\Annotations\Missing_hole\01_missing_hole_17;0.3132827949901121;0.2083858764186633;67;77;3034;1586;0.022083058668424523;0.048549810844892814;.\data\pcb_defects_kaggle\images/Missing_hole/01_missing_hole_17.jpg;1
50;missing_hole;480;1123;539;1191;.\data\pcb_defects_kaggle\Annotations\Missing_hole\01_missing_hole_17;0.16793012524719841;0.7295081967213115;59;68;3034;1586;0.01944627554383652;0.04287515762925599;.\data\pcb_defects_kaggle\images/Missing_hole/01_missing_hole_17.jpg;1
51;missing_hole;1725;1083;1790;1147;.\data\pcb_defects_kaggle\Annotations\Missing_hole\01_missing_hole_17;0.5792682926829268;0.7030264817150063;65;64;3034;1586;0.02142386288727752;0.0403530895334174;.\data\pcb_defects_kaggle\images/Missing_hole/01_missing_hole_17.jpg;1
52;missing_hole;2188;914;2250;980;.\data\pcb_defects_kaggle\Annotations\Missing_hole\01_missing_hole_18;0.7313777191825972;0.5970996216897856;62;66;3034;1586;0.02043506921555702;0.0416141235813367;.\data\pcb_defects_kaggle\images/Missing_hole/01_missing_hole_18.jpg;1
53;missing_hole;1160;1200;1220;1254;.\data\pcb_defects_kaggle\Annotations\Missing_hole\01_missing_hole_18;0.3922214897824654;0.7736443883984867;60;54;3034;1586;0.01977587343441002;0.034047919293820936;.\data\pcb_defects_kaggle\images/Missing_hole/01_missing_hole_18.jpg;1
54;missing_hole;1731;1151;1791;1203;.\data\pcb_defects_kaggle\Annotations\Missing_hole\01_missing_hole_18;0.5804218852999341;0.7421185372005045;60;52;3034;1586;0.01977587343441002;0.03278688524590164;.\data\pcb_defects_kaggle\images/Missing_hole/01_missing_hole_18.jpg;1
55;missing_hole;1395;738;1450;803;.\data\pcb_defects_kaggle\Annotations\Missing_hole\01_missing_hole_19;0.4688529993408042;0.48581336696090793;55;65;3034;1586;0.01812788398154252;0.040983606557377046;.\data\pcb_defects_kaggle\images/Missing_hole/01_missing_hole_19.jpg;1
56;missing_hole;339;752;388;814;.\data\pcb_defects_kaggle\Annotations\Missing_hole\01_missing_hole_19;0.11980883322346737;0.4936948297604035;49;62;3034;1586;0.016150296638101518;0.03909205548549811;.\data\pcb_defects_kaggle\images/Missing_hole/01_missing_hole_19.jpg;1
57;missing_hole;168;572;228;638;.\data\pcb_defects_kaggle\Annotations\Missing_hole\01_missing_hole_19;0.06526038233355307;0.38146279949558637;60;66;3034;1586;0.01977587343441002;0.0416141235813367;.\data\pcb_defects_kaggle\images/Missing_hole/01_missing_hole_19.jpg;1
58;missing_hole;2635;1102;2695;1160;.\data\pcb_defects_kaggle\Annotations\Missing_hole\01_missing_hole_20;0.8783783783783784;0.7131147540983607;60;58;3034;1586;0.01977587343441002;0.03656998738965952;.\data\pcb_defects_kaggle\images/Missing_hole/01_missing_hole_20.jpg;1
59;missing_hole;228;574;275;629;.\data\pcb_defects_kaggle\Annotations\Missing_hole\01_missing_hole_20;0.08289386947923533;0.3792559899117276;47;55;3034;1586;0.015491100856954515;0.03467843631778058;.\data\pcb_defects_kaggle\images/Missing_hole/01_missing_hole_20.jpg;1
60;missing_hole;2528;227;2588;302;.\data\pcb_defects_kaggle\Annotations\Missing_hole\01_missing_hole_20;0.8431114040870138;0.16677175283732662;60;75;3034;1586;0.01977587343441002;0.04728877679697352;.\data\pcb_defects_kaggle\images/Missing_hole/01_missing_hole_20.jpg;1
61;missing_hole;2139;753;2189;824;.\data\pcb_defects_kaggle\Annotations\Missing_hole\04_missing_hole_01;0.7081151832460733;0.32000811688311687;50;71;3056;2464;0.016361256544502618;0.028814935064935064;.\data\pcb_defects_kaggle\images/Missing_hole/04_missing_hole_01.jpg;1
62;missing_hole;2117;1590;2171;1646;.\data\pcb_defects_kaggle\Annotations\Missing_hole\04_missing_hole_01;0.7015706806282722;0.6566558441558441;54;56;3056;2464;0.01767015706806283;0.022727272727272728;.\data\pcb_defects_kaggle\images/Missing_hole/04_missing_hole_01.jpg;1
63;missing_hole;1401;955;1464;1033;.\data\pcb_defects_kaggle\Annotations\Missing_hole\04_missing_hole_01;0.46875;0.4034090909090909;63;78;3056;2464;0.0206151832460733;0.03165584415584415;.\data\pcb_defects_kaggle\images/Missing_hole/04_missing_hole_01.jpg;1
64;missing_hole;1877;757;1930;815;.\data\pcb_defects_kaggle\Annotations\Missing_hole\04_missing_hole_02;0.6228730366492147;0.3189935064935065;53;58;3056;2464;0.017342931937172776;0.02353896103896104;.\data\pcb_defects_kaggle\images/Missing_hole/04_missing_hole_02.jpg;1
65;missing_hole;997;759;1055;817;.\data\pcb_defects_kaggle\Annotations\Missing_hole\04_missing_hole_02;0.3357329842931937;0.3198051948051948;58;58;3056;2464;0.018979057591623036;0.02353896103896104;.\data\pcb_defects_kaggle\images/Missing_hole/04_missing_hole_02.jpg;1
66;missing_hole;1228;1771;1284;1841;.\data\pcb_defects_kaggle\Annotations\Missing_hole\04_missing_hole_02;0.4109947643979058;0.7329545454545454;56;70;3056;2464;0.01832460732984293;0.028409090909090908;.\data\pcb_defects_kaggle\images/Missing_hole/04_missing_hole_02.jpg;1
67;missing_hole;2474;1581;2547;1650;.\data\pcb_defects_kaggle\Annotations\Missing_hole\04_missing_hole_03;0.8214986910994765;0.6556412337662337;73;69;3056;2464;0.023887434554973823;0.028003246753246752;.\data\pcb_defects_kaggle\images/Missing_hole/04_missing_hole_03.jpg;1
68;missing_hole;1279;1295;1351;1381;.\data\pcb_defects_kaggle\Annotations\Missing_hole\04_missing_hole_03;0.43030104712041883;0.5430194805194806;72;86;3056;2464;0.02356020942408377;0.0349025974025974;.\data\pcb_defects_kaggle\images/Missing_hole/04_missing_hole_03.jpg;1
69;missing_hole;711;1626;775;1713;.\data\pcb_defects_kaggle\Annotations\Missing_hole\04_missing_hole_03;0.2431282722513089;0.6775568181818182;64;87;3056;2464;0.020942408376963352;0.03530844155844156;.\data\pcb_defects_kaggle\images/Missing_hole/04_missing_hole_03.jpg;1
70;missing_hole;2113;1473;2186;1537;.\data\pcb_defects_kaggle\Annotations\Missing_hole\04_missing_hole_04;0.7033704188481675;0.6107954545454546;73;64;3056;2464;0.023887434554973823;0.025974025974025976;.\data\pcb_defects_kaggle\images/Missing_hole/04_missing_hole_04.jpg;1
71;missing_hole;2570;1366;2646;1457;.\data\pcb_defects_kaggle\Annotations\Missing_hole\04_missing_hole_04;0.8534031413612565;0.572849025974026;76;91;3056;2464;0.024869109947643978;0.036931818181818184;.\data\pcb_defects_kaggle\images/Missing_hole/04_missing_hole_04.jpg;1
72;missing_hole;2564;946;2621;1019;.\data\pcb_defects_kaggle\Annotations\Missing_hole\04_missing_hole_04;0.8483311518324608;0.39874188311688313;57;73;3056;2464;0.018651832460732983;0.029626623376623376;.\data\pcb_defects_kaggle\images/Missing_hole/04_missing_hole_04.jpg;1
73;missing_hole;1344;1093;1395;1151;.\data\pcb_defects_kaggle\Annotations\Missing_hole\04_missing_hole_05;0.4481348167539267;0.45535714285714285;51;58;3056;2464;0.01668848167539267;0.02353896103896104;.\data\pcb_defects_kaggle\images/Missing_hole/04_missing_hole_05.jpg;1
74;missing_hole;1817;859;1882;922;.\data\pcb_defects_kaggle\Annotations\Missing_hole\04_missing_hole_05;0.6052028795811518;0.3614042207792208;65;63;3056;2464;0.021269633507853405;0.02556818181818182;.\data\pcb_defects_kaggle\images/Missing_hole/04_missing_hole_05.jpg;1
75;missing_hole;1888;357;1946;417;.\data\pcb_defects_kaggle\Annotations\Missing_hole\04_missing_hole_05;0.6272905759162304;0.15706168831168832;58;60;3056;2464;0.018979057591623036;0.024350649350649352;.\data\pcb_defects_kaggle\images/Missing_hole/04_missing_hole_05.jpg;1
76;missing_hole;1173;621;1231;695;.\data\pcb_defects_kaggle\Annotations\Missing_hole\04_missing_hole_06;0.3933246073298429;0.26704545454545453;58;74;3056;2464;0.018979057591623036;0.030032467532467532;.\data\pcb_defects_kaggle\images/Missing_hole/04_missing_hole_06.jpg;1
77;missing_hole;1461;377;1519;442;.\data\pcb_defects_kaggle\Annotations\Missing_hole\04_missing_hole_06;0.487565445026178;0.16619318181818182;58;65;3056;2464;0.018979057591623036;0.026379870129870128;.\data\pcb_defects_kaggle\images/Missing_hole/04_missing_hole_06.jpg;1
78;missing_hole;2171;341;2239;419;.\data\pcb_defects_kaggle\Annotations\Missing_hole\04_missing_hole_06;0.7215314136125655;0.15422077922077923;68;78;3056;2464;0.02225130890052356;0.03165584415584415;.\data\pcb_defects_kaggle\images/Missing_hole/04_missing_hole_06.jpg;1
79;missing_hole;1744;964;1811;1031;.\data\pcb_defects_kaggle\Annotations\Missing_hole\04_missing_hole_07;0.581642670157068;0.40482954545454547;67;67;3056;2464;0.021924083769633507;0.02719155844155844;.\data\pcb_defects_kaggle\images/Missing_hole/04_missing_hole_07.jpg;1
80;missing_hole;1939;346;2011;419;.\data\pcb_defects_kaggle\Annotations\Missing_hole\04_missing_hole_07;0.6462696335078534;0.1552353896103896;72;73;3056;2464;0.02356020942408377;0.029626623376623376;.\data\pcb_defects_kaggle\images/Missing_hole/04_missing_hole_07.jpg;1
81;missing_hole;2617;339;2684;424;.\data\pcb_defects_kaggle\Annotations\Missing_hole\04_missing_hole_07;0.8673102094240838;0.15482954545454544;67;85;3056;2464;0.021924083769633507;0.03449675324675325;.\data\pcb_defects_kaggle\images/Missing_hole/04_missing_hole_07.jpg;1
82;missing_hole;1967;1177;2047;1253;.\data\pcb_defects_kaggle\Annotations\Missing_hole\04_missing_hole_08;0.6567408376963351;0.49310064935064934;80;76;3056;2464;0.02617801047120419;0.030844155844155844;.\data\pcb_defects_kaggle\images/Missing_hole/04_missing_hole_08.jpg;1
83;missing_hole;1344;1430;1402;1502;.\data\pcb_defects_kaggle\Annotations\Missing_hole\04_missing_hole_08;0.4492801047120419;0.5949675324675324;58;72;3056;2464;0.018979057591623036;0.02922077922077922;.\data\pcb_defects_kaggle\images/Missing_hole/04_missing_hole_08.jpg;1
84;missing_hole;1742;1428;1806;1504;.\data\pcb_defects_kaggle\Annotations\Missing_hole\04_missing_hole_08;0.5804973821989529;0.5949675324675324;64;76;3056;2464;0.020942408376963352;0.030844155844155844;.\data\pcb_defects_kaggle\images/Missing_hole/04_missing_hole_08.jpg;1
85;missing_hole;2488;1246;2581;1344;.\data\pcb_defects_kaggle\Annotations\Missing_hole\04_missing_hole_09;0.8293520942408377;0.5255681818181818;93;98;3056;2464;0.03043193717277487;0.03977272727272727;.\data\pcb_defects_kaggle\images/Missing_hole/04_missing_hole_09.jpg;1
86;missing_hole;1175;1308;1230;1381;.\data\pcb_defects_kaggle\Annotations\Missing_hole\04_missing_hole_09;0.393488219895288;0.5456574675324676;55;73;3056;2464;0.01799738219895288;0.029626623376623376;.\data\pcb_defects_kaggle\images/Missing_hole/04_missing_hole_09.jpg;1
87;missing_hole;715;1404;768;1481;.\data\pcb_defects_kaggle\Annotations\Missing_hole\04_missing_hole_09;0.24263743455497383;0.5854301948051948;53;77;3056;2464;0.017342931937172776;0.03125;.\data\pcb_defects_kaggle\images/Missing_hole/04_missing_hole_09.jpg;1
88;missing_hole;1122;844;1166;904;.\data\pcb_defects_kaggle\Annotations\Missing_hole\04_missing_hole_10;0.3743455497382199;0.3547077922077922;44;60;3056;2464;0.014397905759162303;0.024350649350649352;.\data\pcb_defects_kaggle\images/Missing_hole/04_missing_hole_10.jpg;1
89;missing_hole;1288;375;1341;439;.\data\pcb_defects_kaggle\Annotations\Missing_hole\04_missing_hole_10;0.43013743455497383;0.16517857142857142;53;64;3056;2464;0.017342931937172776;0.025974025974025976;.\data\pcb_defects_kaggle\images/Missing_hole/04_missing_hole_10.jpg;1
90;missing_hole;662;504;715;566;.\data\pcb_defects_kaggle\Annotations\Missing_hole\04_missing_hole_10;0.22529450261780104;0.2171266233766234;53;62;3056;2464;0.017342931937172776;0.025162337662337664;.\data\pcb_defects_kaggle\images/Missing_hole/04_missing_hole_10.jpg;1
91;missing_hole;1284;953;1350;1028;.\data\pcb_defects_kaggle\Annotations\Missing_hole\04_missing_hole_11;0.43095549738219896;0.40198863636363635;66;75;3056;2464;0.021596858638743454;0.030438311688311688;.\data\pcb_defects_kaggle\images/Missing_hole/04_missing_hole_11.jpg;1
92;missing_hole;1399;82;1461;137;.\data\pcb_defects_kaggle\Annotations\Missing_hole\04_missing_hole_11;0.46793193717277487;0.044439935064935064;62;55;3056;2464;0.020287958115183247;0.022321428571428572;.\data\pcb_defects_kaggle\images/Missing_hole/04_missing_hole_11.jpg;1
93;missing_hole;1391;251;1464;306;.\data\pcb_defects_kaggle\Annotations\Missing_hole\04_missing_hole_11;0.46711387434554974;0.11302759740259741;73;55;3056;2464;0.023887434554973823;0.022321428571428572;.\data\pcb_defects_kaggle\images/Missing_hole/04_missing_hole_11.jpg;1
94;missing_hole;1650;750;1721;826;.\data\pcb_defects_kaggle\Annotations\Missing_hole\04_missing_hole_12;0.5515379581151832;0.3198051948051948;71;76;3056;2464;0.023232984293193717;0.030844155844155844;.\data\pcb_defects_kaggle\images/Missing_hole/04_missing_hole_12.jpg;1
95;missing_hole;326;802;402;864;.\data\pcb_defects_kaggle\Annotations\Missing_hole\04_missing_hole_12;0.11910994764397906;0.3380681818181818;76;62;3056;2464;0.024869109947643978;0.025162337662337664;.\data\pcb_defects_kaggle\images/Missing_hole/04_missing_hole_12.jpg;1
96;missing_hole;177;1144;250;1213;.\data\pcb_defects_kaggle\Annotations\Missing_hole\04_missing_hole_12;0.06986256544502618;0.47828733766233766;73;69;3056;2464;0.023887434554973823;0.028003246753246752;.\data\pcb_defects_kaggle\images/Missing_hole/04_missing_hole_12.jpg;1
97;missing_hole;711;1922;773;1986;.\data\pcb_defects_kaggle\Annotations\Missing_hole\04_missing_hole_13;0.24280104712041886;0.7930194805194806;62;64;3056;2464;0.020287958115183247;0.025974025974025976;.\data\pcb_defects_kaggle\images/Missing_hole/04_missing_hole_13.jpg;1
98;missing_hole;659;1410;713;1473;.\data\pcb_defects_kaggle\Annotations\Missing_hole\04_missing_hole_13;0.2244764397905759;0.5850243506493507;54;63;3056;2464;0.01767015706806283;0.02556818181818182;.\data\pcb_defects_kaggle\images/Missing_hole/04_missing_hole_13.jpg;1
99;missing_hole;177;453;255;524;.\data\pcb_defects_kaggle\Annotations\Missing_hole\04_missing_hole_13;0.07068062827225131;0.19825487012987014;78;71;3056;2464;0.025523560209424083;0.028814935064935064;.\data\pcb_defects_kaggle\images/Missing_hole/04_missing_hole_13.jpg;1
100;missing_hole;1121;1924;1173;1988;.\data\pcb_defects_kaggle\Annotations\Missing_hole\04_missing_hole_14;0.37532722513089006;0.7938311688311688;52;64;3056;2464;0.017015706806282723;0.025974025974025976;.\data\pcb_defects_kaggle\images/Missing_hole/04_missing_hole_14.jpg;1
101;missing_hole;891;1404;944;1475;.\data\pcb_defects_kaggle\Annotations\Missing_hole\04_missing_hole_14;0.30022905759162305;0.5842126623376623;53;71;3056;2464;0.017342931937172776;0.028814935064935064;.\data\pcb_defects_kaggle\images/Missing_hole/04_missing_hole_14.jpg;1
102;missing_hole;337;1142;393;1208;.\data\pcb_defects_kaggle\Annotations\Missing_hole\04_missing_hole_14;0.11943717277486911;0.47686688311688313;56;66;3056;2464;0.01832460732984293;0.026785714285714284;.\data\pcb_defects_kaggle\images/Missing_hole/04_missing_hole_14.jpg;1
103;missing_hole;1286;1541;1348;1597;.\data\pcb_defects_kaggle\Annotations\Missing_hole\04_missing_hole_15;0.43095549738219896;0.6367694805194806;62;56;3056;2464;0.020287958115183247;0.022727272727272728;.\data\pcb_defects_kaggle\images/Missing_hole/04_missing_hole_15.jpg;1
104;missing_hole;1688;1653;1748;1715;.\data\pcb_defects_kaggle\Annotations\Missing_hole\04_missing_hole_15;0.56217277486911;0.6834415584415584;60;62;3056;2464;0.01963350785340314;0.025162337662337664;.\data\pcb_defects_kaggle\images/Missing_hole/04_missing_hole_15.jpg;1
105;missing_hole;657;957;715;1039;.\data\pcb_defects_kaggle\Annotations\Missing_hole\04_missing_hole_15;0.2244764397905759;0.4050324675324675;58;82;3056;2464;0.018979057591623036;0.033279220779220776;.\data\pcb_defects_kaggle\images/Missing_hole/04_missing_hole_15.jpg;1
106;missing_hole;1177;762;1230;815;.\data\pcb_defects_kaggle\Annotations\Missing_hole\04_missing_hole_16;0.393815445026178;0.32000811688311687;53;53;3056;2464;0.017342931937172776;0.02150974025974026;.\data\pcb_defects_kaggle\images/Missing_hole/04_missing_hole_16.jpg;1
107;missing_hole;1231;1537;1288;1599;.\data\pcb_defects_kaggle\Annotations\Missing_hole\04_missing_hole_16;0.41214005235602097;0.6363636363636364;57;62;3056;2464;0.018651832460732983;0.025162337662337664;.\data\pcb_defects_kaggle\images/Missing_hole/04_missing_hole_16.jpg;1
108;missing_hole;830;502;886;566;.\data\pcb_defects_kaggle\Annotations\Missing_hole\04_missing_hole_16;0.28075916230366493;0.21672077922077923;56;64;3056;2464;0.01832460732984293;0.025974025974025976;.\data\pcb_defects_kaggle\images/Missing_hole/04_missing_hole_16.jpg;1
109;missing_hole;1348;1304;1401;1373;.\data\pcb_defects_kaggle\Annotations\Missing_hole\04_missing_hole_17;0.44977094240837695;0.5432224025974026;53;69;3056;2464;0.017342931937172776;0.028003246753246752;.\data\pcb_defects_kaggle\images/Missing_hole/04_missing_hole_17.jpg;1
110;missing_hole;651;1410;715;1468;.\data\pcb_defects_kaggle\Annotations\Missing_hole\04_missing_hole_17;0.22349476439790575;0.5840097402597403;64;58;3056;2464;0.020942408376963352;0.02353896103896104;.\data\pcb_defects_kaggle\images/Missing_hole/04_missing_hole_17.jpg;1
111;missing_hole;1515;1655;1575;1715;.\data\pcb_defects_kaggle\Annotations\Missing_hole\04_missing_hole_17;0.5055628272251309;0.6838474025974026;60;60;3056;2464;0.01963350785340314;0.024350649350649352;.\data\pcb_defects_kaggle\images/Missing_hole/04_missing_hole_17.jpg;1
112;missing_hole;1342;1431;1401;1502;.\data\pcb_defects_kaggle\Annotations\Missing_hole\04_missing_hole_18;0.4487892670157068;0.5951704545454546;59;71;3056;2464;0.01930628272251309;0.028814935064935064;.\data\pcb_defects_kaggle\images/Missing_hole/04_missing_hole_18.jpg;1
113;missing_hole;882;957;944;1028;.\data\pcb_defects_kaggle\Annotations\Missing_hole\04_missing_hole_18;0.2987565445026178;0.4028003246753247;62;71;3056;2464;0.020287958115183247;0.028814935064935064;.\data\pcb_defects_kaggle\images/Missing_hole/04_missing_hole_18.jpg;1
114;missing_hole;1284;1777;1344;1844;.\data\pcb_defects_kaggle\Annotations\Missing_hole\04_missing_hole_18;0.42997382198952877;0.7347808441558441;60;67;3056;2464;0.01963350785340314;0.02719155844155844;.\data\pcb_defects_kaggle\images/Missing_hole/04_missing_hole_18.jpg;1
115;missing_hole;1288;1535;1341;1601;.\data\pcb_defects_kaggle\Annotations\Missing_hole\04_missing_hole_19;0.43013743455497383;0.6363636363636364;53;66;3056;2464;0.017342931937172776;0.026785714285714284;.\data\pcb_defects_kaggle\images/Missing_hole/04_missing_hole_19.jpg;1
116;missing_hole;1517;1648;1571;1715;.\data\pcb_defects_kaggle\Annotations\Missing_hole\04_missing_hole_19;0.5052356020942408;0.682426948051948;54;67;3056;2464;0.01767015706806283;0.02719155844155844;.\data\pcb_defects_kaggle\images/Missing_hole/04_missing_hole_19.jpg;1
117;missing_hole;2110;1591;2173;1650;.\data\pcb_defects_kaggle\Annotations\Missing_hole\04_missing_hole_19;0.7007526178010471;0.6576704545454546;63;59;3056;2464;0.0206151832460733;0.023944805194805196;.\data\pcb_defects_kaggle\images/Missing_hole/04_missing_hole_19.jpg;1
118;missing_hole;1635;1430;1688;1502;.\data\pcb_defects_kaggle\Annotations\Missing_hole\04_missing_hole_20;0.543684554973822;0.5949675324675324;53;72;3056;2464;0.017342931937172776;0.02922077922077922;.\data\pcb_defects_kaggle\images/Missing_hole/04_missing_hole_20.jpg;1
119;missing_hole;1053;1410;1106;1471;.\data\pcb_defects_kaggle\Annotations\Missing_hole\04_missing_hole_20;0.3532395287958115;0.5846185064935064;53;61;3056;2464;0.017342931937172776;0.024756493506493508;.\data\pcb_defects_kaggle\images/Missing_hole/04_missing_hole_20.jpg;1
120;missing_hole;2110;1471;2177;1537;.\data\pcb_defects_kaggle\Annotations\Missing_hole\04_missing_hole_20;0.7014070680628273;0.6103896103896104;67;66;3056;2464;0.021924083769633507;0.026785714285714284;.\data\pcb_defects_kaggle\images/Missing_hole/04_missing_hole_20.jpg;1
121;missing_hole;1103;567;1174;623;.\data\pcb_defects_kaggle\Annotations\Missing_hole\05_missing_hole_01;0.44752358490566035;0.275974025974026;71;56;2544;2156;0.02790880503144654;0.025974025974025976;.\data\pcb_defects_kaggle\images/Missing_hole/05_missing_hole_01.jpg;1
122;missing_hole;1520;965;1569;1026;.\data\pcb_defects_kaggle\Annotations\Missing_hole\05_missing_hole_01;0.6071147798742138;0.461734693877551;49;61;2544;2156;0.019261006289308175;0.02829313543599258;.\data\pcb_defects_kaggle\images/Missing_hole/05_missing_hole_01.jpg;1
123;missing_hole;1337;1660;1387;1715;.\data\pcb_defects_kaggle\Annotations\Missing_hole\05_missing_hole_01;0.535377358490566;0.7826994434137291;50;55;2544;2156;0.019654088050314465;0.025510204081632654;.\data\pcb_defects_kaggle\images/Missing_hole/05_missing_hole_01.jpg;1
124;missing_hole;1931;546;1994;612;.\data\pcb_defects_kaggle\Annotations\Missing_hole\05_missing_hole_02;0.7714229559748428;0.26855287569573283;63;66;2544;2156;0.024764150943396228;0.030612244897959183;.\data\pcb_defects_kaggle\images/Missing_hole/05_missing_hole_02.jpg;1
125;missing_hole;1836;1092;1886;1149;.\data\pcb_defects_kaggle\Annotations\Missing_hole\05_missing_hole_02;0.7315251572327044;0.5197124304267161;50;57;2544;2156;0.019654088050314465;0.026437847866419294;.\data\pcb_defects_kaggle\images/Missing_hole/05_missing_hole_02.jpg;1
126;missing_hole;1058;370;1114;429;.\data\pcb_defects_kaggle\Annotations\Missing_hole\05_missing_hole_02;0.4268867924528302;0.18529684601113172;56;59;2544;2156;0.0220125786163522;0.02736549165120594;.\data\pcb_defects_kaggle\images/Missing_hole/05_missing_hole_02.jpg;1
127;missing_hole;1118;243;1179;309;.\data\pcb_defects_kaggle\Annotations\Missing_hole\05_missing_hole_03;0.4514544025157233;0.1280148423005566;61;66;2544;2156;0.02397798742138365;0.030612244897959183;.\data\pcb_defects_kaggle\images/Missing_hole/05_missing_hole_03.jpg;1
128;missing_hole;2050;820;2089;874;.\data\pcb_defects_kaggle\Annotations\Missing_hole\05_missing_hole_03;0.8134827044025157;0.39285714285714285;39;54;2544;2156;0.015330188679245283;0.02504638218923933;.\data\pcb_defects_kaggle\images/Missing_hole/05_missing_hole_03.jpg;1
129;missing_hole;1102;1023;1175;1079;.\data\pcb_defects_kaggle\Annotations\Missing_hole\05_missing_hole_03;0.44752358490566035;0.4874768089053803;73;56;2544;2156;0.02869496855345912;0.025974025974025976;.\data\pcb_defects_kaggle\images/Missing_hole/05_missing_hole_03.jpg;1
130;missing_hole;220;737;286;798;.\data\pcb_defects_kaggle\Annotations\Missing_hole\05_missing_hole_03;0.0994496855345912;0.3559833024118738;66;61;2544;2156;0.025943396226415096;0.02829313543599258;.\data\pcb_defects_kaggle\images/Missing_hole/05_missing_hole_03.jpg;1
131;missing_hole;1450;1318;1514;1376;.\data\pcb_defects_kaggle\Annotations\Missing_hole\05_missing_hole_03;0.5825471698113207;0.6247680890538033;64;58;2544;2156;0.025157232704402517;0.026901669758812616;.\data\pcb_defects_kaggle\images/Missing_hole/05_missing_hole_03.jpg;1
132;missing_hole;1102;624;1170;685;.\data\pcb_defects_kaggle\Annotations\Missing_hole\05_missing_hole_04;0.44654088050314467;0.30357142857142855;68;61;2544;2156;0.026729559748427674;0.02829313543599258;.\data\pcb_defects_kaggle\images/Missing_hole/05_missing_hole_04.jpg;1
133;missing_hole;375;1018;445;1088;.\data\pcb_defects_kaggle\Annotations\Missing_hole\05_missing_hole_04;0.1611635220125786;0.48840445269016697;70;70;2544;2156;0.027515723270440252;0.032467532467532464;.\data\pcb_defects_kaggle\images/Missing_hole/05_missing_hole_04.jpg;1
134;missing_hole;909;1767;977;1829;.\data\pcb_defects_kaggle\Annotations\Missing_hole\05_missing_hole_04;0.3706761006289308;0.8339517625231911;68;62;2544;2156;0.026729559748427674;0.0287569573283859;.\data\pcb_defects_kaggle\images/Missing_hole/05_missing_hole_04.jpg;1
135;missing_hole;1835;1096;1885;1149;.\data\pcb_defects_kaggle\Annotations\Missing_hole\05_missing_hole_04;0.7311320754716981;0.5206400742115028;50;53;2544;2156;0.019654088050314465;0.02458256029684601;.\data\pcb_defects_kaggle\images/Missing_hole/05_missing_hole_04.jpg;1
136;missing_hole;1450;796;1520;857;.\data\pcb_defects_kaggle\Annotations\Missing_hole\05_missing_hole_04;0.5837264150943396;0.38334879406307976;70;61;2544;2156;0.027515723270440252;0.02829313543599258;.\data\pcb_defects_kaggle\images/Missing_hole/05_missing_hole_04.jpg;1
137;missing_hole;1831;1270;1895;1323;.\data\pcb_defects_kaggle\Annotations\Missing_hole\05_missing_hole_05;0.7323113207547169;0.6013450834879406;64;53;2544;2156;0.025157232704402517;0.02458256029684601;.\data\pcb_defects_kaggle\images/Missing_hole/05_missing_hole_05.jpg;1
138;missing_hole;1450;1137;1511;1193;.\data\pcb_defects_kaggle\Annotations\Missing_hole\05_missing_hole_05;0.5819575471698113;0.5403525046382189;61;56;2544;2156;0.02397798742138365;0.025974025974025976;.\data\pcb_defects_kaggle\images/Missing_hole/05_missing_hole_05.jpg;1
139;missing_hole;1489;1788;1540;1857;.\data\pcb_defects_kaggle\Annotations\Missing_hole\05_missing_hole_05;0.5953223270440252;0.8453153988868275;51;69;2544;2156;0.020047169811320754;0.03200371057513915;.\data\pcb_defects_kaggle\images/Missing_hole/05_missing_hole_05.jpg;1
140;missing_hole;2031;1881;2094;1946;.\data\pcb_defects_kaggle\Annotations\Missing_hole\05_missing_hole_05;0.8107311320754716;0.8875231910946196;63;65;2544;2156;0.024764150943396228;0.030148423005565864;.\data\pcb_defects_kaggle\images/Missing_hole/05_missing_hole_05.jpg;1
141;missing_hole;2189;1585;2247;1645;.\data\pcb_defects_kaggle\Annotations\Missing_hole\05_missing_hole_05;0.8718553459119497;0.7490723562152134;58;60;2544;2156;0.02279874213836478;0.027829313543599257;.\data\pcb_defects_kaggle\images/Missing_hole/05_missing_hole_05.jpg;1
142;missing_hole;1670;1071;1724;1124;.\data\pcb_defects_kaggle\Annotations\Missing_hole\05_missing_hole_06;0.6670597484276729;0.5090445269016698;54;53;2544;2156;0.02122641509433962;0.02458256029684601;.\data\pcb_defects_kaggle\images/Missing_hole/05_missing_hole_06.jpg;1
143;missing_hole;1103;1479;1163;1543;.\data\pcb_defects_kaggle\Annotations\Missing_hole\05_missing_hole_06;0.4453616352201258;0.700834879406308;60;64;2544;2156;0.02358490566037736;0.029684601113172542;.\data\pcb_defects_kaggle\images/Missing_hole/05_missing_hole_06.jpg;1
144;missing_hole;219;1020;281;1084;.\data\pcb_defects_kaggle\Annotations\Missing_hole\05_missing_hole_06;0.09827044025157233;0.48794063079777367;62;64;2544;2156;0.02437106918238994;0.029684601113172542;.\data\pcb_defects_kaggle\images/Missing_hole/05_missing_hole_06.jpg;1
145;missing_hole;1561;146;1625;206;.\data\pcb_defects_kaggle\Annotations\Missing_hole\05_missing_hole_06;0.6261792452830188;0.08163265306122448;64;60;2544;2156;0.025157232704402517;0.027829313543599257;.\data\pcb_defects_kaggle\images/Missing_hole/05_missing_hole_06.jpg;1
146;missing_hole;2274;1692;2325;1743;.\data\pcb_defects_kaggle\Annotations\Missing_hole\05_missing_hole_06;0.9038915094339622;0.7966141001855288;51;51;2544;2156;0.020047169811320754;0.02365491651205937;.\data\pcb_defects_kaggle\images/Missing_hole/05_missing_hole_06.jpg;1
147;missing_hole;1110;621;1163;678;.\data\pcb_defects_kaggle\Annotations\Missing_hole\05_missing_hole_07;0.4467374213836478;0.301252319109462;53;57;2544;2156;0.020833333333333332;0.026437847866419294;.\data\pcb_defects_kaggle\images/Missing_hole/05_missing_hole_07.jpg;1
148;missing_hole;1374;352;1444;415;.\data\pcb_defects_kaggle\Annotations\Missing_hole\05_missing_hole_07;0.5538522012578616;0.1778756957328386;70;63;2544;2156;0.027515723270440252;0.02922077922077922;.\data\pcb_defects_kaggle\images/Missing_hole/05_missing_hole_07.jpg;1
149;missing_hole;1852;315;1917;387;.\data\pcb_defects_kaggle\Annotations\Missing_hole\05_missing_hole_07;0.7407625786163522;0.16280148423005567;65;72;2544;2156;0.025550314465408806;0.03339517625231911;.\data\pcb_defects_kaggle\images/Missing_hole/05_missing_hole_07.jpg;1
150;missing_hole;2028;187;2103;259;.\data\pcb_defects_kaggle\Annotations\Missing_hole\05_missing_hole_07;0.8119103773584906;0.10343228200371057;75;72;2544;2156;0.0294811320754717;0.03339517625231911;.\data\pcb_defects_kaggle\images/Missing_hole/05_missing_hole_07.jpg;1
151;missing_hole;1036;1249;1091;1315;.\data\pcb_defects_kaggle\Annotations\Missing_hole\05_missing_hole_07;0.4180424528301887;0.5946196660482375;55;66;2544;2156;0.02161949685534591;0.030612244897959183;.\data\pcb_defects_kaggle\images/Missing_hole/05_missing_hole_07.jpg;1
152;missing_hole;1722;1074;1777;1123;.\data\pcb_defects_kaggle\Annotations\Missing_hole\05_missing_hole_08;0.6876965408805031;0.509508348794063;55;49;2544;2156;0.02161949685534591;0.022727272727272728;.\data\pcb_defects_kaggle\images/Missing_hole/05_missing_hole_08.jpg;1
153;missing_hole;1981;813;2041;873;.\data\pcb_defects_kaggle\Annotations\Missing_hole\05_missing_hole_08;0.7904874213836478;0.3910018552875696;60;60;2544;2156;0.02358490566037736;0.027829313543599257;.\data\pcb_defects_kaggle\images/Missing_hole/05_missing_hole_08.jpg;1
154;missing_hole;1539;1465;1603;1515;.\data\pcb_defects_kaggle\Annotations\Missing_hole\05_missing_hole_08;0.6175314465408805;0.6910946196660482;64;50;2544;2156;0.025157232704402517;0.023191094619666047;.\data\pcb_defects_kaggle\images/Missing_hole/05_missing_hole_08.jpg;1
155;missing_hole;2061;1265;2120;1323;.\data\pcb_defects_kaggle\Annotations\Missing_hole\05_missing_hole_08;0.8217374213836478;0.6001855287569573;59;58;2544;2156;0.023191823899371068;0.026901669758812616;.\data\pcb_defects_kaggle\images/Missing_hole/05_missing_hole_08.jpg;1
156;missing_hole;1652;798;1709;849;.\data\pcb_defects_kaggle\Annotations\Missing_hole\05_missing_hole_08;0.6605738993710691;0.3819573283858998;57;51;2544;2156;0.02240566037735849;0.02365491651205937;.\data\pcb_defects_kaggle\images/Missing_hole/05_missing_hole_08.jpg;1
157;missing_hole;1603;1792;1659;1849;.\data\pcb_defects_kaggle\Annotations\Missing_hole\05_missing_hole_09;0.6411163522012578;0.8443877551020408;56;57;2544;2156;0.0220125786163522;0.026437847866419294;.\data\pcb_defects_kaggle\images/Missing_hole/05_missing_hole_09.jpg;1
158;missing_hole;2302;1585;2364;1645;.\data\pcb_defects_kaggle\Annotations\Missing_hole\05_missing_hole_09;0.9170597484276729;0.7490723562152134;62;60;2544;2156;0.02437106918238994;0.027829313543599257;.\data\pcb_defects_kaggle\images/Missing_hole/05_missing_hole_09.jpg;1
159;missing_hole;1085;1803;1144;1860;.\data\pcb_defects_kaggle\Annotations\Missing_hole\05_missing_hole_09;0.4380896226415094;0.8494897959183674;59;57;2544;2156;0.023191823899371068;0.026437847866419294;.\data\pcb_defects_kaggle\images/Missing_hole/05_missing_hole_09.jpg;1
160;missing_hole;1309;1956;1380;2027;.\data\pcb_defects_kaggle\Annotations\Missing_hole\05_missing_hole_09;0.528498427672956;0.9237012987012987;71;71;2544;2156;0.02790880503144654;0.03293135435992579;.\data\pcb_defects_kaggle\images/Missing_hole/05_missing_hole_09.jpg;1
161;missing_hole;223;1763;287;1834;.\data\pcb_defects_kaggle\Annotations\Missing_hole\05_missing_hole_09;0.10023584905660378;0.8341836734693877;64;71;2544;2156;0.025157232704402517;0.03293135435992579;.\data\pcb_defects_kaggle\images/Missing_hole/05_missing_hole_09.jpg;1
162;missing_hole;1905;1415;1963;1478;.\data\pcb_defects_kaggle\Annotations\Missing_hole\05_missing_hole_10;0.7602201257861635;0.6709183673469388;58;63;2544;2156;0.02279874213836478;0.02922077922077922;.\data\pcb_defects_kaggle\images/Missing_hole/05_missing_hole_10.jpg;1
163;missing_hole;1452;1428;1513;1482;.\data\pcb_defects_kaggle\Annotations\Missing_hole\05_missing_hole_10;0.5827437106918238;0.674860853432282;61;54;2544;2156;0.02397798742138365;0.02504638218923933;.\data\pcb_defects_kaggle\images/Missing_hole/05_missing_hole_10.jpg;1
164;missing_hole;1103;1367;1169;1431;.\data\pcb_defects_kaggle\Annotations\Missing_hole\05_missing_hole_10;0.44654088050314467;0.648886827458256;66;64;2544;2156;0.025943396226415096;0.029684601113172542;.\data\pcb_defects_kaggle\images/Missing_hole/05_missing_hole_10.jpg;1
165;missing_hole;367;217;441;281;.\data\pcb_defects_kaggle\Annotations\Missing_hole\05_missing_hole_10;0.15880503144654087;0.11549165120593692;74;64;2544;2156;0.02908805031446541;0.029684601113172542;.\data\pcb_defects_kaggle\images/Missing_hole/05_missing_hole_10.jpg;1
166;missing_hole;216;623;286;682;.\data\pcb_defects_kaggle\Annotations\Missing_hole\05_missing_hole_10;0.09866352201257862;0.30264378478664195;70;59;2544;2156;0.027515723270440252;0.02736549165120594;.\data\pcb_defects_kaggle\images/Missing_hole/05_missing_hole_10.jpg;1
167;missing_hole;1443;854;1494;902;.\data\pcb_defects_kaggle\Annotations\Missing_hole\06_missing_hole_01;0.5120292887029289;0.3791018998272884;51;48;2868;2316;0.01778242677824268;0.02072538860103627;.\data\pcb_defects_kaggle\images/Missing_hole/06_missing_hole_01.jpg;1
168;missing_hole;1332;1151;1382;1212;.\data\pcb_defects_kaggle\Annotations\Missing_hole\06_missing_hole_01;0.47315202231520226;0.510146804835924;50;61;2868;2316;0.017433751743375175;0.026338514680483593;.\data\pcb_defects_kaggle\images/Missing_hole/06_missing_hole_01.jpg;1
169;missing_hole;1786;1374;1837;1427;.\data\pcb_defects_kaggle\Annotations\Missing_hole\06_missing_hole_01;0.6316248256624826;0.604706390328152;51;53;2868;2316;0.01778242677824268;0.022884283246977548;.\data\pcb_defects_kaggle\images/Missing_hole/06_missing_hole_01.jpg;1
170;missing_hole;1062;1415;1127;1470;.\data\pcb_defects_kaggle\Annotations\Missing_hole\06_missing_hole_01;0.38162482566248257;0.6228411053540587;65;55;2868;2316;0.022663877266387727;0.023747841105354058;.\data\pcb_defects_kaggle\images/Missing_hole/06_missing_hole_01.jpg;1
171;missing_hole;584;1229;635;1275;.\data\pcb_defects_kaggle\Annotations\Missing_hole\06_missing_hole_01;0.21251743375174337;0.540587219343696;51;46;2868;2316;0.01778242677824268;0.019861830742659757;.\data\pcb_defects_kaggle\images/Missing_hole/06_missing_hole_01.jpg;1
172;missing_hole;1615;973;1674;1036;.\data\pcb_defects_kaggle\Annotations\Missing_hole\06_missing_hole_02;0.5733960948396095;0.43372193436960277;59;63;2868;2316;0.020571827057182707;0.027202072538860103;.\data\pcb_defects_kaggle\images/Missing_hole/06_missing_hole_02.jpg;1
173;missing_hole;2104;1659;2181;1731;.\data\pcb_defects_kaggle\Annotations\Missing_hole\06_missing_hole_02;0.7470362622036262;0.7318652849740933;77;72;2868;2316;0.02684797768479777;0.031088082901554404;.\data\pcb_defects_kaggle\images/Missing_hole/06_missing_hole_02.jpg;1
174;missing_hole;2428;1317;2489;1380;.\data\pcb_defects_kaggle\Annotations\Missing_hole\06_missing_hole_02;0.8572175732217573;0.5822538860103627;61;63;2868;2316;0.021269177126917713;0.027202072538860103;.\data\pcb_defects_kaggle\images/Missing_hole/06_missing_hole_02.jpg;1
175;missing_hole;238;1674;318;1739;.\data\pcb_defects_kaggle\Annotations\Missing_hole\06_missing_hole_02;0.09693165969316597;0.7368307426597582;80;65;2868;2316;0.02789400278940028;0.028065630397236616;.\data\pcb_defects_kaggle\images/Missing_hole/06_missing_hole_02.jpg;1
176;missing_hole;1155;1814;1213;1871;.\data\pcb_defects_kaggle\Annotations\Missing_hole\06_missing_hole_02;0.41283124128312415;0.7955526770293609;58;57;2868;2316;0.020223152022315203;0.02461139896373057;.\data\pcb_defects_kaggle\images/Missing_hole/06_missing_hole_02.jpg;1
177;missing_hole;1528;395;1588;446;.\data\pcb_defects_kaggle\Annotations\Missing_hole\06_missing_hole_03;0.5432357043235704;0.18156303972366147;60;51;2868;2316;0.02092050209205021;0.022020725388601035;.\data\pcb_defects_kaggle\images/Missing_hole/06_missing_hole_03.jpg;1
178;missing_hole;710;768;799;841;.\data\pcb_defects_kaggle\Annotations\Missing_hole\06_missing_hole_03;0.2630753138075314;0.34736614853195164;89;73;2868;2316;0.03103207810320781;0.03151986183074266;.\data\pcb_defects_kaggle\images/Missing_hole/06_missing_hole_03.jpg;1
179;missing_hole;1093;976;1155;1044;.\data\pcb_defects_kaggle\Annotations\Missing_hole\06_missing_hole_03;0.39191073919107394;0.43609671848013815;62;68;2868;2316;0.021617852161785217;0.02936096718480138;.\data\pcb_defects_kaggle\images/Missing_hole/06_missing_hole_03.jpg;1
180;missing_hole;242;897;306;959;.\data\pcb_defects_kaggle\Annotations\Missing_hole\06_missing_hole_03;0.09553695955369595;0.4006908462867012;64;62;2868;2316;0.022315202231520222;0.02677029360967185;.\data\pcb_defects_kaggle\images/Missing_hole/06_missing_hole_03.jpg;1
181;missing_hole;603;203;652;247;.\data\pcb_defects_kaggle\Annotations\Missing_hole\06_missing_hole_03;0.21879358437935845;0.09715025906735751;49;44;2868;2316;0.01708507670850767;0.018998272884283247;.\data\pcb_defects_kaggle\images/Missing_hole/06_missing_hole_03.jpg;1
182;missing_hole;921;542;967;592;.\data\pcb_defects_kaggle\Annotations\Missing_hole\06_missing_hole_04;0.3291492329149233;0.24481865284974094;46;50;2868;2316;0.01603905160390516;0.02158894645941278;.\data\pcb_defects_kaggle\images/Missing_hole/06_missing_hole_04.jpg;1
183;missing_hole;725;924;788;976;.\data\pcb_defects_kaggle\Annotations\Missing_hole\06_missing_hole_04;0.2637726638772664;0.41018998272884283;63;52;2868;2316;0.021966527196652718;0.022452504317789293;.\data\pcb_defects_kaggle\images/Missing_hole/06_missing_hole_04.jpg;1
184;missing_hole;316;1485;381;1544;.\data\pcb_defects_kaggle\Annotations\Missing_hole\06_missing_hole_04;0.12151324965132497;0.6539291882556131;65;59;2868;2316;0.022663877266387727;0.02547495682210708;.\data\pcb_defects_kaggle\images/Missing_hole/06_missing_hole_04.jpg;1
185;missing_hole;1155;1473;1213;1529;.\data\pcb_defects_kaggle\Annotations\Missing_hole\06_missing_hole_04;0.41283124128312415;0.6481001727115717;58;56;2868;2316;0.020223152022315203;0.024179620034542316;.\data\pcb_defects_kaggle\images/Missing_hole/06_missing_hole_04.jpg;1
186;missing_hole;1350;1956;1401;2007;.\data\pcb_defects_kaggle\Annotations\Missing_hole\06_missing_hole_04;0.47960251046025104;0.8555699481865285;51;51;2868;2316;0.01778242677824268;0.022020725388601035;.\data\pcb_defects_kaggle\images/Missing_hole/06_missing_hole_04.jpg;1
187;missing_hole;1276;725;1345;788;.\data\pcb_defects_kaggle\Annotations\Missing_hole\06_missing_hole_05;0.4569386331938633;0.32664075993091535;69;63;2868;2316;0.02405857740585774;0.027202072538860103;.\data\pcb_defects_kaggle\images/Missing_hole/06_missing_hole_05.jpg;1
188;missing_hole;808;1156;864;1207;.\data\pcb_defects_kaggle\Annotations\Missing_hole\06_missing_hole_05;0.2914923291492329;0.510146804835924;56;51;2868;2316;0.019525801952580194;0.022020725388601035;.\data\pcb_defects_kaggle\images/Missing_hole/06_missing_hole_05.jpg;1
189;missing_hole;1215;1154;1265;1210;.\data\pcb_defects_kaggle\Annotations\Missing_hole\06_missing_hole_05;0.43235704323570434;0.5103626943005182;50;56;2868;2316;0.017433751743375175;0.024179620034542316;.\data\pcb_defects_kaggle\images/Missing_hole/06_missing_hole_05.jpg;1
190;missing_hole;2213;1283;2274;1342;.\data\pcb_defects_kaggle\Annotations\Missing_hole\06_missing_hole_05;0.782252440725244;0.5667098445595855;61;59;2868;2316;0.021269177126917713;0.02547495682210708;.\data\pcb_defects_kaggle\images/Missing_hole/06_missing_hole_05.jpg;1
191;missing_hole;1676;1815;1733;1878;.\data\pcb_defects_kaggle\Annotations\Missing_hole\06_missing_hole_05;0.5943165969316597;0.7972797927461139;57;63;2868;2316;0.0198744769874477;0.027202072538860103;.\data\pcb_defects_kaggle\images/Missing_hole/06_missing_hole_05.jpg;1
192;missing_hole;806;541;860;590;.\data\pcb_defects_kaggle\Annotations\Missing_hole\06_missing_hole_06;0.2904463040446304;0.24417098445595856;54;49;2868;2316;0.01882845188284519;0.021157167530224525;.\data\pcb_defects_kaggle\images/Missing_hole/06_missing_hole_06.jpg;1
193;missing_hole;2213;1375;2284;1439;.\data\pcb_defects_kaggle\Annotations\Missing_hole\06_missing_hole_06;0.7839958158995816;0.6075129533678757;71;64;2868;2316;0.024755927475592746;0.027633851468048358;.\data\pcb_defects_kaggle\images/Missing_hole/06_missing_hole_06.jpg;1
194;missing_hole;588;1292;638;1349;.\data\pcb_defects_kaggle\Annotations\Missing_hole\06_missing_hole_06;0.21373779637377963;0.5701640759930915;50;57;2868;2316;0.017433751743375175;0.02461139896373057;.\data\pcb_defects_kaggle\images/Missing_hole/06_missing_hole_06.jpg;1
195;missing_hole;1620;1322;1667;1383;.\data\pcb_defects_kaggle\Annotations\Missing_hole\06_missing_hole_06;0.5730474198047419;0.5839810017271158;47;61;2868;2316;0.016387726638772665;0.026338514680483593;.\data\pcb_defects_kaggle\images/Missing_hole/06_missing_hole_06.jpg;1
196;missing_hole;238;897;311;961;.\data\pcb_defects_kaggle\Annotations\Missing_hole\06_missing_hole_06;0.09571129707112971;0.4011226252158895;73;64;2868;2316;0.025453277545327755;0.027633851468048358;.\data\pcb_defects_kaggle\images/Missing_hole/06_missing_hole_06.jpg;1
197;missing_hole;1067;1939;1132;2005;.\data\pcb_defects_kaggle\Annotations\Missing_hole\06_missing_hole_06;0.3833682008368201;0.8514680483592401;65;66;2868;2316;0.022663877266387727;0.02849740932642487;.\data\pcb_defects_kaggle\images/Missing_hole/06_missing_hole_06.jpg;1
198;missing_hole;1276;725;1342;781;.\data\pcb_defects_kaggle\Annotations\Missing_hole\06_missing_hole_07;0.45641562064156205;0.32512953367875647;66;56;2868;2316;0.02301255230125523;0.024179620034542316;.\data\pcb_defects_kaggle\images/Missing_hole/06_missing_hole_07.jpg;1
199;missing_hole;1159;1815;1218;1876;.\data\pcb_defects_kaggle\Annotations\Missing_hole\06_missing_hole_07;0.4144002789400279;0.7968480138169257;59;61;2868;2316;0.020571827057182707;0.026338514680483593;.\data\pcb_defects_kaggle\images/Missing_hole/06_missing_hole_07.jpg;1
200;missing_hole;2206;1285;2277;1342;.\data\pcb_defects_kaggle\Annotations\Missing_hole\06_missing_hole_07;0.7815550906555091;0.5671416234887737;71;57;2868;2316;0.024755927475592746;0.02461139896373057;.\data\pcb_defects_kaggle\images/Missing_hole/06_missing_hole_07.jpg;1
201;missing_hole;1154;1154;1211;1212;.\data\pcb_defects_kaggle\Annotations\Missing_hole\06_missing_hole_07;0.41230822873082285;0.5107944732297064;57;58;2868;2316;0.0198744769874477;0.025043177892918825;.\data\pcb_defects_kaggle\images/Missing_hole/06_missing_hole_07.jpg;1
202;missing_hole;1603;1149;1673;1217;.\data\pcb_defects_kaggle\Annotations\Missing_hole\06_missing_hole_07;0.5711297071129707;0.5107944732297064;70;68;2868;2316;0.024407252440725245;0.02936096718480138;.\data\pcb_defects_kaggle\images/Missing_hole/06_missing_hole_07.jpg;1
203;missing_hole;1442;1149;1498;1205;.\data\pcb_defects_kaggle\Annotations\Missing_hole\06_missing_hole_08;0.5125523012552301;0.5082037996545768;56;56;2868;2316;0.019525801952580194;0.024179620034542316;.\data\pcb_defects_kaggle\images/Missing_hole/06_missing_hole_08.jpg;1
204;missing_hole;1093;1149;1159;1212;.\data\pcb_defects_kaggle\Annotations\Missing_hole\06_missing_hole_08;0.3926080892608089;0.5097150259067358;66;63;2868;2316;0.02301255230125523;0.027202072538860103;.\data\pcb_defects_kaggle\images/Missing_hole/06_missing_hole_08.jpg;1
205;missing_hole;1010;849;1074;915;.\data\pcb_defects_kaggle\Annotations\Missing_hole\06_missing_hole_08;0.3633193863319386;0.38082901554404147;64;66;2868;2316;0.022315202231520222;0.02849740932642487;.\data\pcb_defects_kaggle\images/Missing_hole/06_missing_hole_08.jpg;1
206;missing_hole;857;197;913;253;.\data\pcb_defects_kaggle\Annotations\Missing_hole\06_missing_hole_08;0.30857740585774057;0.09715025906735751;56;56;2868;2316;0.019525801952580194;0.024179620034542316;.\data\pcb_defects_kaggle\images/Missing_hole/06_missing_hole_08.jpg;1
207;missing_hole;243;1164;315;1222;.\data\pcb_defects_kaggle\Annotations\Missing_hole\06_missing_hole_08;0.09728033472803348;0.5151122625215889;72;58;2868;2316;0.02510460251046025;0.025043177892918825;.\data\pcb_defects_kaggle\images/Missing_hole/06_missing_hole_08.jpg;1
208;missing_hole;1160;722;1232;783;.\data\pcb_defects_kaggle\Annotations\Missing_hole\06_missing_hole_09;0.41701534170153415;0.32491364421416236;72;61;2868;2316;0.02510460251046025;0.026338514680483593;.\data\pcb_defects_kaggle\images/Missing_hole/06_missing_hole_09.jpg;1
209;missing_hole;1735;615;1804;678;.\data\pcb_defects_kaggle\Annotations\Missing_hole\06_missing_hole_09;0.6169804741980475;0.27914507772020725;69;63;2868;2316;0.02405857740585774;0.027202072538860103;.\data\pcb_defects_kaggle\images/Missing_hole/06_missing_hole_09.jpg;1
210;missing_hole;1094;1149;1150;1203;.\data\pcb_defects_kaggle\Annotations\Missing_hole\06_missing_hole_09;0.3912133891213389;0.5077720207253886;56;54;2868;2316;0.019525801952580194;0.023316062176165803;.\data\pcb_defects_kaggle\images/Missing_hole/06_missing_hole_09.jpg;1
211;missing_hole;1665;1320;1732;1381;.\data\pcb_defects_kaggle\Annotations\Missing_hole\06_missing_hole_09;0.5922245467224547;0.5831174438687392;67;61;2868;2316;0.023361227336122732;0.026338514680483593;.\data\pcb_defects_kaggle\images/Missing_hole/06_missing_hole_09.jpg;1
212;missing_hole;2213;1500;2276;1561;.\data\pcb_defects_kaggle\Annotations\Missing_hole\06_missing_hole_09;0.7826011157601116;0.6608376511226253;63;61;2868;2316;0.021966527196652718;0.026338514680483593;.\data\pcb_defects_kaggle\images/Missing_hole/06_missing_hole_09.jpg;1
213;missing_hole;1280;723;1342;790;.\data\pcb_defects_kaggle\Annotations\Missing_hole\06_missing_hole_10;0.4571129707112971;0.32664075993091535;62;67;2868;2316;0.021617852161785217;0.028929188255613126;.\data\pcb_defects_kaggle\images/Missing_hole/06_missing_hole_10.jpg;1
214;missing_hole;840;683;904;742;.\data\pcb_defects_kaggle\Annotations\Missing_hole\06_missing_hole_10;0.30404463040446306;0.3076424870466321;64;59;2868;2316;0.022315202231520222;0.02547495682210708;.\data\pcb_defects_kaggle\images/Missing_hole/06_missing_hole_10.jpg;1
215;missing_hole;1093;978;1157;1044;.\data\pcb_defects_kaggle\Annotations\Missing_hole\06_missing_hole_10;0.3922594142259414;0.4365284974093264;64;66;2868;2316;0.022315202231520222;0.02849740932642487;.\data\pcb_defects_kaggle\images/Missing_hole/06_missing_hole_10.jpg;1
216;missing_hole;1043;1471;1098;1532;.\data\pcb_defects_kaggle\Annotations\Missing_hole\06_missing_hole_10;0.37325662482566246;0.6483160621761658;55;61;2868;2316;0.019177126917712693;0.026338514680483593;.\data\pcb_defects_kaggle\images/Missing_hole/06_missing_hole_10.jpg;1
217;missing_hole;2184;2046;2240;2103;.\data\pcb_defects_kaggle\Annotations\Missing_hole\06_missing_hole_10;0.7712691771269177;0.8957253886010362;56;57;2868;2316;0.019525801952580194;0.02461139896373057;.\data\pcb_defects_kaggle\images/Missing_hole/06_missing_hole_10.jpg;1
218;missing_hole;1244;727;1317;807;.\data\pcb_defects_kaggle\Annotations\Missing_hole\07_missing_hole_01;0.4409435261707989;0.3992712129099427;73;80;2904;1921;0.025137741046831957;0.041644976574700676;.\data\pcb_defects_kaggle\images/Missing_hole/07_missing_hole_01.jpg;1
219;missing_hole;1692;1034;1763;1113;.\data\pcb_defects_kaggle\Annotations\Missing_hole\07_missing_hole_01;0.5948691460055097;0.5588235294117647;71;79;2904;1921;0.024449035812672177;0.04112441436751692;.\data\pcb_defects_kaggle\images/Missing_hole/07_missing_hole_01.jpg;1
220;missing_hole;2170;1029;2261;1127;.\data\pcb_defects_kaggle\Annotations\Missing_hole\07_missing_hole_01;0.7629132231404959;0.5611660593440916;91;98;2904;1921;0.03133608815426997;0.05101509630400833;.\data\pcb_defects_kaggle\images/Missing_hole/07_missing_hole_01.jpg;1
221;missing_hole;2441;777;2537;855;.\data\pcb_defects_kaggle\Annotations\Missing_hole\07_missing_hole_01;0.8570936639118457;0.4247787610619469;96;78;2904;1921;0.03305785123966942;0.04060385216033316;.\data\pcb_defects_kaggle\images/Missing_hole/07_missing_hole_01.jpg;1
222;missing_hole;570;301;649;386;.\data\pcb_defects_kaggle\Annotations\Missing_hole\07_missing_hole_01;0.20988292011019283;0.17881311816762102;79;85;2904;1921;0.027203856749311296;0.04424778761061947;.\data\pcb_defects_kaggle\images/Missing_hole/07_missing_hole_01.jpg;1
223;missing_hole;1118;200;1191;265;.\data\pcb_defects_kaggle\Annotations\Missing_hole\07_missing_hole_02;0.39755509641873277;0.12103071317022385;73;65;2904;1921;0.025137741046831957;0.0338365434669443;.\data\pcb_defects_kaggle\images/Missing_hole/07_missing_hole_02.jpg;1
224;missing_hole;1703;338;1784;405;.\data\pcb_defects_kaggle\Annotations\Missing_hole\07_missing_hole_02;0.6003787878787878;0.19338885996876626;81;67;2904;1921;0.027892561983471075;0.034877667881311816;.\data\pcb_defects_kaggle\images/Missing_hole/07_missing_hole_02.jpg;1
225;missing_hole;1203;1032;1270;1119;.\data\pcb_defects_kaggle\Annotations\Missing_hole\07_missing_hole_02;0.42579201101928377;0.5598646538261323;67;87;2904;1921;0.023071625344352618;0.045288912024986985;.\data\pcb_defects_kaggle\images/Missing_hole/07_missing_hole_02.jpg;1
226;missing_hole;284;1070;403;1184;.\data\pcb_defects_kaggle\Annotations\Missing_hole\07_missing_hole_02;0.11828512396694214;0.5866736074960958;119;114;2904;1921;0.040977961432506885;0.059344091618948464;.\data\pcb_defects_kaggle\images/Missing_hole/07_missing_hole_02.jpg;1
227;missing_hole;1548;1446;1617;1548;.\data\pcb_defects_kaggle\Annotations\Missing_hole\07_missing_hole_02;0.5449380165289256;0.7792816241540864;69;102;2904;1921;0.023760330578512397;0.05309734513274336;.\data\pcb_defects_kaggle\images/Missing_hole/07_missing_hole_02.jpg;1
228;missing_hole;1687;517;1770;603;.\data\pcb_defects_kaggle\Annotations\Missing_hole\07_missing_hole_03;0.5952134986225895;0.29151483602290473;83;86;2904;1921;0.028581267217630855;0.04476834981780323;.\data\pcb_defects_kaggle\images/Missing_hole/07_missing_hole_03.jpg;1
229;missing_hole;1856;287;1940;357;.\data\pcb_defects_kaggle\Annotations\Missing_hole\07_missing_hole_03;0.6535812672176309;0.16762103071317022;84;70;2904;1921;0.028925619834710745;0.03643935450286309;.\data\pcb_defects_kaggle\images/Missing_hole/07_missing_hole_03.jpg;1
230;missing_hole;1089;755;1167;829;.\data\pcb_defects_kaggle\Annotations\Missing_hole\07_missing_hole_03;0.3884297520661157;0.4122852680895367;78;74;2904;1921;0.026859504132231406;0.038521603331598125;.\data\pcb_defects_kaggle\images/Missing_hole/07_missing_hole_03.jpg;1
231;missing_hole;846;1027;927;1117;.\data\pcb_defects_kaggle\Annotations\Missing_hole\07_missing_hole_03;0.3052685950413223;0.5580426861009891;81;90;2904;1921;0.027892561983471075;0.04685059864653826;.\data\pcb_defects_kaggle\images/Missing_hole/07_missing_hole_03.jpg;1
232;missing_hole;2106;1029;2180;1127;.\data\pcb_defects_kaggle\Annotations\Missing_hole\07_missing_hole_03;0.7379476584022039;0.5611660593440916;74;98;2904;1921;0.025482093663911846;0.05101509630400833;.\data\pcb_defects_kaggle\images/Missing_hole/07_missing_hole_03.jpg;1
233;missing_hole;2032;510;2111;601;.\data\pcb_defects_kaggle\Annotations\Missing_hole\07_missing_hole_04;0.7133264462809917;0.2891723060905778;79;91;2904;1921;0.027203856749311296;0.04737116085372202;.\data\pcb_defects_kaggle\images/Missing_hole/07_missing_hole_04.jpg;1
234;missing_hole;2680;351;2756;438;.\data\pcb_defects_kaggle\Annotations\Missing_hole\07_missing_hole_04;0.9359504132231405;0.20536179073399272;76;87;2904;1921;0.026170798898071626;0.045288912024986985;.\data\pcb_defects_kaggle\images/Missing_hole/07_missing_hole_04.jpg;1
235;missing_hole;2667;770;2758;863;.\data\pcb_defects_kaggle\Annotations\Missing_hole\07_missing_hole_04;0.9340564738292011;0.4250390421655388;91;93;2904;1921;0.03133608815426997;0.048412285268089536;.\data\pcb_defects_kaggle\images/Missing_hole/07_missing_hole_04.jpg;1
236;missing_hole;1539;1034;1629;1124;.\data\pcb_defects_kaggle\Annotations\Missing_hole\07_missing_hole_04;0.5454545454545454;0.5616866215512754;90;90;2904;1921;0.030991735537190084;0.04685059864653826;.\data\pcb_defects_kaggle\images/Missing_hole/07_missing_hole_04.jpg;1
237;missing_hole;920;1024;998;1119;.\data\pcb_defects_kaggle\Annotations\Missing_hole\07_missing_hole_04;0.33023415977961434;0.5577824049973972;78;95;2904;1921;0.026859504132231406;0.04945340968245705;.\data\pcb_defects_kaggle\images/Missing_hole/07_missing_hole_04.jpg;1
238;missing_hole;1305;513;1387;600;.\data\pcb_defects_kaggle\Annotations\Missing_hole\07_missing_hole_05;0.4634986225895317;0.2896928682977616;82;87;2904;1921;0.028236914600550965;0.045288912024986985;.\data\pcb_defects_kaggle\images/Missing_hole/07_missing_hole_05.jpg;1
239;missing_hole;875;758;953;831;.\data\pcb_defects_kaggle\Annotations\Missing_hole\07_missing_hole_05;0.31473829201101927;0.41358667360749607;78;73;2904;1921;0.026859504132231406;0.03800104112441437;.\data\pcb_defects_kaggle\images/Missing_hole/07_missing_hole_05.jpg;1
240;missing_hole;1241;722;1311;807;.\data\pcb_defects_kaggle\Annotations\Missing_hole\07_missing_hole_05;0.4393939393939394;0.39796980739198334;70;85;2904;1921;0.024104683195592287;0.04424778761061947;.\data\pcb_defects_kaggle\images/Missing_hole/07_missing_hole_05.jpg;1
241;missing_hole;565;299;653;390;.\data\pcb_defects_kaggle\Annotations\Missing_hole\07_missing_hole_05;0.2097107438016529;0.1793336803748048;88;91;2904;1921;0.030303030303030304;0.04737116085372202;.\data\pcb_defects_kaggle\images/Missing_hole/07_missing_hole_05.jpg;1
242;missing_hole;432;551;511;639;.\data\pcb_defects_kaggle\Annotations\Missing_hole\07_missing_hole_05;0.16236225895316805;0.30973451327433627;79;88;2904;1921;0.027203856749311296;0.045809474232170744;.\data\pcb_defects_kaggle\images/Missing_hole/07_missing_hole_05.jpg;1
243;missing_hole;951;294;1018;363;.\data\pcb_defects_kaggle\Annotations\Missing_hole\07_missing_hole_06;0.3390151515151515;0.17100468505986466;67;69;2904;1921;0.023071625344352618;0.03591879229567933;.\data\pcb_defects_kaggle\images/Missing_hole/07_missing_hole_06.jpg;1
244;missing_hole;1232;508;1317;598;.\data\pcb_defects_kaggle\Annotations\Missing_hole\07_missing_hole_06;0.4388774104683196;0.28787090057261844;85;90;2904;1921;0.029269972451790634;0.04685059864653826;.\data\pcb_defects_kaggle\images/Missing_hole/07_missing_hole_06.jpg;1
245;missing_hole;1696;329;1791;417;.\data\pcb_defects_kaggle\Annotations\Missing_hole\07_missing_hole_06;0.6003787878787878;0.19416970327954192;95;88;2904;1921;0.03271349862258953;0.045809474232170744;.\data\pcb_defects_kaggle\images/Missing_hole/07_missing_hole_06.jpg;1
246;missing_hole;1332;1027;1411;1127;.\data\pcb_defects_kaggle\Annotations\Missing_hole\07_missing_hole_06;0.4722796143250689;0.5606454971369078;79;100;2904;1921;0.027203856749311296;0.052056220718375845;.\data\pcb_defects_kaggle\images/Missing_hole/07_missing_hole_06.jpg;1
247;missing_hole;1537;1441;1630;1546;.\data\pcb_defects_kaggle\Annotations\Missing_hole\07_missing_hole_06;0.5452823691460055;0.7774596564289432;93;105;2904;1921;0.03202479338842975;0.05465903175429464;.\data\pcb_defects_kaggle\images/Missing_hole/07_missing_hole_06.jpg;1
248;missing_hole;423;300;517;389;.\data\pcb_defects_kaggle\Annotations\Missing_hole\07_missing_hole_07;0.1618457300275482;0.1793336803748048;94;89;2904;1921;0.03236914600550964;0.0463300364393545;.\data\pcb_defects_kaggle\images/Missing_hole/07_missing_hole_07.jpg;1
249;missing_hole;563;688;655;777;.\data\pcb_defects_kaggle\Annotations\Missing_hole\07_missing_hole_07;0.2097107438016529;0.3813118167621031;92;89;2904;1921;0.03168044077134986;0.0463300364393545;.\data\pcb_defects_kaggle\images/Missing_hole/07_missing_hole_07.jpg;1
250;missing_hole;137;1153;273;1269;.\data\pcb_defects_kaggle\Annotations\Missing_hole\07_missing_hole_07;0.07059228650137742;0.6304008328995315;136;116;2904;1921;0.046831955922865015;0.06038521603331598;.\data\pcb_defects_kaggle\images/Missing_hole/07_missing_hole_07.jpg;1
251;missing_hole;2110;726;2187;813;.\data\pcb_defects_kaggle\Annotations\Missing_hole\07_missing_hole_07;0.7398415977961432;0.40057261842790215;77;87;2904;1921;0.026515151515151516;0.045288912024986985;.\data\pcb_defects_kaggle\images/Missing_hole/07_missing_hole_07.jpg;1
252;missing_hole;1851;358;1939;455;.\data\pcb_defects_kaggle\Annotations\Missing_hole\07_missing_hole_07;0.6525482093663911;0.21160853722019782;88;97;2904;1921;0.030303030303030304;0.05049453409682457;.\data\pcb_defects_kaggle\images/Missing_hole/07_missing_hole_07.jpg;1
253;missing_hole;1237;717;1320;808;.\data\pcb_defects_kaggle\Annotations\Missing_hole\07_missing_hole_08;0.4402548209366391;0.3969286829776158;83;91;2904;1921;0.028581267217630855;0.04737116085372202;.\data\pcb_defects_kaggle\images/Missing_hole/07_missing_hole_08.jpg;1
254;missing_hole;949;758;1022;829;.\data\pcb_defects_kaggle\Annotations\Missing_hole\07_missing_hole_08;0.3393595041322314;0.41306611140031235;73;71;2904;1921;0.025137741046831957;0.03695991671004685;.\data\pcb_defects_kaggle\images/Missing_hole/07_missing_hole_08.jpg;1
255;missing_hole;1339;1031;1417;1117;.\data\pcb_defects_kaggle\Annotations\Missing_hole\07_missing_hole_08;0.47451790633608815;0.5590838105153566;78;86;2904;1921;0.026859504132231406;0.04476834981780323;.\data\pcb_defects_kaggle\images/Missing_hole/07_missing_hole_08.jpg;1
256;missing_hole;2034;515;2113;601;.\data\pcb_defects_kaggle\Annotations\Missing_hole\07_missing_hole_08;0.7140151515151515;0.29047371160853724;79;86;2904;1921;0.027203856749311296;0.04476834981780323;.\data\pcb_defects_kaggle\images/Missing_hole/07_missing_hole_08.jpg;1
257;missing_hole;2451;357;2527;439;.\data\pcb_defects_kaggle\Annotations\Missing_hole\07_missing_hole_08;0.8570936639118457;0.20718375845913586;76;82;2904;1921;0.026170798898071626;0.04268610098906819;.\data\pcb_defects_kaggle\images/Missing_hole/07_missing_hole_08.jpg;1
258;missing_hole;1642;434;1727;508;.\data\pcb_defects_kaggle\Annotations\Missing_hole\07_missing_hole_09;0.5800619834710744;0.24518479958355024;85;74;2904;1921;0.029269972451790634;0.038521603331598125;.\data\pcb_defects_kaggle\images/Missing_hole/07_missing_hole_09.jpg;1
259;missing_hole;851;1024;927;1112;.\data\pcb_defects_kaggle\Annotations\Missing_hole\07_missing_hole_09;0.30612947658402206;0.5559604372722541;76;88;2904;1921;0.026170798898071626;0.045809474232170744;.\data\pcb_defects_kaggle\images/Missing_hole/07_missing_hole_09.jpg;1
260;missing_hole;1130;1029;1205;1117;.\data\pcb_defects_kaggle\Annotations\Missing_hole\07_missing_hole_09;0.40203168044077137;0.5585632483081728;75;88;2904;1921;0.025826446280991736;0.045809474232170744;.\data\pcb_defects_kaggle\images/Missing_hole/07_missing_hole_09.jpg;1
261;missing_hole;2172;1446;2255;1544;.\data\pcb_defects_kaggle\Annotations\Missing_hole\07_missing_hole_09;0.762224517906336;0.7782404997397189;83;98;2904;1921;0.028581267217630855;0.05101509630400833;.\data\pcb_defects_kaggle\images/Missing_hole/07_missing_hole_09.jpg;1
262;missing_hole;1403;1446;1486;1536;.\data\pcb_defects_kaggle\Annotations\Missing_hole\07_missing_hole_09;0.49741735537190085;0.7761582509109839;83;90;2904;1921;0.028581267217630855;0.04685059864653826;.\data\pcb_defects_kaggle\images/Missing_hole/07_missing_hole_09.jpg;1
263;missing_hole;2048;291;2134;374;.\data\pcb_defects_kaggle\Annotations\Missing_hole\07_missing_hole_10;0.7200413223140496;0.1730869338885997;86;83;2904;1921;0.029614325068870524;0.04320666319625195;.\data\pcb_defects_kaggle\images/Missing_hole/07_missing_hole_10.jpg;1
264;missing_hole;2046;736;2113;791;.\data\pcb_defects_kaggle\Annotations\Missing_hole\07_missing_hole_10;0.7160812672176309;0.39744924518479957;67;55;2904;1921;0.023071625344352618;0.028630921395106715;.\data\pcb_defects_kaggle\images/Missing_hole/07_missing_hole_10.jpg;1
265;missing_hole;1377;519;1456;594;.\data\pcb_defects_kaggle\Annotations\Missing_hole\07_missing_hole_10;0.4877754820936639;0.2896928682977616;79;75;2904;1921;0.027203856749311296;0.039042165538781884;.\data\pcb_defects_kaggle\images/Missing_hole/07_missing_hole_10.jpg;1
266;missing_hole;737;553;844;641;.\data\pcb_defects_kaggle\Annotations\Missing_hole\07_missing_hole_10;0.2722107438016529;0.3107756376887038;107;88;2904;1921;0.03684573002754821;0.045809474232170744;.\data\pcb_defects_kaggle\images/Missing_hole/07_missing_hole_10.jpg;1
267;missing_hole;423;544;513;638;.\data\pcb_defects_kaggle\Annotations\Missing_hole\07_missing_hole_10;0.16115702479338842;0.30765226444560123;90;94;2904;1921;0.030991735537190084;0.048932847475273294;.\data\pcb_defects_kaggle\images/Missing_hole/07_missing_hole_10.jpg;1
268;missing_hole;2325;1193;2378;1252;.\data\pcb_defects_kaggle\Annotations\Missing_hole\08_missing_hole_01;0.8523015585357013;0.5675487465181058;53;59;2759;2154;0.01920985864443639;0.027390900649953576;.\data\pcb_defects_kaggle\images/Missing_hole/08_missing_hole_01.jpg;1
269;missing_hole;1996;1603;2061;1670;.\data\pcb_defects_kaggle\Annotations\Missing_hole\08_missing_hole_01;0.7352301558535701;0.7597493036211699;65;67;2759;2154;0.02355926060166727;0.031104921077065924;.\data\pcb_defects_kaggle\images/Missing_hole/08_missing_hole_01.jpg;1
270;missing_hole;1169;1734;1233;1805;.\data\pcb_defects_kaggle\Annotations\Missing_hole\08_missing_hole_01;0.43530264588619066;0.8214948932219127;64;71;2759;2154;0.023196810438564697;0.032961931290622096;.\data\pcb_defects_kaggle\images/Missing_hole/08_missing_hole_01.jpg;1
271;missing_hole;1245;746;1310;808;.\data\pcb_defects_kaggle\Annotations\Missing_hole\08_missing_hole_01;0.4630300833635375;0.3607242339832869;65;62;2759;2154;0.02355926060166727;0.028783658310120707;.\data\pcb_defects_kaggle\images/Missing_hole/08_missing_hole_01.jpg;1
272;missing_hole;546;1441;610;1510;.\data\pcb_defects_kaggle\Annotations\Missing_hole\08_missing_hole_01;0.20949619427328742;0.6850046425255338;64;69;2759;2154;0.023196810438564697;0.03203342618384401;.\data\pcb_defects_kaggle\images/Missing_hole/08_missing_hole_01.jpg;1
273;missing_hole;2133;944;2197;1008;.\data\pcb_defects_kaggle\Annotations\Missing_hole\08_missing_hole_02;0.7847046031170714;0.4531104921077066;64;64;2759;2154;0.023196810438564697;0.029712163416898793;.\data\pcb_defects_kaggle\images/Missing_hole/08_missing_hole_02.jpg;1
274;missing_hole;2319;1328;2378;1392;.\data\pcb_defects_kaggle\Annotations\Missing_hole\08_missing_hole_02;0.8512142080463936;0.6313834726090993;59;64;2759;2154;0.02138455962305183;0.029712163416898793;.\data\pcb_defects_kaggle\images/Missing_hole/08_missing_hole_02.jpg;1
275;missing_hole;964;747;1028;805;.\data\pcb_defects_kaggle\Annotations\Missing_hole\08_missing_hole_02;0.3610003624501631;0.36025998142989785;64;58;2759;2154;0.023196810438564697;0.02692664809656453;.\data\pcb_defects_kaggle\images/Missing_hole/08_missing_hole_02.jpg;1
276;missing_hole;1823;1561;1891;1631;.\data\pcb_defects_kaggle\Annotations\Missing_hole\08_missing_hole_02;0.6730699528814788;0.7409470752089137;68;70;2759;2154;0.02464661109097499;0.032497678737233054;.\data\pcb_defects_kaggle\images/Missing_hole/08_missing_hole_02.jpg;1
277;missing_hole;1035;1441;1100;1515;.\data\pcb_defects_kaggle\Annotations\Missing_hole\08_missing_hole_02;0.3869155491119971;0.6861652739090065;65;74;2759;2154;0.02355926060166727;0.034354688950789226;.\data\pcb_defects_kaggle\images/Missing_hole/08_missing_hole_02.jpg;1
278;missing_hole;2459;1156;2523;1223;.\data\pcb_defects_kaggle\Annotations\Missing_hole\08_missing_hole_03;0.9028633562885103;0.5522284122562674;64;67;2759;2154;0.023196810438564697;0.031104921077065924;.\data\pcb_defects_kaggle\images/Missing_hole/08_missing_hole_03.jpg;1
279;missing_hole;819;1438;894;1525;.\data\pcb_defects_kaggle\Annotations\Missing_hole\08_missing_hole_03;0.3104385646973541;0.6877901578458682;75;87;2759;2154;0.027183762232693004;0.0403899721448468;.\data\pcb_defects_kaggle\images/Missing_hole/08_missing_hole_03.jpg;1
280;missing_hole;682;1731;748;1797;.\data\pcb_defects_kaggle\Annotations\Missing_hole\08_missing_hole_03;0.25915186661834;0.8189415041782729;66;66;2759;2154;0.023921710764769843;0.03064066852367688;.\data\pcb_defects_kaggle\images/Missing_hole/08_missing_hole_03.jpg;1
281;missing_hole;1381;1738;1450;1798;.\data\pcb_defects_kaggle\Annotations\Missing_hole\08_missing_hole_03;0.5130482058716926;0.8207985143918292;69;60;2759;2154;0.025009061254077564;0.027855153203342618;.\data\pcb_defects_kaggle\images/Missing_hole/08_missing_hole_03.jpg;1
282;missing_hole;1382;1444;1440;1510;.\data\pcb_defects_kaggle\Annotations\Missing_hole\08_missing_hole_03;0.5114171801377311;0.6857010213556175;58;66;2759;2154;0.021022109459949256;0.03064066852367688;.\data\pcb_defects_kaggle\images/Missing_hole/08_missing_hole_03.jpg;1
283;missing_hole;1037;1036;1099;1088;.\data\pcb_defects_kaggle\Annotations\Missing_hole\08_missing_hole_04;0.3870967741935484;0.49303621169916434;62;52;2759;2154;0.02247191011235955;0.02414113277623027;.\data\pcb_defects_kaggle\images/Missing_hole/08_missing_hole_04.jpg;1
284;missing_hole;1730;1039;1796;1098;.\data\pcb_defects_kaggle\Annotations\Missing_hole\08_missing_hole_04;0.6389996375498369;0.4960538532961931;66;59;2759;2154;0.023921710764769843;0.027390900649953576;.\data\pcb_defects_kaggle\images/Missing_hole/08_missing_hole_04.jpg;1
285;missing_hole;378;467;441;531;.\data\pcb_defects_kaggle\Annotations\Missing_hole\08_missing_hole_04;0.14842334179050382;0.23166202414113277;63;64;2759;2154;0.022834360275462123;0.029712163416898793;.\data\pcb_defects_kaggle\images/Missing_hole/08_missing_hole_04.jpg;1
286;missing_hole;155;977;212;1039;.\data\pcb_defects_kaggle\Annotations\Missing_hole\08_missing_hole_04;0.06650960492932222;0.467966573816156;57;62;2759;2154;0.020659659296846683;0.028783658310120707;.\data\pcb_defects_kaggle\images/Missing_hole/08_missing_hole_04.jpg;1
287;missing_hole;1176;1444;1241;1516;.\data\pcb_defects_kaggle\Annotations\Missing_hole\08_missing_hole_05;0.4380210221094599;0.6870937790157846;65;72;2759;2154;0.02355926060166727;0.033426183844011144;.\data\pcb_defects_kaggle\images/Missing_hole/08_missing_hole_05.jpg;1
288;missing_hole;966;741;1037;813;.\data\pcb_defects_kaggle\Annotations\Missing_hole\08_missing_hole_05;0.36299383834722726;0.3607242339832869;71;72;2759;2154;0.02573396158028271;0.033426183844011144;.\data\pcb_defects_kaggle\images/Missing_hole/08_missing_hole_05.jpg;1
289;missing_hole;159;982;214;1031;.\data\pcb_defects_kaggle\Annotations\Missing_hole\08_missing_hole_05;0.06759695541862994;0.4672701949860724;55;49;2759;2154;0.019934758970641536;0.02274837511606314;.\data\pcb_defects_kaggle\images/Missing_hole/08_missing_hole_05.jpg;1
290;missing_hole;2002;405;2064;462;.\data\pcb_defects_kaggle\Annotations\Missing_hole\08_missing_hole_05;0.7368611815875317;0.2012534818941504;62;57;2759;2154;0.02247191011235955;0.026462395543175487;.\data\pcb_defects_kaggle\images/Missing_hole/08_missing_hole_05.jpg;1
291;missing_hole;238;634;304;692;.\data\pcb_defects_kaggle\Annotations\Missing_hole\08_missing_hole_05;0.09822399420079739;0.30779944289693595;66;58;2759;2154;0.023921710764769843;0.02692664809656453;.\data\pcb_defects_kaggle\images/Missing_hole/08_missing_hole_05.jpg;1
292;missing_hole;1387;1030;1448;1097;.\data\pcb_defects_kaggle\Annotations\Missing_hole\08_missing_hole_06;0.5137731061978978;0.4937325905292479;61;67;2759;2154;0.022109459949256977;0.031104921077065924;.\data\pcb_defects_kaggle\images/Missing_hole/08_missing_hole_06.jpg;1
293;missing_hole;2004;1608;2061;1666;.\data\pcb_defects_kaggle\Annotations\Missing_hole\08_missing_hole_06;0.7366799565059804;0.7599814298978644;57;58;2759;2154;0.020659659296846683;0.02692664809656453;.\data\pcb_defects_kaggle\images/Missing_hole/08_missing_hole_06.jpg;1
294;missing_hole;1100;1451;1169;1513;.\data\pcb_defects_kaggle\Annotations\Missing_hole\08_missing_hole_06;0.4111997100398695;0.6880222841225627;69;62;2759;2154;0.025009061254077564;0.028783658310120707;.\data\pcb_defects_kaggle\images/Missing_hole/08_missing_hole_06.jpg;1
295;missing_hole;1878;751;1937;810;.\data\pcb_defects_kaggle\Annotations\Missing_hole\08_missing_hole_06;0.6913736861181587;0.36234911792014857;59;59;2759;2154;0.02138455962305183;0.027390900649953576;.\data\pcb_defects_kaggle\images/Missing_hole/08_missing_hole_06.jpg;1
296;missing_hole;1727;2000;1792;2067;.\data\pcb_defects_kaggle\Annotations\Missing_hole\08_missing_hole_06;0.6377310619789779;0.9440575673166203;65;67;2759;2154;0.02355926060166727;0.031104921077065924;.\data\pcb_defects_kaggle\images/Missing_hole/08_missing_hole_06.jpg;1
297;missing_hole;1876;1036;1941;1098;.\data\pcb_defects_kaggle\Annotations\Missing_hole\08_missing_hole_07;0.6917361362812613;0.49535747446610956;65;62;2759;2154;0.02355926060166727;0.028783658310120707;.\data\pcb_defects_kaggle\images/Missing_hole/08_missing_hole_07.jpg;1
298;missing_hole;2128;941;2200;1020;.\data\pcb_defects_kaggle\Annotations\Missing_hole\08_missing_hole_07;0.7843421529539688;0.45519962859795726;72;79;2759;2154;0.026096411743385284;0.03667595171773445;.\data\pcb_defects_kaggle\images/Missing_hole/08_missing_hole_07.jpg;1
299;missing_hole;368;1931;438;2002;.\data\pcb_defects_kaggle\Annotations\Missing_hole\08_missing_hole_07;0.14606741573033707;0.9129526462395543;70;71;2759;2154;0.025371511417180137;0.032961931290622096;.\data\pcb_defects_kaggle\images/Missing_hole/08_missing_hole_07.jpg;1
300;missing_hole;145;1118;220;1187;.\data\pcb_defects_kaggle\Annotations\Missing_hole\08_missing_hole_07;0.06614715476621964;0.5350510677808727;75;69;2759;2154;0.027183762232693004;0.03203342618384401;.\data\pcb_defects_kaggle\images/Missing_hole/08_missing_hole_07.jpg;1
301;missing_hole;546;739;614;811;.\data\pcb_defects_kaggle\Annotations\Missing_hole\08_missing_hole_07;0.21022109459949256;0.35979572887650885;68;72;2759;2154;0.02464661109097499;0.033426183844011144;.\data\pcb_defects_kaggle\images/Missing_hole/08_missing_hole_07.jpg;1
302;missing_hole;1304;1444;1381;1518;.\data\pcb_defects_kaggle\Annotations\Missing_hole\08_missing_hole_08;0.48658934396520476;0.6875580315691736;77;74;2759;2154;0.02790866255889815;0.034354688950789226;.\data\pcb_defects_kaggle\images/Missing_hole/08_missing_hole_08.jpg;1
303;missing_hole;2312;1051;2384;1116;.\data\pcb_defects_kaggle\Annotations\Missing_hole\08_missing_hole_08;0.8510329829648423;0.5030176415970288;72;65;2759;2154;0.026096411743385284;0.030176415970287838;.\data\pcb_defects_kaggle\images/Missing_hole/08_missing_hole_08.jpg;1
304;missing_hole;2609;1220;2668;1275;.\data\pcb_defects_kaggle\Annotations\Missing_hole\08_missing_hole_08;0.9563247553461399;0.5791550603528319;59;55;2759;2154;0.02138455962305183;0.0255338904363974;.\data\pcb_defects_kaggle\images/Missing_hole/08_missing_hole_08.jpg;1
305;missing_hole;2123;1425;2192;1497;.\data\pcb_defects_kaggle\Annotations\Missing_hole\08_missing_hole_08;0.7819862268938021;0.6782729805013927;69;72;2759;2154;0.025009061254077564;0.033426183844011144;.\data\pcb_defects_kaggle\images/Missing_hole/08_missing_hole_08.jpg;1
306;missing_hole;617;744;681;805;.\data\pcb_defects_kaggle\Annotations\Missing_hole\08_missing_hole_08;0.23523015585357013;0.3595636025998143;64;61;2759;2154;0.023196810438564697;0.028319405756731662;.\data\pcb_defects_kaggle\images/Missing_hole/08_missing_hole_08.jpg;1
307;missing_hole;966;746;1030;806;.\data\pcb_defects_kaggle\Annotations\Missing_hole\08_missing_hole_09;0.36172526277636824;0.36025998142989785;64;60;2759;2154;0.023196810438564697;0.027855153203342618;.\data\pcb_defects_kaggle\images/Missing_hole/08_missing_hole_09.jpg;1
308;missing_hole;823;1034;889;1098;.\data\pcb_defects_kaggle\Annotations\Missing_hole\08_missing_hole_09;0.3102573396158028;0.4948932219127205;66;64;2759;2154;0.023921710764769843;0.029712163416898793;.\data\pcb_defects_kaggle\images/Missing_hole/08_missing_hole_09.jpg;1
309;missing_hole;1658;1449;1725;1520;.\data\pcb_defects_kaggle\Annotations\Missing_hole\08_missing_hole_09;0.6130844508880029;0.6891829155060353;67;71;2759;2154;0.024284160927872417;0.032961931290622096;.\data\pcb_defects_kaggle\images/Missing_hole/08_missing_hole_09.jpg;1
310;missing_hole;1997;1606;2061;1664;.\data\pcb_defects_kaggle\Annotations\Missing_hole\08_missing_hole_09;0.7354113809351214;0.7590529247910863;64;58;2759;2154;0.023196810438564697;0.02692664809656453;.\data\pcb_defects_kaggle\images/Missing_hole/08_missing_hole_09.jpg;1
311;missing_hole;1720;544;1786;605;.\data\pcb_defects_kaggle\Annotations\Missing_hole\08_missing_hole_09;0.6353751359188111;0.2667130919220056;66;61;2759;2154;0.023921710764769843;0.028319405756731662;.\data\pcb_defects_kaggle\images/Missing_hole/08_missing_hole_09.jpg;1
312;missing_hole;1876;1036;1938;1092;.\data\pcb_defects_kaggle\Annotations\Missing_hole\08_missing_hole_10;0.6911924610366075;0.49396471680594245;62;56;2759;2154;0.02247191011235955;0.025998142989786442;.\data\pcb_defects_kaggle\images/Missing_hole/08_missing_hole_10.jpg;1
313;missing_hole;822;1444;886;1513;.\data\pcb_defects_kaggle\Annotations\Missing_hole\08_missing_hole_10;0.30953243928959767;0.6863974001857011;64;69;2759;2154;0.023196810438564697;0.03203342618384401;.\data\pcb_defects_kaggle\images/Missing_hole/08_missing_hole_10.jpg;1
314;missing_hole;238;633;304;687;.\data\pcb_defects_kaggle\Annotations\Missing_hole\08_missing_hole_10;0.09822399420079739;0.3064066852367688;66;54;2759;2154;0.023921710764769843;0.025069637883008356;.\data\pcb_defects_kaggle\images/Missing_hole/08_missing_hole_10.jpg;1
315;missing_hole;2291;1639;2345;1702;.\data\pcb_defects_kaggle\Annotations\Missing_hole\08_missing_hole_10;0.8401594780717652;0.7755338904363974;54;63;2759;2154;0.019572308807538963;0.02924791086350975;.\data\pcb_defects_kaggle\images/Missing_hole/08_missing_hole_10.jpg;1
316;missing_hole;1948;1382;1989;1423;.\data\pcb_defects_kaggle\Annotations\Missing_hole\08_missing_hole_10;0.7134831460674157;0.6511142061281338;41;41;2759;2154;0.014860456687205509;0.01903435468895079;.\data\pcb_defects_kaggle\images/Missing_hole/08_missing_hole_10.jpg;1
317;missing_hole;2025;499;2086;564;.\data\pcb_defects_kaggle\Annotations\Missing_hole\09_missing_hole_01;0.7407207207207207;0.24617878647522;61;65;2775;2159;0.021981981981981983;0.030106530801296896;.\data\pcb_defects_kaggle\images/Missing_hole/09_missing_hole_01.jpg;1
318;missing_hole;2336;987;2399;1043;.\data\pcb_defects_kaggle\Annotations\Missing_hole\09_missing_hole_01;0.8531531531531531;0.4701250578971746;63;56;2775;2159;0.022702702702702703;0.025937934228809634;.\data\pcb_defects_kaggle\images/Missing_hole/09_missing_hole_01.jpg;1
319;missing_hole;2231;1877;2307;1945;.\data\pcb_defects_kaggle\Annotations\Missing_hole\09_missing_hole_01;0.8176576576576576;0.8851320055581288;76;68;2775;2159;0.02738738738738739;0.031496062992125984;.\data\pcb_defects_kaggle\images/Missing_hole/09_missing_hole_01.jpg;1
320;missing_hole;1186;1700;1240;1753;.\data\pcb_defects_kaggle\Annotations\Missing_hole\09_missing_hole_01;0.4371171171171171;0.7996757758221399;54;53;2775;2159;0.01945945945945946;0.024548402037980546;.\data\pcb_defects_kaggle\images/Missing_hole/09_missing_hole_01.jpg;1
321;missing_hole;1122;1059;1187;1122;.\data\pcb_defects_kaggle\Annotations\Missing_hole\09_missing_hole_01;0.41603603603603606;0.5050949513663733;65;63;2775;2159;0.023423423423423424;0.029180176007410838;.\data\pcb_defects_kaggle\images/Missing_hole/09_missing_hole_01.jpg;1
322;missing_hole;777;640;836;704;.\data\pcb_defects_kaggle\Annotations\Missing_hole\09_missing_hole_02;0.2906306306306306;0.3112552107457156;59;64;2775;2159;0.021261261261261263;0.029643353404353867;.\data\pcb_defects_kaggle\images/Missing_hole/09_missing_hole_02.jpg;1
323;missing_hole;1195;643;1258;708;.\data\pcb_defects_kaggle\Annotations\Missing_hole\09_missing_hole_02;0.44198198198198196;0.3128763316350162;63;65;2775;2159;0.022702702702702703;0.030106530801296896;.\data\pcb_defects_kaggle\images/Missing_hole/09_missing_hole_02.jpg;1
324;missing_hole;387;1446;453;1508;.\data\pcb_defects_kaggle\Annotations\Missing_hole\09_missing_hole_02;0.15135135135135136;0.6841130152848541;66;62;2775;2159;0.023783783783783784;0.02871699861046781;.\data\pcb_defects_kaggle\images/Missing_hole/09_missing_hole_02.jpg;1
325;missing_hole;2467;1551;2536;1622;.\data\pcb_defects_kaggle\Annotations\Missing_hole\09_missing_hole_02;0.9014414414414414;0.7348309402501157;69;71;2775;2159;0.024864864864864864;0.03288559518295507;.\data\pcb_defects_kaggle\images/Missing_hole/09_missing_hole_02.jpg;1
326;missing_hole;912;353;981;413;.\data\pcb_defects_kaggle\Annotations\Missing_hole\09_missing_hole_02;0.3410810810810811;0.1773969430291802;69;60;2775;2159;0.024864864864864864;0.02779064381658175;.\data\pcb_defects_kaggle\images/Missing_hole/09_missing_hole_02.jpg;1
327;missing_hole;1543;358;1612;422;.\data\pcb_defects_kaggle\Annotations\Missing_hole\09_missing_hole_03;0.5684684684684684;0.18063918480778138;69;64;2775;2159;0.024864864864864864;0.029643353404353867;.\data\pcb_defects_kaggle\images/Missing_hole/09_missing_hole_03.jpg;1
328;missing_hole;1897;646;1961;720;.\data\pcb_defects_kaggle\Annotations\Missing_hole\09_missing_hole_03;0.6951351351351351;0.31635016211208894;64;74;2775;2159;0.023063063063063063;0.03427512737378416;.\data\pcb_defects_kaggle\images/Missing_hole/09_missing_hole_03.jpg;1
329;missing_hole;563;1058;630;1118;.\data\pcb_defects_kaggle\Annotations\Missing_hole\09_missing_hole_03;0.21495495495495495;0.5039370078740157;67;60;2775;2159;0.024144144144144144;0.02779064381658175;.\data\pcb_defects_kaggle\images/Missing_hole/09_missing_hole_03.jpg;1
330;missing_hole;199;638;276;704;.\data\pcb_defects_kaggle\Annotations\Missing_hole\09_missing_hole_03;0.08558558558558559;0.3107920333487726;77;66;2775;2159;0.02774774774774775;0.030569708198239925;.\data\pcb_defects_kaggle\images/Missing_hole/09_missing_hole_03.jpg;1
331;missing_hole;1833;97;1900;158;.\data\pcb_defects_kaggle\Annotations\Missing_hole\09_missing_hole_03;0.6726126126126126;0.05905511811023622;67;61;2775;2159;0.024144144144144144;0.02825382121352478;.\data\pcb_defects_kaggle\images/Missing_hole/09_missing_hole_03.jpg;1
332;missing_hole;1120;356;1194;413;.\data\pcb_defects_kaggle\Annotations\Missing_hole\09_missing_hole_04;0.41693693693693695;0.1780917091245947;74;57;2775;2159;0.02666666666666667;0.026401111625752663;.\data\pcb_defects_kaggle\images/Missing_hole/09_missing_hole_04.jpg;1
333;missing_hole;567;1058;625;1118;.\data\pcb_defects_kaggle\Annotations\Missing_hole\09_missing_hole_04;0.21477477477477477;0.5039370078740157;58;60;2775;2159;0.020900900900900903;0.02779064381658175;.\data\pcb_defects_kaggle\images/Missing_hole/09_missing_hole_04.jpg;1
334;missing_hole;845;1340;904;1408;.\data\pcb_defects_kaggle\Annotations\Missing_hole\09_missing_hole_04;0.31513513513513514;0.6364057433997221;59;68;2775;2159;0.021261261261261263;0.031496062992125984;.\data\pcb_defects_kaggle\images/Missing_hole/09_missing_hole_04.jpg;1
335;missing_hole;2148;1154;2212;1223;.\data\pcb_defects_kaggle\Annotations\Missing_hole\09_missing_hole_04;0.7855855855855856;0.5504863362667902;64;69;2775;2159;0.023063063063063063;0.03195924038906901;.\data\pcb_defects_kaggle\images/Missing_hole/09_missing_hole_04.jpg;1
336;missing_hole;2151;674;2215;740;.\data\pcb_defects_kaggle\Annotations\Missing_hole\09_missing_hole_04;0.7866666666666666;0.32746641963872164;64;66;2775;2159;0.023063063063063063;0.030569708198239925;.\data\pcb_defects_kaggle\images/Missing_hole/09_missing_hole_04.jpg;1
337;missing_hole;1328;1059;1395;1125;.\data\pcb_defects_kaggle\Annotations\Missing_hole\09_missing_hole_04;0.4906306306306306;0.5057897174617879;67;66;2775;2159;0.024144144144144144;0.030569708198239925;.\data\pcb_defects_kaggle\images/Missing_hole/09_missing_hole_04.jpg;1
338;missing_hole;1264;645;1325;697;.\data\pcb_defects_kaggle\Annotations\Missing_hole\09_missing_hole_05;0.4664864864864865;0.3107920333487726;61;52;2775;2159;0.021981981981981983;0.024085224641037517;.\data\pcb_defects_kaggle\images/Missing_hole/09_missing_hole_05.jpg;1
339;missing_hole;202;710;266;768;.\data\pcb_defects_kaggle\Annotations\Missing_hole\09_missing_hole_05;0.08432432432432432;0.3422880963408986;64;58;2775;2159;0.023063063063063063;0.026864289022695692;.\data\pcb_defects_kaggle\images/Missing_hole/09_missing_hole_05.jpg;1
340;missing_hole;2625;754;2689;818;.\data\pcb_defects_kaggle\Annotations\Missing_hole\09_missing_hole_05;0.9574774774774775;0.36405743399722096;64;64;2775;2159;0.023063063063063063;0.029643353404353867;.\data\pcb_defects_kaggle\images/Missing_hole/09_missing_hole_05.jpg;1
341;missing_hole;2025;504;2079;556;.\data\pcb_defects_kaggle\Annotations\Missing_hole\09_missing_hole_05;0.7394594594594595;0.24548402037980546;54;52;2775;2159;0.01945945945945946;0.024085224641037517;.\data\pcb_defects_kaggle\images/Missing_hole/09_missing_hole_05.jpg;1
342;missing_hole;1733;1556;1790;1612;.\data\pcb_defects_kaggle\Annotations\Missing_hole\09_missing_hole_05;0.6347747747747747;0.7336729967577582;57;56;2775;2159;0.02054054054054054;0.025937934228809634;.\data\pcb_defects_kaggle\images/Missing_hole/09_missing_hole_05.jpg;1
343;missing_hole;1413;648;1463;699;.\data\pcb_defects_kaggle\Annotations\Missing_hole\09_missing_hole_06;0.5181981981981982;0.3119499768411301;50;51;2775;2159;0.018018018018018018;0.023622047244094488;.\data\pcb_defects_kaggle\images/Missing_hole/09_missing_hole_06.jpg;1
344;missing_hole;1712;540;1772;599;.\data\pcb_defects_kaggle\Annotations\Missing_hole\09_missing_hole_06;0.6277477477477478;0.2637795275590551;60;59;2775;2159;0.021621621621621623;0.02732746641963872;.\data\pcb_defects_kaggle\images/Missing_hole/09_missing_hole_06.jpg;1
345;missing_hole;2335;771;2413;838;.\data\pcb_defects_kaggle\Annotations\Missing_hole\09_missing_hole_06;0.8554954954954955;0.37262621584066696;78;67;2775;2159;0.02810810810810811;0.031032885595182955;.\data\pcb_defects_kaggle\images/Missing_hole/09_missing_hole_06.jpg;1
346;missing_hole;1182;1545;1243;1605;.\data\pcb_defects_kaggle\Annotations\Missing_hole\09_missing_hole_06;0.4369369369369369;0.729504400185271;61;60;2775;2159;0.021981981981981983;0.02779064381658175;.\data\pcb_defects_kaggle\images/Missing_hole/09_missing_hole_06.jpg;1
347;missing_hole;561;1059;631;1120;.\data\pcb_defects_kaggle\Annotations\Missing_hole\09_missing_hole_06;0.21477477477477477;0.5046317739694303;70;61;2775;2159;0.025225225225225224;0.02825382121352478;.\data\pcb_defects_kaggle\images/Missing_hole/09_missing_hole_06.jpg;1
348;missing_hole;256;1449;315;1505;.\data\pcb_defects_kaggle\Annotations\Missing_hole\09_missing_hole_06;0.10288288288288289;0.6841130152848541;59;56;2775;2159;0.021261261261261263;0.025937934228809634;.\data\pcb_defects_kaggle\images/Missing_hole/09_missing_hole_06.jpg;1
349;missing_hole;200;572;266;627;.\data\pcb_defects_kaggle\Annotations\Missing_hole\09_missing_hole_07;0.08396396396396397;0.277674849467346;66;55;2775;2159;0.023783783783783784;0.025474756831866605;.\data\pcb_defects_kaggle\images/Missing_hole/09_missing_hole_07.jpg;1
350;missing_hole;1474;1059;1531;1122;.\data\pcb_defects_kaggle\Annotations\Missing_hole\09_missing_hole_07;0.5414414414414415;0.5050949513663733;57;63;2775;2159;0.02054054054054054;0.029180176007410838;.\data\pcb_defects_kaggle\images/Missing_hole/09_missing_hole_07.jpg;1
351;missing_hole;2472;881;2543;941;.\data\pcb_defects_kaggle\Annotations\Missing_hole\09_missing_hole_07;0.9036036036036036;0.4219546086150996;71;60;2775;2159;0.025585585585585584;0.02779064381658175;.\data\pcb_defects_kaggle\images/Missing_hole/09_missing_hole_07.jpg;1
352;missing_hole;1610;643;1677;713;.\data\pcb_defects_kaggle\Annotations\Missing_hole\09_missing_hole_07;0.5922522522522522;0.3140342751273738;67;70;2775;2159;0.024144144144144144;0.03242241778601204;.\data\pcb_defects_kaggle\images/Missing_hole/09_missing_hole_07.jpg;1
353;missing_hole;846;1343;902;1400;.\data\pcb_defects_kaggle\Annotations\Missing_hole\09_missing_hole_07;0.31495495495495496;0.6352477999073646;56;57;2775;2159;0.02018018018018018;0.026401111625752663;.\data\pcb_defects_kaggle\images/Missing_hole/09_missing_hole_07.jpg;1
354;missing_hole;2187;100;2245;163;.\data\pcb_defects_kaggle\Annotations\Missing_hole\09_missing_hole_07;0.7985585585585585;0.060907827698008336;58;63;2775;2159;0.020900900900900903;0.029180176007410838;.\data\pcb_defects_kaggle\images/Missing_hole/09_missing_hole_07.jpg;1
355;missing_hole;638;353;700;410;.\data\pcb_defects_kaggle\Annotations\Missing_hole\09_missing_hole_08;0.2410810810810811;0.17670217693376564;62;57;2775;2159;0.022342342342342343;0.026401111625752663;.\data\pcb_defects_kaggle\images/Missing_hole/09_missing_hole_08.jpg;1
356;missing_hole;176;1107;233;1166;.\data\pcb_defects_kaggle\Annotations\Missing_hole\09_missing_hole_08;0.07369369369369369;0.5264011116257526;57;59;2775;2159;0.02054054054054054;0.02732746641963872;.\data\pcb_defects_kaggle\images/Missing_hole/09_missing_hole_08.jpg;1
357;missing_hole;1266;1063;1323;1122;.\data\pcb_defects_kaggle\Annotations\Missing_hole\09_missing_hole_08;0.4664864864864865;0.5060213061602594;57;59;2775;2159;0.02054054054054054;0.02732746641963872;.\data\pcb_defects_kaggle\images/Missing_hole/09_missing_hole_08.jpg;1
358;missing_hole;256;1449;308;1510;.\data\pcb_defects_kaggle\Annotations\Missing_hole\09_missing_hole_08;0.10162162162162162;0.6852709587772117;52;61;2775;2159;0.018738738738738738;0.02825382121352478;.\data\pcb_defects_kaggle\images/Missing_hole/09_missing_hole_08.jpg;1
359;missing_hole;2481;676;2540;731;.\data\pcb_defects_kaggle\Annotations\Missing_hole\09_missing_hole_08;0.9046846846846847;0.32584529874942103;59;55;2775;2159;0.021261261261261263;0.025474756831866605;.\data\pcb_defects_kaggle\images/Missing_hole/09_missing_hole_08.jpg;1
360;missing_hole;2631;966;2686;1025;.\data\pcb_defects_kaggle\Annotations\Missing_hole\09_missing_hole_09;0.958018018018018;0.46109309865678555;55;59;2775;2159;0.01981981981981982;0.02732746641963872;.\data\pcb_defects_kaggle\images/Missing_hole/09_missing_hole_09.jpg;1
361;missing_hole;2467;1553;2528;1612;.\data\pcb_defects_kaggle\Annotations\Missing_hole\09_missing_hole_09;0.9;0.7329782306623437;61;59;2775;2159;0.021981981981981983;0.02732746641963872;.\data\pcb_defects_kaggle\images/Missing_hole/09_missing_hole_09.jpg;1
362;missing_hole;1536;1350;1610;1410;.\data\pcb_defects_kaggle\Annotations\Missing_hole\09_missing_hole_09;0.5668468468468468;0.6391848077813803;74;60;2775;2159;0.02666666666666667;0.02779064381658175;.\data\pcb_defects_kaggle\images/Missing_hole/09_missing_hole_09.jpg;1
363;missing_hole;772;1054;835;1117;.\data\pcb_defects_kaggle\Annotations\Missing_hole\09_missing_hole_09;0.28954954954954953;0.5027790643816582;63;63;2775;2159;0.022702702702702703;0.029180176007410838;.\data\pcb_defects_kaggle\images/Missing_hole/09_missing_hole_09.jpg;1
364;missing_hole;1197;643;1256;703;.\data\pcb_defects_kaggle\Annotations\Missing_hole\09_missing_hole_09;0.44198198198198196;0.3117183881426586;59;60;2775;2159;0.021261261261261263;0.02779064381658175;.\data\pcb_defects_kaggle\images/Missing_hole/09_missing_hole_09.jpg;1
365;missing_hole;1194;643;1256;707;.\data\pcb_defects_kaggle\Annotations\Missing_hole\09_missing_hole_10;0.44144144144144143;0.3126447429365447;62;64;2775;2159;0.022342342342342343;0.029643353404353867;.\data\pcb_defects_kaggle\images/Missing_hole/09_missing_hole_10.jpg;1
366;missing_hole;1545;356;1613;425;.\data\pcb_defects_kaggle\Annotations\Missing_hole\09_missing_hole_10;0.569009009009009;0.18087077350625289;68;69;2775;2159;0.024504504504504504;0.03195924038906901;.\data\pcb_defects_kaggle\images/Missing_hole/09_missing_hole_10.jpg;1
367;missing_hole;1333;1061;1394;1125;.\data\pcb_defects_kaggle\Annotations\Missing_hole\09_missing_hole_10;0.49135135135135133;0.5062528948587309;61;64;2775;2159;0.021981981981981983;0.029643353404353867;.\data\pcb_defects_kaggle\images/Missing_hole/09_missing_hole_10.jpg;1
368;missing_hole;2007;1551;2072;1615;.\data\pcb_defects_kaggle\Annotations\Missing_hole\09_missing_hole_10;0.734954954954955;0.7332098193608152;65;64;2775;2159;0.023423423423423424;0.029643353404353867;.\data\pcb_defects_kaggle\images/Missing_hole/09_missing_hole_10.jpg;1
369;missing_hole;566;636;628;705;.\data\pcb_defects_kaggle\Annotations\Missing_hole\09_missing_hole_10;0.21513513513513513;0.3105604446503011;62;69;2775;2159;0.022342342342342343;0.03195924038906901;.\data\pcb_defects_kaggle\images/Missing_hole/09_missing_hole_10.jpg;1
370;missing_hole;1346;677;1479;789;.\data\pcb_defects_kaggle\Annotations\Missing_hole\10_missing_hole_01;0.6305803571428571;0.3635912698412698;133;112;2240;2016;0.059375;0.05555555555555555;.\data\pcb_defects_kaggle\images/Missing_hole/10_missing_hole_01.jpg;1
371;missing_hole;1907;490;1982;571;.\data\pcb_defects_kaggle\Annotations\Missing_hole\10_missing_hole_01;0.8680803571428571;0.2631448412698413;75;81;2240;2016;0.033482142857142856;0.04017857142857143;.\data\pcb_defects_kaggle\images/Missing_hole/10_missing_hole_01.jpg;1
372;missing_hole;1963;651;2053;727;.\data\pcb_defects_kaggle\Annotations\Missing_hole\10_missing_hole_01;0.8964285714285715;0.341765873015873;90;76;2240;2016;0.04017857142857143;0.037698412698412696;.\data\pcb_defects_kaggle\images/Missing_hole/10_missing_hole_01.jpg;1
373;missing_hole;1794;1144;1891;1234;.\data\pcb_defects_kaggle\Annotations\Missing_hole\10_missing_hole_01;0.8225446428571429;0.589781746031746;97;90;2240;2016;0.04330357142857143;0.044642857142857144;.\data\pcb_defects_kaggle\images/Missing_hole/10_missing_hole_01.jpg;1
374;missing_hole;1017;1270;1111;1350;.\data\pcb_defects_kaggle\Annotations\Missing_hole\10_missing_hole_01;0.475;0.6498015873015873;94;80;2240;2016;0.04196428571428571;0.03968253968253968;.\data\pcb_defects_kaggle\images/Missing_hole/10_missing_hole_01.jpg;1
375;missing_hole;945;692;1052;780;.\data\pcb_defects_kaggle\Annotations\Missing_hole\10_missing_hole_02;0.44575892857142857;0.36507936507936506;107;88;2240;2016;0.04776785714285714;0.04365079365079365;.\data\pcb_defects_kaggle\images/Missing_hole/10_missing_hole_02.jpg;1
376;missing_hole;588;783;717;892;.\data\pcb_defects_kaggle\Annotations\Missing_hole\10_missing_hole_02;0.29129464285714285;0.4154265873015873;129;109;2240;2016;0.05758928571428571;0.05406746031746032;.\data\pcb_defects_kaggle\images/Missing_hole/10_missing_hole_02.jpg;1
377;missing_hole;908;1085;1003;1164;.\data\pcb_defects_kaggle\Annotations\Missing_hole\10_missing_hole_02;0.4265625;0.5577876984126984;95;79;2240;2016;0.04241071428571429;0.039186507936507936;.\data\pcb_defects_kaggle\images/Missing_hole/10_missing_hole_02.jpg;1
378;missing_hole;1419;1113;1491;1174;.\data\pcb_defects_kaggle\Annotations\Missing_hole\10_missing_hole_02;0.6495535714285714;0.5672123015873016;72;61;2240;2016;0.03214285714285714;0.030257936507936508;.\data\pcb_defects_kaggle\images/Missing_hole/10_missing_hole_02.jpg;1
379;missing_hole;2014;1351;2085;1431;.\data\pcb_defects_kaggle\Annotations\Missing_hole\10_missing_hole_02;0.9149553571428571;0.6899801587301587;71;80;2240;2016;0.03169642857142857;0.03968253968253968;.\data\pcb_defects_kaggle\images/Missing_hole/10_missing_hole_02.jpg;1
380;missing_hole;1301;335;1363;399;.\data\pcb_defects_kaggle\Annotations\Missing_hole\10_missing_hole_03;0.5946428571428571;0.18204365079365079;62;64;2240;2016;0.027678571428571427;0.031746031746031744;.\data\pcb_defects_kaggle\images/Missing_hole/10_missing_hole_03.jpg;1
381;missing_hole;1521;786;1592;854;.\data\pcb_defects_kaggle\Annotations\Missing_hole\10_missing_hole_03;0.6948660714285714;0.40674603174603174;71;68;2240;2016;0.03169642857142857;0.03373015873015873;.\data\pcb_defects_kaggle\images/Missing_hole/10_missing_hole_03.jpg;1
382;missing_hole;1420;1112;1488;1179;.\data\pcb_defects_kaggle\Annotations\Missing_hole\10_missing_hole_03;0.6491071428571429;0.5682043650793651;68;67;2240;2016;0.030357142857142857;0.033234126984126984;.\data\pcb_defects_kaggle\images/Missing_hole/10_missing_hole_03.jpg;1
383;missing_hole;1062;1428;1158;1516;.\data\pcb_defects_kaggle\Annotations\Missing_hole\10_missing_hole_03;0.4955357142857143;0.7301587301587301;96;88;2240;2016;0.04285714285714286;0.04365079365079365;.\data\pcb_defects_kaggle\images/Missing_hole/10_missing_hole_03.jpg;1
384;missing_hole;1340;1482;1408;1551;.\data\pcb_defects_kaggle\Annotations\Missing_hole\10_missing_hole_03;0.6133928571428572;0.7522321428571429;68;69;2240;2016;0.030357142857142857;0.03422619047619048;.\data\pcb_defects_kaggle\images/Missing_hole/10_missing_hole_03.jpg;1
385;missing_hole;720;971;843;1106;.\data\pcb_defects_kaggle\Annotations\Missing_hole\10_missing_hole_04;0.3488839285714286;0.5151289682539683;123;135;2240;2016;0.054910714285714285;0.06696428571428571;.\data\pcb_defects_kaggle\images/Missing_hole/10_missing_hole_04.jpg;1
386;missing_hole;1340;1480;1407;1547;.\data\pcb_defects_kaggle\Annotations\Missing_hole\10_missing_hole_04;0.6131696428571428;0.7507440476190477;67;67;2240;2016;0.029910714285714287;0.033234126984126984;.\data\pcb_defects_kaggle\images/Missing_hole/10_missing_hole_04.jpg;1
387;missing_hole;1659;1164;1743;1258;.\data\pcb_defects_kaggle\Annotations\Missing_hole\10_missing_hole_04;0.759375;0.6006944444444444;84;94;2240;2016;0.0375;0.04662698412698413;.\data\pcb_defects_kaggle\images/Missing_hole/10_missing_hole_04.jpg;1
388;missing_hole;2013;944;2088;1021;.\data\pcb_defects_kaggle\Annotations\Missing_hole\10_missing_hole_04;0.9154017857142858;0.48735119047619047;75;77;2240;2016;0.033482142857142856;0.03819444444444445;.\data\pcb_defects_kaggle\images/Missing_hole/10_missing_hole_04.jpg;1
389;missing_hole;1911;1567;1988;1635;.\data\pcb_defects_kaggle\Annotations\Missing_hole\10_missing_hole_04;0.8703125;0.7941468253968254;77;68;2240;2016;0.034375;0.03373015873015873;.\data\pcb_defects_kaggle\images/Missing_hole/10_missing_hole_04.jpg;1
390;missing_hole;1062;508;1153;592;.\data\pcb_defects_kaggle\Annotations\Missing_hole\10_missing_hole_05;0.49441964285714285;0.2728174603174603;91;84;2240;2016;0.040625;0.041666666666666664;.\data\pcb_defects_kaggle\images/Missing_hole/10_missing_hole_05.jpg;1
391;missing_hole;1632;258;1727;348;.\data\pcb_defects_kaggle\Annotations\Missing_hole\10_missing_hole_05;0.7497767857142857;0.15029761904761904;95;90;2240;2016;0.04241071428571429;0.044642857142857144;.\data\pcb_defects_kaggle\images/Missing_hole/10_missing_hole_05.jpg;1
392;missing_hole;940;692;1062;783;.\data\pcb_defects_kaggle\Annotations\Missing_hole\10_missing_hole_05;0.446875;0.3658234126984127;122;91;2240;2016;0.054464285714285715;0.04513888888888889;.\data\pcb_defects_kaggle\images/Missing_hole/10_missing_hole_05.jpg;1
393;missing_hole;1330;1637;1414;1715;.\data\pcb_defects_kaggle\Annotations\Missing_hole\10_missing_hole_05;0.6125;0.8313492063492064;84;78;2240;2016;0.0375;0.03869047619047619;.\data\pcb_defects_kaggle\images/Missing_hole/10_missing_hole_05.jpg;1
394;missing_hole;110;1796;223;1913;.\data\pcb_defects_kaggle\Annotations\Missing_hole\10_missing_hole_05;0.07433035714285714;0.919890873015873;113;117;2240;2016;0.05044642857142857;0.05803571428571429;.\data\pcb_defects_kaggle\images/Missing_hole/10_missing_hole_05.jpg;1
395;missing_hole;757;439;829;526;.\data\pcb_defects_kaggle\Annotations\Missing_hole\11_missing_hole_01;0.34750219106047325;0.214635231316726;72;87;2282;2248;0.03155127081507449;0.03870106761565836;.\data\pcb_defects_kaggle\images/Missing_hole/11_missing_hole_01.jpg;1
396;missing_hole;1227;596;1306;673;.\data\pcb_defects_kaggle\Annotations\Missing_hole\11_missing_hole_01;0.5549956178790535;0.2822508896797153;79;77;2282;2248;0.034618755477651184;0.03425266903914591;.\data\pcb_defects_kaggle\images/Missing_hole/11_missing_hole_01.jpg;1
397;missing_hole;1425;773;1512;862;.\data\pcb_defects_kaggle\Annotations\Missing_hole\11_missing_hole_01;0.6435144609991236;0.3636565836298932;87;89;2282;2248;0.03812445223488168;0.03959074733096085;.\data\pcb_defects_kaggle\images/Missing_hole/11_missing_hole_01.jpg;1
398;missing_hole;1437;1267;1507;1360;.\data\pcb_defects_kaggle\Annotations\Missing_hole\11_missing_hole_01;0.6450482033304119;0.584297153024911;70;93;2282;2248;0.03067484662576687;0.041370106761565835;.\data\pcb_defects_kaggle\images/Missing_hole/11_missing_hole_01.jpg;1
399;missing_hole;1196;1747;1275;1832;.\data\pcb_defects_kaggle\Annotations\Missing_hole\11_missing_hole_01;0.5414110429447853;0.796040925266904;79;85;2282;2248;0.034618755477651184;0.037811387900355875;.\data\pcb_defects_kaggle\images/Missing_hole/11_missing_hole_01.jpg;1
400;missing_hole;1158;222;1255;314;.\data\pcb_defects_kaggle\Annotations\Missing_hole\11_missing_hole_02;0.5287028921998247;0.11921708185053381;97;92;2282;2248;0.04250657318141981;0.04092526690391459;.\data\pcb_defects_kaggle\images/Missing_hole/11_missing_hole_02.jpg;1
401;missing_hole;1025;960;1096;1055;.\data\pcb_defects_kaggle\Annotations\Missing_hole\11_missing_hole_02;0.4647239263803681;0.4481761565836299;71;95;2282;2248;0.031113058720420684;0.04225978647686833;.\data\pcb_defects_kaggle\images/Missing_hole/11_missing_hole_02.jpg;1
402;missing_hole;1434;1260;1507;1363;.\data\pcb_defects_kaggle\Annotations\Missing_hole\11_missing_hole_02;0.6443908851884312;0.5834074733096085;73;103;2282;2248;0.031989482909728306;0.04581850533807829;.\data\pcb_defects_kaggle\images/Missing_hole/11_missing_hole_02.jpg;1
403;missing_hole;512;1265;586;1357;.\data\pcb_defects_kaggle\Annotations\Missing_hole\11_missing_hole_02;0.24057843996494302;0.583185053380783;74;92;2282;2248;0.03242769500438212;0.04092526690391459;.\data\pcb_defects_kaggle\images/Missing_hole/11_missing_hole_02.jpg;1
404;missing_hole;1594;1862;1668;1958;.\data\pcb_defects_kaggle\Annotations\Missing_hole\11_missing_hole_02;0.7147239263803681;0.849644128113879;74;96;2282;2248;0.03242769500438212;0.042704626334519574;.\data\pcb_defects_kaggle\images/Missing_hole/11_missing_hole_02.jpg;1
405;missing_hole;1420;447;1517;539;.\data\pcb_defects_kaggle\Annotations\Missing_hole\11_missing_hole_03;0.6435144609991236;0.21930604982206406;97;92;2282;2248;0.04250657318141981;0.04092526690391459;.\data\pcb_defects_kaggle\images/Missing_hole/11_missing_hole_03.jpg;1
406;missing_hole;953;747;1045;829;.\data\pcb_defects_kaggle\Annotations\Missing_hole\11_missing_hole_03;0.4377738825591586;0.3505338078291815;92;82;2282;2248;0.040315512708150744;0.036476868327402136;.\data\pcb_defects_kaggle\images/Missing_hole/11_missing_hole_03.jpg;1
407;missing_hole;294;740;389;824;.\data\pcb_defects_kaggle\Annotations\Missing_hole\11_missing_hole_03;0.14964943032427694;0.34786476868327404;95;84;2282;2248;0.04163014899211218;0.037366548042704624;.\data\pcb_defects_kaggle\images/Missing_hole/11_missing_hole_03.jpg;1
408;missing_hole;717;970;778;1044;.\data\pcb_defects_kaggle\Annotations\Missing_hole\11_missing_hole_03;0.3275635407537248;0.44795373665480426;61;74;2282;2248;0.02673093777388256;0.03291814946619217;.\data\pcb_defects_kaggle\images/Missing_hole/11_missing_hole_03.jpg;1
409;missing_hole;619;1442;681;1526;.\data\pcb_defects_kaggle\Annotations\Missing_hole\11_missing_hole_03;0.2848378615249781;0.6601423487544484;62;84;2282;2248;0.02716914986853637;0.037366548042704624;.\data\pcb_defects_kaggle\images/Missing_hole/11_missing_hole_03.jpg;1
410;missing_hole;411;747;476;813;.\data\pcb_defects_kaggle\Annotations\Missing_hole\11_missing_hole_04;0.1943470639789658;0.3469750889679715;65;66;2282;2248;0.02848378615249781;0.029359430604982206;.\data\pcb_defects_kaggle\images/Missing_hole/11_missing_hole_04.jpg;1
411;missing_hole;1553;683;1639;758;.\data\pcb_defects_kaggle\Annotations\Missing_hole\11_missing_hole_04;0.6993865030674846;0.3205071174377224;86;75;2282;2248;0.03768624014022787;0.03336298932384341;.\data\pcb_defects_kaggle\images/Missing_hole/11_missing_hole_04.jpg;1
412;missing_hole;1420;1467;1502;1553;.\data\pcb_defects_kaggle\Annotations\Missing_hole\11_missing_hole_04;0.64022787028922;0.6717081850533808;82;86;2282;2248;0.03593339176161262;0.03825622775800712;.\data\pcb_defects_kaggle\images/Missing_hole/11_missing_hole_04.jpg;1
413;missing_hole;863;1747;935;1839;.\data\pcb_defects_kaggle\Annotations\Missing_hole\11_missing_hole_04;0.3939526730937774;0.7975978647686833;72;92;2282;2248;0.03155127081507449;0.04092526690391459;.\data\pcb_defects_kaggle\images/Missing_hole/11_missing_hole_04.jpg;1
414;missing_hole;116;1776;255;1916;.\data\pcb_defects_kaggle\Annotations\Missing_hole\11_missing_hole_04;0.08128834355828221;0.8211743772241993;139;140;2282;2248;0.06091148115687993;0.06227758007117438;.\data\pcb_defects_kaggle\images/Missing_hole/11_missing_hole_04.jpg;1
415;missing_hole;1755;1749;1834;1842;.\data\pcb_defects_kaggle\Annotations\Missing_hole\11_missing_hole_05;0.7863716038562665;0.7987099644128114;79;93;2282;2248;0.034618755477651184;0.041370106761565835;.\data\pcb_defects_kaggle\images/Missing_hole/11_missing_hole_05.jpg;1
416;missing_hole;1417;1744;1499;1832;.\data\pcb_defects_kaggle\Annotations\Missing_hole\11_missing_hole_05;0.6389132340052586;0.7953736654804271;82;88;2282;2248;0.03593339176161262;0.03914590747330961;.\data\pcb_defects_kaggle\images/Missing_hole/11_missing_hole_05.jpg;1
417;missing_hole;2022;1806;2122;1899;.\data\pcb_defects_kaggle\Annotations\Missing_hole\11_missing_hole_05;0.9079754601226994;0.8240658362989324;100;93;2282;2248;0.04382120946538125;0.041370106761565835;.\data\pcb_defects_kaggle\images/Missing_hole/11_missing_hole_05.jpg;1
418;missing_hole;861;1749;939;1837;.\data\pcb_defects_kaggle\Annotations\Missing_hole\11_missing_hole_05;0.3943908851884312;0.7975978647686833;78;88;2282;2248;0.03418054338299737;0.03914590747330961;.\data\pcb_defects_kaggle\images/Missing_hole/11_missing_hole_05.jpg;1
419;missing_hole;1145;1868;1217;1952;.\data\pcb_defects_kaggle\Annotations\Missing_hole\11_missing_hole_05;0.5175284837861525;0.849644128113879;72;84;2282;2248;0.03155127081507449;0.037366548042704624;.\data\pcb_defects_kaggle\images/Missing_hole/11_missing_hole_05.jpg;1
420;missing_hole;1076;862;1150;940;.\data\pcb_defects_kaggle\Annotations\Missing_hole\11_missing_hole_06;0.48773006134969327;0.40080071174377224;74;78;2282;2248;0.03242769500438212;0.03469750889679715;.\data\pcb_defects_kaggle\images/Missing_hole/11_missing_hole_06.jpg;1
421;missing_hole;1161;729;1242;826;.\data\pcb_defects_kaggle\Annotations\Missing_hole\11_missing_hole_06;0.5265118317265557;0.3458629893238434;81;97;2282;2248;0.03549517966695881;0.04314946619217082;.\data\pcb_defects_kaggle\images/Missing_hole/11_missing_hole_06.jpg;1
422;missing_hole;1507;868;1586;947;.\data\pcb_defects_kaggle\Annotations\Missing_hole\11_missing_hole_06;0.6776950043821209;0.40369217081850534;79;79;2282;2248;0.034618755477651184;0.035142348754448396;.\data\pcb_defects_kaggle\images/Missing_hole/11_missing_hole_06.jpg;1
423;missing_hole;819;1268;896;1360;.\data\pcb_defects_kaggle\Annotations\Missing_hole\11_missing_hole_06;0.37576687116564417;0.5845195729537367;77;92;2282;2248;0.03374233128834356;0.04092526690391459;.\data\pcb_defects_kaggle\images/Missing_hole/11_missing_hole_06.jpg;1
424;missing_hole;527;1752;611;1837;.\data\pcb_defects_kaggle\Annotations\Missing_hole\11_missing_hole_06;0.24934268185801928;0.7982651245551602;84;85;2282;2248;0.03680981595092025;0.037811387900355875;.\data\pcb_defects_kaggle\images/Missing_hole/11_missing_hole_06.jpg;1
425;missing_hole;1170;737;1240;817;.\data\pcb_defects_kaggle\Annotations\Missing_hole\11_missing_hole_07;0.528045574057844;0.3456405693950178;70;80;2282;2248;0.03067484662576687;0.03558718861209965;.\data\pcb_defects_kaggle\images/Missing_hole/11_missing_hole_07.jpg;1
426;missing_hole;1330;968;1407;1049;.\data\pcb_defects_kaggle\Annotations\Missing_hole\11_missing_hole_07;0.5996932515337423;0.4486209964412811;77;81;2282;2248;0.03374233128834356;0.03603202846975089;.\data\pcb_defects_kaggle\images/Missing_hole/11_missing_hole_07.jpg;1
427;missing_hole;512;962;591;1039;.\data\pcb_defects_kaggle\Annotations\Missing_hole\11_missing_hole_07;0.24167397020157758;0.44506227758007116;79;77;2282;2248;0.034618755477651184;0.03425266903914591;.\data\pcb_defects_kaggle\images/Missing_hole/11_missing_hole_07.jpg;1
428;missing_hole;714;1885;761;1931;.\data\pcb_defects_kaggle\Annotations\Missing_hole\11_missing_hole_07;0.3231814198071867;0.8487544483985765;47;46;2282;2248;0.020595968448729185;0.020462633451957295;.\data\pcb_defects_kaggle\images/Missing_hole/11_missing_hole_07.jpg;1
429;missing_hole;820;1881;868;1931;.\data\pcb_defects_kaggle\Annotations\Missing_hole\11_missing_hole_07;0.3698510078878177;0.847864768683274;48;50;2282;2248;0.021034180543382998;0.02224199288256228;.\data\pcb_defects_kaggle\images/Missing_hole/11_missing_hole_07.jpg;1
430;missing_hole;1317;1542;1380;1617;.\data\pcb_defects_kaggle\Annotations\Missing_hole\11_missing_hole_08;0.5909290096406661;0.7026245551601423;63;75;2282;2248;0.027607361963190184;0.03336298932384341;.\data\pcb_defects_kaggle\images/Missing_hole/11_missing_hole_08.jpg;1
431;missing_hole;1129;1283;1193;1353;.\data\pcb_defects_kaggle\Annotations\Missing_hole\11_missing_hole_08;0.5087642418930762;0.5862989323843416;64;70;2282;2248;0.028045574057843997;0.03113879003558719;.\data\pcb_defects_kaggle\images/Missing_hole/11_missing_hole_08.jpg;1
432;missing_hole;1432;962;1506;1047;.\data\pcb_defects_kaggle\Annotations\Missing_hole\11_missing_hole_08;0.6437335670464505;0.44684163701067614;74;85;2282;2248;0.03242769500438212;0.037811387900355875;.\data\pcb_defects_kaggle\images/Missing_hole/11_missing_hole_08.jpg;1
433;missing_hole;722;967;786;1047;.\data\pcb_defects_kaggle\Annotations\Missing_hole\11_missing_hole_08;0.33041191936897457;0.44795373665480426;64;80;2282;2248;0.028045574057843997;0.03558718861209965;.\data\pcb_defects_kaggle\images/Missing_hole/11_missing_hole_08.jpg;1
434;missing_hole;425;1537;512;1616;.\data\pcb_defects_kaggle\Annotations\Missing_hole\11_missing_hole_08;0.20530236634531113;0.7012900355871886;87;79;2282;2248;0.03812445223488168;0.035142348754448396;.\data\pcb_defects_kaggle\images/Missing_hole/11_missing_hole_08.jpg;1
435;missing_hole;857;224;937;313;.\data\pcb_defects_kaggle\Annotations\Missing_hole\11_missing_hole_09;0.39307624890446974;0.11943950177935943;80;89;2282;2248;0.035056967572304996;0.03959074733096085;.\data\pcb_defects_kaggle\images/Missing_hole/11_missing_hole_09.jpg;1
436;missing_hole;912;593;983;673;.\data\pcb_defects_kaggle\Annotations\Missing_hole\11_missing_hole_09;0.4152059596844873;0.28158362989323843;71;80;2282;2248;0.031113058720420684;0.03558718861209965;.\data\pcb_defects_kaggle\images/Missing_hole/11_missing_hole_09.jpg;1
437;missing_hole;1548;552;1637;637;.\data\pcb_defects_kaggle\Annotations\Missing_hole\11_missing_hole_09;0.6978527607361963;0.26445729537366547;89;85;2282;2248;0.039000876424189306;0.037811387900355875;.\data\pcb_defects_kaggle\images/Missing_hole/11_missing_hole_09.jpg;1
438;missing_hole;712;1265;793;1350;.\data\pcb_defects_kaggle\Annotations\Missing_hole\11_missing_hole_09;0.32975460122699385;0.5816281138790036;81;85;2282;2248;0.03549517966695881;0.037811387900355875;.\data\pcb_defects_kaggle\images/Missing_hole/11_missing_hole_09.jpg;1
439;missing_hole;1302;1749;1389;1834;.\data\pcb_defects_kaggle\Annotations\Missing_hole\11_missing_hole_09;0.5896143733567046;0.7969306049822064;87;85;2282;2248;0.03812445223488168;0.037811387900355875;.\data\pcb_defects_kaggle\images/Missing_hole/11_missing_hole_09.jpg;1
440;missing_hole;950;737;1047;835;.\data\pcb_defects_kaggle\Annotations\Missing_hole\11_missing_hole_10;0.4375547765118317;0.349644128113879;97;98;2282;2248;0.04250657318141981;0.04359430604982206;.\data\pcb_defects_kaggle\images/Missing_hole/11_missing_hole_10.jpg;1
441;missing_hole;294;740;391;821;.\data\pcb_defects_kaggle\Annotations\Missing_hole\11_missing_hole_10;0.15008764241893077;0.3471975088967972;97;81;2282;2248;0.04250657318141981;0.03603202846975089;.\data\pcb_defects_kaggle\images/Missing_hole/11_missing_hole_10.jpg;1
442;missing_hole;816;968;889;1045;.\data\pcb_defects_kaggle\Annotations\Missing_hole\11_missing_hole_10;0.3735758106923751;0.44773131672597866;73;77;2282;2248;0.031989482909728306;0.03425266903914591;.\data\pcb_defects_kaggle\images/Missing_hole/11_missing_hole_10.jpg;1
443;missing_hole;1416;1468;1506;1549;.\data\pcb_defects_kaggle\Annotations\Missing_hole\11_missing_hole_10;0.64022787028922;0.671040925266904;90;81;2282;2248;0.03943908851884312;0.03603202846975089;.\data\pcb_defects_kaggle\images/Missing_hole/11_missing_hole_10.jpg;1
444;missing_hole;611;1449;686;1522;.\data\pcb_defects_kaggle\Annotations\Missing_hole\11_missing_hole_10;0.28418054338299736;0.6608096085409253;75;73;2282;2248;0.03286590709903593;0.032473309608540925;.\data\pcb_defects_kaggle\images/Missing_hole/11_missing_hole_10.jpg;1
445;missing_hole;2218;983;2278;1044;.\data\pcb_defects_kaggle\Annotations\Missing_hole\12_missing_hole_01;0.8888888888888888;0.4005928853754941;60;61;2529;2530;0.02372479240806643;0.024110671936758893;.\data\pcb_defects_kaggle\images/Missing_hole/12_missing_hole_01.jpg;1
446;missing_hole;1809;257;1862;321;.\data\pcb_defects_kaggle\Annotations\Missing_hole\12_missing_hole_01;0.7257809410834322;0.11422924901185771;53;64;2529;2530;0.02095689996045868;0.025296442687747035;.\data\pcb_defects_kaggle\images/Missing_hole/12_missing_hole_01.jpg;1
447;missing_hole;1595;1234;1657;1283;.\data\pcb_defects_kaggle\Annotations\Missing_hole\12_missing_hole_01;0.6429418742586003;0.4974308300395257;62;49;2529;2530;0.024515618821668642;0.019367588932806323;.\data\pcb_defects_kaggle\images/Missing_hole/12_missing_hole_01.jpg;1
448;missing_hole;1087;1712;1151;1777;.\data\pcb_defects_kaggle\Annotations\Missing_hole\12_missing_hole_01;0.4424673784104389;0.6895256916996048;64;65;2529;2530;0.02530644523527086;0.025691699604743084;.\data\pcb_defects_kaggle\images/Missing_hole/12_missing_hole_01.jpg;1
449;missing_hole;1647;1964;1698;2026;.\data\pcb_defects_kaggle\Annotations\Missing_hole\12_missing_hole_01;0.6613285883748518;0.7885375494071146;51;62;2529;2530;0.020166073546856466;0.02450592885375494;.\data\pcb_defects_kaggle\images/Missing_hole/12_missing_hole_01.jpg;1
450;missing_hole;2220;1090;2275;1146;.\data\pcb_defects_kaggle\Annotations\Missing_hole\12_missing_hole_02;0.8886911822854884;0.44189723320158103;55;56;2529;2530;0.021747726374060895;0.022134387351778657;.\data\pcb_defects_kaggle\images/Missing_hole/12_missing_hole_02.jpg;1
451;missing_hole;1089;1712;1147;1775;.\data\pcb_defects_kaggle\Annotations\Missing_hole\12_missing_hole_02;0.4420719652036378;0.6891304347826087;58;63;2529;2530;0.022933965994464216;0.024901185770750987;.\data\pcb_defects_kaggle\images/Missing_hole/12_missing_hole_02.jpg;1
452;missing_hole;586;889;644;949;.\data\pcb_defects_kaggle\Annotations\Missing_hole\12_missing_hole_02;0.2431791221826809;0.3632411067193676;58;60;2529;2530;0.022933965994464216;0.023715415019762844;.\data\pcb_defects_kaggle\images/Missing_hole/12_missing_hole_02.jpg;1
453;missing_hole;1642;1954;1706;2034;.\data\pcb_defects_kaggle\Annotations\Missing_hole\12_missing_hole_02;0.6619217081850534;0.7881422924901186;64;80;2529;2530;0.02530644523527086;0.03162055335968379;.\data\pcb_defects_kaggle\images/Missing_hole/12_missing_hole_02.jpg;1
454;missing_hole;2176;1275;2234;1337;.\data\pcb_defects_kaggle\Annotations\Missing_hole\12_missing_hole_02;0.8718861209964412;0.516205533596838;58;62;2529;2530;0.022933965994464216;0.02450592885375494;.\data\pcb_defects_kaggle\images/Missing_hole/12_missing_hole_02.jpg;1
455;missing_hole;1549;832;1604;894;.\data\pcb_defects_kaggle\Annotations\Missing_hole\12_missing_hole_03;0.6233689205219455;0.3411067193675889;55;62;2529;2530;0.021747726374060895;0.02450592885375494;.\data\pcb_defects_kaggle\images/Missing_hole/12_missing_hole_03.jpg;1
456;missing_hole;378;1095;444;1157;.\data\pcb_defects_kaggle\Annotations\Missing_hole\12_missing_hole_03;0.16251482799525505;0.4450592885375494;66;62;2529;2530;0.02609727164887307;0.02450592885375494;.\data\pcb_defects_kaggle\images/Missing_hole/12_missing_hole_03.jpg;1
457;missing_hole;258;1375;331;1464;.\data\pcb_defects_kaggle\Annotations\Missing_hole\12_missing_hole_03;0.11644918940292606;0.5610671936758893;73;89;2529;2530;0.028865164096480822;0.03517786561264822;.\data\pcb_defects_kaggle\images/Missing_hole/12_missing_hole_03.jpg;1
458;missing_hole;980;1955;1047;2024;.\data\pcb_defects_kaggle\Annotations\Missing_hole\12_missing_hole_03;0.4007512850929221;0.7863636363636364;67;69;2529;2530;0.02649268485567418;0.02727272727272727;.\data\pcb_defects_kaggle\images/Missing_hole/12_missing_hole_03.jpg;1
459;missing_hole;1637;1964;1707;2030;.\data\pcb_defects_kaggle\Annotations\Missing_hole\12_missing_hole_03;0.6611308817714512;0.7893280632411067;70;66;2529;2530;0.0276789244760775;0.02608695652173913;.\data\pcb_defects_kaggle\images/Missing_hole/12_missing_hole_03.jpg;1
460;missing_hole;149;1708;222;1772;.\data\pcb_defects_kaggle\Annotations\Missing_hole\12_missing_hole_03;0.07334914986160537;0.6877470355731226;73;64;2529;2530;0.028865164096480822;0.025296442687747035;.\data\pcb_defects_kaggle\images/Missing_hole/12_missing_hole_03.jpg;1
461;missing_hole;1289;1326;1338;1381;.\data\pcb_defects_kaggle\Annotations\Missing_hole\12_missing_hole_04;0.5193752471332542;0.5349802371541502;49;55;2529;2530;0.01937524713325425;0.021739130434782608;.\data\pcb_defects_kaggle\images/Missing_hole/12_missing_hole_04.jpg;1
462;missing_hole;1493;1412;1547;1463;.\data\pcb_defects_kaggle\Annotations\Missing_hole\12_missing_hole_04;0.6010280743376829;0.5681818181818182;54;51;2529;2530;0.021352313167259787;0.02015810276679842;.\data\pcb_defects_kaggle\images/Missing_hole/12_missing_hole_04.jpg;1
463;missing_hole;1498;1017;1546;1072;.\data\pcb_defects_kaggle\Annotations\Missing_hole\12_missing_hole_04;0.6018189007512851;0.41284584980237155;48;55;2529;2530;0.018979833926453145;0.021739130434782608;.\data\pcb_defects_kaggle\images/Missing_hole/12_missing_hole_04.jpg;1
464;missing_hole;1908;1010;1964;1079;.\data\pcb_defects_kaggle\Annotations\Missing_hole\12_missing_hole_04;0.7655199683669435;0.41284584980237155;56;69;2529;2530;0.022143139580862;0.02727272727272727;.\data\pcb_defects_kaggle\images/Missing_hole/12_missing_hole_04.jpg;1
465;missing_hole;1316;446;1362;495;.\data\pcb_defects_kaggle\Annotations\Missing_hole\12_missing_hole_04;0.5294582839066825;0.18596837944664033;46;49;2529;2530;0.01818900751285093;0.019367588932806323;.\data\pcb_defects_kaggle\images/Missing_hole/12_missing_hole_04.jpg;1
466;missing_hole;878;879;927;930;.\data\pcb_defects_kaggle\Annotations\Missing_hole\12_missing_hole_05;0.3568604191379992;0.3575098814229249;49;51;2529;2530;0.01937524713325425;0.02015810276679842;.\data\pcb_defects_kaggle\images/Missing_hole/12_missing_hole_05.jpg;1
467;missing_hole;1262;1152;1307;1203;.\data\pcb_defects_kaggle\Annotations\Missing_hole\12_missing_hole_05;0.5079082641360222;0.4654150197628458;45;51;2529;2530;0.017793594306049824;0.02015810276679842;.\data\pcb_defects_kaggle\images/Missing_hole/12_missing_hole_05.jpg;1
468;missing_hole;1077;1324;1135;1379;.\data\pcb_defects_kaggle\Annotations\Missing_hole\12_missing_hole_05;0.4373270067220245;0.5341897233201581;58;55;2529;2530;0.022933965994464216;0.021739130434782608;.\data\pcb_defects_kaggle\images/Missing_hole/12_missing_hole_05.jpg;1
469;missing_hole;2006;1324;2066;1388;.\data\pcb_defects_kaggle\Annotations\Missing_hole\12_missing_hole_05;0.8050612890470542;0.5359683794466403;60;64;2529;2530;0.02372479240806643;0.025296442687747035;.\data\pcb_defects_kaggle\images/Missing_hole/12_missing_hole_05.jpg;1
470;missing_hole;2318;884;2382;946;.\data\pcb_defects_kaggle\Annotations\Missing_hole\12_missing_hole_05;0.9292210359826019;0.3616600790513834;64;62;2529;2530;0.02530644523527086;0.02450592885375494;.\data\pcb_defects_kaggle\images/Missing_hole/12_missing_hole_05.jpg;1
471;missing_hole;1644;1710;1707;1782;.\data\pcb_defects_kaggle\Annotations\Missing_hole\12_missing_hole_05;0.6625148279952551;0.6901185770750988;63;72;2529;2530;0.02491103202846975;0.028458498023715414;.\data\pcb_defects_kaggle\images/Missing_hole/12_missing_hole_05.jpg;1
472;missing_hole;1184;1015;1237;1077;.\data\pcb_defects_kaggle\Annotations\Missing_hole\12_missing_hole_06;0.4786476868327402;0.4134387351778656;53;62;2529;2530;0.02095689996045868;0.02450592885375494;.\data\pcb_defects_kaggle\images/Missing_hole/12_missing_hole_06.jpg;1
473;missing_hole;1597;1014;1655;1077;.\data\pcb_defects_kaggle\Annotations\Missing_hole\12_missing_hole_06;0.6429418742586003;0.4132411067193676;58;63;2529;2530;0.022933965994464216;0.024901185770750987;.\data\pcb_defects_kaggle\images/Missing_hole/12_missing_hole_06.jpg;1
474;missing_hole;2218;981;2282;1043;.\data\pcb_defects_kaggle\Annotations\Missing_hole\12_missing_hole_06;0.8896797153024911;0.4;64;62;2529;2530;0.02530644523527086;0.02450592885375494;.\data\pcb_defects_kaggle\images/Missing_hole/12_missing_hole_06.jpg;1
475;missing_hole;1129;1466;1184;1530;.\data\pcb_defects_kaggle\Annotations\Missing_hole\12_missing_hole_06;0.45729537366548045;0.5920948616600791;55;64;2529;2530;0.021747726374060895;0.025296442687747035;.\data\pcb_defects_kaggle\images/Missing_hole/12_missing_hole_06.jpg;1
476;missing_hole;380;1097;442;1154;.\data\pcb_defects_kaggle\Annotations\Missing_hole\12_missing_hole_06;0.16251482799525505;0.44486166007905137;62;57;2529;2530;0.024515618821668642;0.022529644268774702;.\data\pcb_defects_kaggle\images/Missing_hole/12_missing_hole_06.jpg;1
477;missing_hole;1546;628;1607;694;.\data\pcb_defects_kaggle\Annotations\Missing_hole\12_missing_hole_07;0.6233689205219455;0.26126482213438734;61;66;2529;2530;0.024120205614867538;0.02608695652173913;.\data\pcb_defects_kaggle\images/Missing_hole/12_missing_hole_07.jpg;1
478;missing_hole;1805;1013;1862;1079;.\data\pcb_defects_kaggle\Annotations\Missing_hole\12_missing_hole_07;0.72499011466983;0.4134387351778656;57;66;2529;2530;0.022538552787663108;0.02608695652173913;.\data\pcb_defects_kaggle\images/Missing_hole/12_missing_hole_07.jpg;1
479;missing_hole;1386;1233;1450;1289;.\data\pcb_defects_kaggle\Annotations\Missing_hole\12_missing_hole_07;0.56069592724397;0.4984189723320158;64;56;2529;2530;0.02530644523527086;0.022134387351778657;.\data\pcb_defects_kaggle\images/Missing_hole/12_missing_hole_07.jpg;1
480;missing_hole;662;1034;717;1092;.\data\pcb_defects_kaggle\Annotations\Missing_hole\12_missing_hole_07;0.2726374060893634;0.42015810276679844;55;58;2529;2530;0.021747726374060895;0.02292490118577075;.\data\pcb_defects_kaggle\images/Missing_hole/12_missing_hole_07.jpg;1
481;missing_hole;1911;255;1965;319;.\data\pcb_defects_kaggle\Annotations\Missing_hole\12_missing_hole_07;0.7663107947805456;0.11343873517786561;54;64;2529;2530;0.021352313167259787;0.025296442687747035;.\data\pcb_defects_kaggle\images/Missing_hole/12_missing_hole_07.jpg;1
482;missing_hole;2203;1715;2266;1781;.\data\pcb_defects_kaggle\Annotations\Missing_hole\12_missing_hole_08;0.883550810597074;0.6909090909090909;63;66;2529;2530;0.02491103202846975;0.02608695652173913;.\data\pcb_defects_kaggle\images/Missing_hole/12_missing_hole_08.jpg;1
483;missing_hole;382;1046;438;1095;.\data\pcb_defects_kaggle\Annotations\Missing_hole\12_missing_hole_08;0.16211941478845393;0.4231225296442688;56;49;2529;2530;0.022143139580862;0.019367588932806323;.\data\pcb_defects_kaggle\images/Missing_hole/12_missing_hole_08.jpg;1
484;missing_hole;504;686;562;741;.\data\pcb_defects_kaggle\Annotations\Missing_hole\12_missing_hole_08;0.21075523922499012;0.2820158102766798;58;55;2529;2530;0.022933965994464216;0.021739130434782608;.\data\pcb_defects_kaggle\images/Missing_hole/12_missing_hole_08.jpg;1
485;missing_hole;809;1957;875;2026;.\data\pcb_defects_kaggle\Annotations\Missing_hole\12_missing_hole_08;0.3329379201265322;0.7871541501976285;66;69;2529;2530;0.02609727164887307;0.02727272727272727;.\data\pcb_defects_kaggle\images/Missing_hole/12_missing_hole_08.jpg;1
486;missing_hole;875;263;937;314;.\data\pcb_defects_kaggle\Annotations\Missing_hole\12_missing_hole_08;0.3582443653618031;0.11403162055335968;62;51;2529;2530;0.024515618821668642;0.02015810276679842;.\data\pcb_defects_kaggle\images/Missing_hole/12_missing_hole_08.jpg;1
487;missing_hole;2118;259;2177;323;.\data\pcb_defects_kaggle\Annotations\Missing_hole\12_missing_hole_09;0.8491498616053776;0.1150197628458498;59;64;2529;2530;0.02332937920126532;0.025296442687747035;.\data\pcb_defects_kaggle\images/Missing_hole/12_missing_hole_09.jpg;1
488;missing_hole;842;1270;898;1332;.\data\pcb_defects_kaggle\Annotations\Missing_hole\12_missing_hole_09;0.34400948991696323;0.5142292490118577;56;62;2529;2530;0.022143139580862;0.02450592885375494;.\data\pcb_defects_kaggle\images/Missing_hole/12_missing_hole_09.jpg;1
489;missing_hole;1137;1008;1187;1072;.\data\pcb_defects_kaggle\Annotations\Missing_hole\12_missing_hole_09;0.4594701463028865;0.41106719367588934;50;64;2529;2530;0.019770660340055358;0.025296442687747035;.\data\pcb_defects_kaggle\images/Missing_hole/12_missing_hole_09.jpg;1
490;missing_hole;2078;1086;2129;1130;.\data\pcb_defects_kaggle\Annotations\Missing_hole\12_missing_hole_09;0.8317516805061289;0.4379446640316206;51;44;2529;2530;0.020166073546856466;0.017391304347826087;.\data\pcb_defects_kaggle\images/Missing_hole/12_missing_hole_09.jpg;1
491;missing_hole;1438;1321;1498;1384;.\data\pcb_defects_kaggle\Annotations\Missing_hole\12_missing_hole_09;0.5804665875840254;0.5345849802371542;60;63;2529;2530;0.02372479240806643;0.024901185770750987;.\data\pcb_defects_kaggle\images/Missing_hole/12_missing_hole_09.jpg;1
492;missing_hole;1387;1232;1451;1292;.\data\pcb_defects_kaggle\Annotations\Missing_hole\12_missing_hole_10;0.561091340450771;0.49881422924901186;64;60;2529;2530;0.02530644523527086;0.023715415019762844;.\data\pcb_defects_kaggle\images/Missing_hole/12_missing_hole_10.jpg;1
493;missing_hole;1649;1021;1704;1079;.\data\pcb_defects_kaggle\Annotations\Missing_hole\12_missing_hole_10;0.6629102412020561;0.4150197628458498;55;58;2529;2530;0.021747726374060895;0.02292490118577075;.\data\pcb_defects_kaggle\images/Missing_hole/12_missing_hole_10.jpg;1
494;missing_hole;877;883;933;941;.\data\pcb_defects_kaggle\Annotations\Missing_hole\12_missing_hole_10;0.35784895215500195;0.36047430830039523;56;58;2529;2530;0.022143139580862;0.02292490118577075;.\data\pcb_defects_kaggle\images/Missing_hole/12_missing_hole_10.jpg;1
495;missing_hole;693;769;740;816;.\data\pcb_defects_kaggle\Annotations\Missing_hole\12_missing_hole_10;0.2833135626729933;0.3132411067193676;47;47;2529;2530;0.018584420719652037;0.01857707509881423;.\data\pcb_defects_kaggle\images/Missing_hole/12_missing_hole_10.jpg;1
496;missing_hole;1960;1323;2018;1392;.\data\pcb_defects_kaggle\Annotations\Missing_hole\12_missing_hole_10;0.7864768683274022;0.5365612648221344;58;69;2529;2530;0.022933965994464216;0.02727272727272727;.\data\pcb_defects_kaggle\images/Missing_hole/12_missing_hole_10.jpg;1
497;mouse_bite;1518;913;1547;958;.\data\pcb_defects_kaggle\Annotations\Mouse_bite\01_mouse_bite_01;0.5051087673038892;0.5898486759142497;29;45;3034;1586;0.00955833882663151;0.02837326607818411;.\data\pcb_defects_kaggle\images/Mouse_bite/01_mouse_bite_01.jpg;2
498;mouse_bite;2020;1260;2046;1302;.\data\pcb_defects_kaggle\Annotations\Mouse_bite\01_mouse_bite_01;0.6700725115359262;0.8076923076923077;26;42;3034;1586;0.008569545154911009;0.02648171500630517;.\data\pcb_defects_kaggle\images/Mouse_bite/01_mouse_bite_01.jpg;2
499;mouse_bite;2595;888;2620;920;.\data\pcb_defects_kaggle\Annotations\Mouse_bite\01_mouse_bite_01;0.8594264996704021;0.5699873896595208;25;32;3034;1586;0.008239947264337508;0.0201765447667087;.\data\pcb_defects_kaggle\images/Mouse_bite/01_mouse_bite_01.jpg;2
500;mouse_bite;1526;1165;1571;1209;.\data\pcb_defects_kaggle\Annotations\Mouse_bite\01_mouse_bite_02;0.5103823335530653;0.7484237074401009;45;44;3034;1586;0.014831905075807514;0.027742749054224466;.\data\pcb_defects_kaggle\images/Mouse_bite/01_mouse_bite_02.jpg;2
501;mouse_bite;1985;951;2022;988;.\data\pcb_defects_kaggle\Annotations\Mouse_bite\01_mouse_bite_02;0.6603493737640079;0.6112862547288777;37;37;3034;1586;0.012195121951219513;0.023329129886506934;.\data\pcb_defects_kaggle\images/Mouse_bite/01_mouse_bite_02.jpg;2
502;mouse_bite;785;1035;824;1073;.\data\pcb_defects_kaggle\Annotations\Mouse_bite\01_mouse_bite_02;0.265161502966381;0.6645649432534678;39;38;3034;1586;0.012854317732366513;0.02395964691046658;.\data\pcb_defects_kaggle\images/Mouse_bite/01_mouse_bite_02.jpg;2
503;mouse_bite;1019;500;1079;558;.\data\pcb_defects_kaggle\Annotations\Mouse_bite\01_mouse_bite_03;0.34574818721160183;0.33354350567465324;60;58;3034;1586;0.01977587343441002;0.03656998738965952;.\data\pcb_defects_kaggle\images/Mouse_bite/01_mouse_bite_03.jpg;2
504;mouse_bite;1264;1067;1301;1100;.\data\pcb_defects_kaggle\Annotations\Mouse_bite\01_mouse_bite_03;0.42270929466051416;0.6831651954602774;37;33;3034;1586;0.012195121951219513;0.02080706179066835;.\data\pcb_defects_kaggle\images/Mouse_bite/01_mouse_bite_03.jpg;2
505;mouse_bite;1683;638;1723;677;.\data\pcb_defects_kaggle\Annotations\Mouse_bite\01_mouse_bite_03;0.561305207646671;0.4145649432534678;40;39;3034;1586;0.013183915622940013;0.02459016393442623;.\data\pcb_defects_kaggle\images/Mouse_bite/01_mouse_bite_03.jpg;2
506;mouse_bite;1940;757;1974;785;.\data\pcb_defects_kaggle\Annotations\Mouse_bite\01_mouse_bite_04;0.6450230718523401;0.48612862547288777;34;28;3034;1586;0.01120632827949901;0.017654476670870115;.\data\pcb_defects_kaggle\images/Mouse_bite/01_mouse_bite_04.jpg;2
507;mouse_bite;2590;892;2624;929;.\data\pcb_defects_kaggle\Annotations\Mouse_bite\01_mouse_bite_04;0.8592617007251153;0.5740857503152585;34;37;3034;1586;0.01120632827949901;0.023329129886506934;.\data\pcb_defects_kaggle\images/Mouse_bite/01_mouse_bite_04.jpg;2
508;mouse_bite;2564;545;2603;583;.\data\pcb_defects_kaggle\Annotations\Mouse_bite\01_mouse_bite_04;0.8515161502966381;0.35561160151324084;39;38;3034;1586;0.012854317732366513;0.02395964691046658;.\data\pcb_defects_kaggle\images/Mouse_bite/01_mouse_bite_04.jpg;2
509;mouse_bite;2151;1155;2184;1191;.\data\pcb_defects_kaggle\Annotations\Mouse_bite\01_mouse_bite_05;0.714403427818062;0.7395964691046658;33;36;3034;1586;0.010876730388925511;0.02269861286254729;.\data\pcb_defects_kaggle\images/Mouse_bite/01_mouse_bite_05.jpg;2
510;mouse_bite;2164;296;2205;331;.\data\pcb_defects_kaggle\Annotations\Mouse_bite\01_mouse_bite_05;0.7200065919578115;0.1976670870113493;41;35;3034;1586;0.013513513513513514;0.022068095838587643;.\data\pcb_defects_kaggle\images/Mouse_bite/01_mouse_bite_05.jpg;2
511;mouse_bite;2201;615;2233;654;.\data\pcb_defects_kaggle\Annotations\Mouse_bite\01_mouse_bite_05;0.7307185234014503;0.400063051702396;32;39;3034;1586;0.01054713249835201;0.02459016393442623;.\data\pcb_defects_kaggle\images/Mouse_bite/01_mouse_bite_05.jpg;2
512;mouse_bite;1198;1312;1244;1350;.\data\pcb_defects_kaggle\Annotations\Mouse_bite\01_mouse_bite_06;0.4024390243902439;0.8392181588902901;46;38;3034;1586;0.015161502966381015;0.02395964691046658;.\data\pcb_defects_kaggle\images/Mouse_bite/01_mouse_bite_06.jpg;2
513;mouse_bite;2629;319;2665;352;.\data\pcb_defects_kaggle\Annotations\Mouse_bite\01_mouse_bite_06;0.8724456163480554;0.21153846153846154;36;33;3034;1586;0.011865524060646011;0.02080706179066835;.\data\pcb_defects_kaggle\images/Mouse_bite/01_mouse_bite_06.jpg;2
514;mouse_bite;2821;824;2853;872;.\data\pcb_defects_kaggle\Annotations\Mouse_bite\01_mouse_bite_06;0.9350692155570204;0.5346784363177806;32;48;3034;1586;0.01054713249835201;0.03026481715006305;.\data\pcb_defects_kaggle\images/Mouse_bite/01_mouse_bite_06.jpg;2
515;mouse_bite;1471;403;1508;461;.\data\pcb_defects_kaggle\Annotations\Mouse_bite\01_mouse_bite_07;0.49093605800922874;0.2723833543505675;37;58;3034;1586;0.012195121951219513;0.03656998738965952;.\data\pcb_defects_kaggle\images/Mouse_bite/01_mouse_bite_07.jpg;2
516;mouse_bite;441;916;476;947;.\data\pcb_defects_kaggle\Annotations\Mouse_bite\01_mouse_bite_07;0.1511206328279499;0.5873266078184111;35;31;3034;1586;0.011535926170072512;0.019546027742749054;.\data\pcb_defects_kaggle\images/Mouse_bite/01_mouse_bite_07.jpg;2
517;mouse_bite;663;1302;702;1343;.\data\pcb_defects_kaggle\Annotations\Mouse_bite\01_mouse_bite_07;0.22495056031641397;0.8338587641866331;39;41;3034;1586;0.012854317732366513;0.025851197982345524;.\data\pcb_defects_kaggle\images/Mouse_bite/01_mouse_bite_07.jpg;2
518;mouse_bite;1018;1281;1058;1318;.\data\pcb_defects_kaggle\Annotations\Mouse_bite\01_mouse_bite_08;0.34212261041529335;0.8193568726355611;40;37;3034;1586;0.013183915622940013;0.023329129886506934;.\data\pcb_defects_kaggle\images/Mouse_bite/01_mouse_bite_08.jpg;2
519;mouse_bite;837;1099;874;1147;.\data\pcb_defects_kaggle\Annotations\Mouse_bite\01_mouse_bite_08;0.28197099538562953;0.7080706179066835;37;48;3034;1586;0.012195121951219513;0.03026481715006305;.\data\pcb_defects_kaggle\images/Mouse_bite/01_mouse_bite_08.jpg;2
520;mouse_bite;957;886;990;916;.\data\pcb_defects_kaggle\Annotations\Mouse_bite\01_mouse_bite_09;0.32086354647330256;0.5680958385876419;33;30;3034;1586;0.010876730388925511;0.018915510718789406;.\data\pcb_defects_kaggle\images/Mouse_bite/01_mouse_bite_09.jpg;2
521;mouse_bite;176;1113;207;1144;.\data\pcb_defects_kaggle\Annotations\Mouse_bite\01_mouse_bite_09;0.06311799604482532;0.7115384615384616;31;31;3034;1586;0.01021753460777851;0.019546027742749054;.\data\pcb_defects_kaggle\images/Mouse_bite/01_mouse_bite_09.jpg;2
522;mouse_bite;597;803;626;840;.\data\pcb_defects_kaggle\Annotations\Mouse_bite\01_mouse_bite_09;0.20154911008569545;0.5179697351828499;29;37;3034;1586;0.00955833882663151;0.023329129886506934;.\data\pcb_defects_kaggle\images/Mouse_bite/01_mouse_bite_09.jpg;2
523;mouse_bite;1694;642;1729;677;.\data\pcb_defects_kaggle\Annotations\Mouse_bite\01_mouse_bite_10;0.5641067897165458;0.41582597730138715;35;35;3034;1586;0.011535926170072512;0.022068095838587643;.\data\pcb_defects_kaggle\images/Mouse_bite/01_mouse_bite_10.jpg;2
524;mouse_bite;445;423;505;464;.\data\pcb_defects_kaggle\Annotations\Mouse_bite\01_mouse_bite_10;0.15655899802241266;0.2796343001261034;60;41;3034;1586;0.01977587343441002;0.025851197982345524;.\data\pcb_defects_kaggle\images/Mouse_bite/01_mouse_bite_10.jpg;2
525;mouse_bite;1199;966;1234;1004;.\data\pcb_defects_kaggle\Annotations\Mouse_bite\01_mouse_bite_11;0.40095583388266315;0.6210592686002522;35;38;3034;1586;0.011535926170072512;0.02395964691046658;.\data\pcb_defects_kaggle\images/Mouse_bite/01_mouse_bite_11.jpg;2
526;mouse_bite;2042;755;2073;786;.\data\pcb_defects_kaggle\Annotations\Mouse_bite\01_mouse_bite_11;0.6781476598549769;0.48581336696090793;31;31;3034;1586;0.01021753460777851;0.019546027742749054;.\data\pcb_defects_kaggle\images/Mouse_bite/01_mouse_bite_11.jpg;2
527;mouse_bite;1472;607;1507;639;.\data\pcb_defects_kaggle\Annotations\Mouse_bite\01_mouse_bite_11;0.49093605800922874;0.39281210592686;35;32;3034;1586;0.011535926170072512;0.0201765447667087;.\data\pcb_defects_kaggle\images/Mouse_bite/01_mouse_bite_11.jpg;2
528;mouse_bite;2594;882;2625;918;.\data\pcb_defects_kaggle\Annotations\Mouse_bite\01_mouse_bite_12;0.8600856954515491;0.5674653215636822;31;36;3034;1586;0.01021753460777851;0.02269861286254729;.\data\pcb_defects_kaggle\images/Mouse_bite/01_mouse_bite_12.jpg;2
529;mouse_bite;2819;1210;2854;1253;.\data\pcb_defects_kaggle\Annotations\Mouse_bite\01_mouse_bite_12;0.9349044166117337;0.7764817150063051;35;43;3034;1586;0.011535926170072512;0.02711223203026482;.\data\pcb_defects_kaggle\images/Mouse_bite/01_mouse_bite_12.jpg;2
530;mouse_bite;2664;318;2704;354;.\data\pcb_defects_kaggle\Annotations\Mouse_bite\01_mouse_bite_12;0.8846407382992749;0.21185372005044137;40;36;3034;1586;0.013183915622940013;0.02269861286254729;.\data\pcb_defects_kaggle\images/Mouse_bite/01_mouse_bite_12.jpg;2
531;mouse_bite;1223;1369;1264;1410;.\data\pcb_defects_kaggle\Annotations\Mouse_bite\01_mouse_bite_13;0.40985497692814765;0.8761034047919294;41;41;3034;1586;0.013513513513513514;0.025851197982345524;.\data\pcb_defects_kaggle\images/Mouse_bite/01_mouse_bite_13.jpg;2
532;mouse_bite;1539;1162;1577;1202;.\data\pcb_defects_kaggle\Annotations\Mouse_bite\01_mouse_bite_13;0.5135135135135135;0.7452711223203027;38;40;3034;1586;0.012524719841793012;0.025220680958385876;.\data\pcb_defects_kaggle\images/Mouse_bite/01_mouse_bite_13.jpg;2
533;mouse_bite;1550;1288;1586;1326;.\data\pcb_defects_kaggle\Annotations\Mouse_bite\01_mouse_bite_13;0.5168094924192486;0.8240857503152585;36;38;3034;1586;0.011865524060646011;0.02395964691046658;.\data\pcb_defects_kaggle\images/Mouse_bite/01_mouse_bite_13.jpg;2
534;mouse_bite;731;1396;768;1430;.\data\pcb_defects_kaggle\Annotations\Mouse_bite\01_mouse_bite_14;0.2470336189848385;0.8909205548549811;37;34;3034;1586;0.012195121951219513;0.021437578814627996;.\data\pcb_defects_kaggle\images/Mouse_bite/01_mouse_bite_14.jpg;2
535;mouse_bite;444;915;476;949;.\data\pcb_defects_kaggle\Annotations\Mouse_bite\01_mouse_bite_14;0.15161502966381016;0.587641866330391;32;34;3034;1586;0.01054713249835201;0.021437578814627996;.\data\pcb_defects_kaggle\images/Mouse_bite/01_mouse_bite_14.jpg;2
536;mouse_bite;601;1053;635;1084;.\data\pcb_defects_kaggle\Annotations\Mouse_bite\01_mouse_bite_15;0.20369149637442321;0.6737074401008827;34;31;3034;1586;0.01120632827949901;0.019546027742749054;.\data\pcb_defects_kaggle\images/Mouse_bite/01_mouse_bite_15.jpg;2
537;mouse_bite;2651;558;2684;591;.\data\pcb_defects_kaggle\Annotations\Mouse_bite\01_mouse_bite_15;0.8792023731048121;0.36223203026481715;33;33;3034;1586;0.010876730388925511;0.02080706179066835;.\data\pcb_defects_kaggle\images/Mouse_bite/01_mouse_bite_15.jpg;2
538;mouse_bite;2547;318;2582;352;.\data\pcb_defects_kaggle\Annotations\Mouse_bite\01_mouse_bite_16;0.8452537903757416;0.2112232030264817;35;34;3034;1586;0.011535926170072512;0.021437578814627996;.\data\pcb_defects_kaggle\images/Mouse_bite/01_mouse_bite_16.jpg;2
539;mouse_bite;2210;1113;2249;1160;.\data\pcb_defects_kaggle\Annotations\Mouse_bite\01_mouse_bite_16;0.734838497033619;0.7165825977301387;39;47;3034;1586;0.012854317732366513;0.029634300126103404;.\data\pcb_defects_kaggle\images/Mouse_bite/01_mouse_bite_16.jpg;2
540;mouse_bite;2768;306;2795;344;.\data\pcb_defects_kaggle\Annotations\Mouse_bite\01_mouse_bite_16;0.9167765326301912;0.20491803278688525;27;38;3034;1586;0.008899143045484509;0.02395964691046658;.\data\pcb_defects_kaggle\images/Mouse_bite/01_mouse_bite_16.jpg;2
541;mouse_bite;2168;854;2200;887;.\data\pcb_defects_kaggle\Annotations\Mouse_bite\01_mouse_bite_17;0.7198417930125247;0.5488650693568726;32;33;3034;1586;0.01054713249835201;0.02080706179066835;.\data\pcb_defects_kaggle\images/Mouse_bite/01_mouse_bite_17.jpg;2
542;mouse_bite;1513;919;1545;957;.\data\pcb_defects_kaggle\Annotations\Mouse_bite\01_mouse_bite_17;0.503955174686882;0.5914249684741488;32;38;3034;1586;0.01054713249835201;0.02395964691046658;.\data\pcb_defects_kaggle\images/Mouse_bite/01_mouse_bite_17.jpg;2
543;mouse_bite;2727;1245;2761;1289;.\data\pcb_defects_kaggle\Annotations\Mouse_bite\01_mouse_bite_17;0.9044166117336849;0.7988650693568726;34;44;3034;1586;0.01120632827949901;0.027742749054224466;.\data\pcb_defects_kaggle\images/Mouse_bite/01_mouse_bite_17.jpg;2
544;mouse_bite;391;1395;427;1428;.\data\pcb_defects_kaggle\Annotations\Mouse_bite\01_mouse_bite_18;0.13480553724456162;0.8899747793190416;36;33;3034;1586;0.011865524060646011;0.02080706179066835;.\data\pcb_defects_kaggle\images/Mouse_bite/01_mouse_bite_18.jpg;2
545;mouse_bite;724;1222;755;1258;.\data\pcb_defects_kaggle\Annotations\Mouse_bite\01_mouse_bite_19;0.2437376400791035;0.7818411097099621;31;36;3034;1586;0.01021753460777851;0.02269861286254729;.\data\pcb_defects_kaggle\images/Mouse_bite/01_mouse_bite_19.jpg;2
546;mouse_bite;645;1286;689;1329;.\data\pcb_defects_kaggle\Annotations\Mouse_bite\01_mouse_bite_19;0.2198417930125247;0.8244010088272383;44;43;3034;1586;0.014502307185234015;0.02711223203026482;.\data\pcb_defects_kaggle\images/Mouse_bite/01_mouse_bite_19.jpg;2
547;mouse_bite;1339;1366;1382;1410;.\data\pcb_defects_kaggle\Annotations\Mouse_bite\01_mouse_bite_20;0.4484179301252472;0.8751576292559899;43;44;3034;1586;0.014172709294660513;0.027742749054224466;.\data\pcb_defects_kaggle\images/Mouse_bite/01_mouse_bite_20.jpg;2
548;mouse_bite;995;1312;1040;1351;.\data\pcb_defects_kaggle\Annotations\Mouse_bite\01_mouse_bite_20;0.3353658536585366;0.8395334174022698;45;39;3034;1586;0.014831905075807514;0.02459016393442623;.\data\pcb_defects_kaggle\images/Mouse_bite/01_mouse_bite_20.jpg;2
549;mouse_bite;792;1296;834;1340;.\data\pcb_defects_kaggle\Annotations\Mouse_bite\01_mouse_bite_20;0.26796308503625577;0.8310214375788146;42;44;3034;1586;0.013843111404087014;0.027742749054224466;.\data\pcb_defects_kaggle\images/Mouse_bite/01_mouse_bite_20.jpg;2
550;mouse_bite;986;2115;1093;2195;.\data\pcb_defects_kaggle\Annotations\Mouse_bite\04_mouse_bite_01;0.3401505235602094;0.8745941558441559;107;80;3056;2464;0.0350130890052356;0.032467532467532464;.\data\pcb_defects_kaggle\images/Mouse_bite/04_mouse_bite_01.jpg;2
551;mouse_bite;1895;1448;1979;1537;.\data\pcb_defects_kaggle\Annotations\Mouse_bite\04_mouse_bite_01;0.6338350785340314;0.6057224025974026;84;89;3056;2464;0.0274869109947644;0.03612012987012987;.\data\pcb_defects_kaggle\images/Mouse_bite/04_mouse_bite_01.jpg;2
552;mouse_bite;1773;1139;1855;1190;.\data\pcb_defects_kaggle\Annotations\Mouse_bite\04_mouse_bite_01;0.5935863874345549;0.4726055194805195;82;51;3056;2464;0.026832460732984294;0.020698051948051948;.\data\pcb_defects_kaggle\images/Mouse_bite/04_mouse_bite_01.jpg;2
553;mouse_bite;762;1159;833;1201;.\data\pcb_defects_kaggle\Annotations\Mouse_bite\04_mouse_bite_02;0.26096204188481675;0.4788961038961039;71;42;3056;2464;0.023232984293193717;0.017045454545454544;.\data\pcb_defects_kaggle\images/Mouse_bite/04_mouse_bite_02.jpg;2
554;mouse_bite;537;1468;582;1531;.\data\pcb_defects_kaggle\Annotations\Mouse_bite\04_mouse_bite_02;0.1830824607329843;0.6085633116883117;45;63;3056;2464;0.014725130890052356;0.02556818181818182;.\data\pcb_defects_kaggle\images/Mouse_bite/04_mouse_bite_02.jpg;2
555;mouse_bite;1533;1875;1619;1926;.\data\pcb_defects_kaggle\Annotations\Mouse_bite\04_mouse_bite_02;0.5157068062827225;0.7713068181818182;86;51;3056;2464;0.0281413612565445;0.020698051948051948;.\data\pcb_defects_kaggle\images/Mouse_bite/04_mouse_bite_02.jpg;2
556;mouse_bite;2010;435;2084;482;.\data\pcb_defects_kaggle\Annotations\Mouse_bite\04_mouse_bite_03;0.6698298429319371;0.18607954545454544;74;47;3056;2464;0.024214659685863876;0.019074675324675324;.\data\pcb_defects_kaggle\images/Mouse_bite/04_mouse_bite_03.jpg;2
557;mouse_bite;2157;862;2208;935;.\data\pcb_defects_kaggle\Annotations\Mouse_bite\04_mouse_bite_03;0.7141688481675392;0.364650974025974;51;73;3056;2464;0.01668848167539267;0.029626623376623376;.\data\pcb_defects_kaggle\images/Mouse_bite/04_mouse_bite_03.jpg;2
558;mouse_bite;1153;473;1208;539;.\data\pcb_defects_kaggle\Annotations\Mouse_bite\04_mouse_bite_03;0.3862892670157068;0.20535714285714285;55;66;3056;2464;0.01799738219895288;0.026785714285714284;.\data\pcb_defects_kaggle\images/Mouse_bite/04_mouse_bite_03.jpg;2
559;mouse_bite;113;995;171;1064;.\data\pcb_defects_kaggle\Annotations\Mouse_bite\04_mouse_bite_04;0.046465968586387435;0.41781655844155846;58;69;3056;2464;0.018979057591623036;0.028003246753246752;.\data\pcb_defects_kaggle\images/Mouse_bite/04_mouse_bite_04.jpg;2
560;mouse_bite;853;1081;926;1137;.\data\pcb_defects_kaggle\Annotations\Mouse_bite\04_mouse_bite_04;0.29106675392670156;0.45008116883116883;73;56;3056;2464;0.023887434554973823;0.022727272727272728;.\data\pcb_defects_kaggle\images/Mouse_bite/04_mouse_bite_04.jpg;2
561;mouse_bite;262;541;328;610;.\data\pcb_defects_kaggle\Annotations\Mouse_bite\04_mouse_bite_04;0.09653141361256544;0.23356331168831168;66;69;3056;2464;0.021596858638743454;0.028003246753246752;.\data\pcb_defects_kaggle\images/Mouse_bite/04_mouse_bite_04.jpg;2
562;mouse_bite;701;642;762;724;.\data\pcb_defects_kaggle\Annotations\Mouse_bite\04_mouse_bite_05;0.2393651832460733;0.27719155844155846;61;82;3056;2464;0.019960732984293194;0.033279220779220776;.\data\pcb_defects_kaggle\images/Mouse_bite/04_mouse_bite_05.jpg;2
563;mouse_bite;1106;621;1170;688;.\data\pcb_defects_kaggle\Annotations\Mouse_bite\04_mouse_bite_05;0.3723821989528796;0.265625;64;67;3056;2464;0.020942408376963352;0.02719155844155844;.\data\pcb_defects_kaggle\images/Mouse_bite/04_mouse_bite_05.jpg;2
564;mouse_bite;1595;473;1648;551;.\data\pcb_defects_kaggle\Annotations\Mouse_bite\04_mouse_bite_05;0.5305955497382199;0.2077922077922078;53;78;3056;2464;0.017342931937172776;0.03165584415584415;.\data\pcb_defects_kaggle\images/Mouse_bite/04_mouse_bite_05.jpg;2
565;mouse_bite;397;2231;497;2299;.\data\pcb_defects_kaggle\Annotations\Mouse_bite\04_mouse_bite_06;0.1462696335078534;0.919237012987013;100;68;3056;2464;0.032722513089005235;0.027597402597402596;.\data\pcb_defects_kaggle\images/Mouse_bite/04_mouse_bite_06.jpg;2
566;mouse_bite;2382;1790;2468;1853;.\data\pcb_defects_kaggle\Annotations\Mouse_bite\04_mouse_bite_06;0.793520942408377;0.7392451298701299;86;63;3056;2464;0.0281413612565445;0.02556818181818182;.\data\pcb_defects_kaggle\images/Mouse_bite/04_mouse_bite_06.jpg;2
567;mouse_bite;2562;1581;2635;1631;.\data\pcb_defects_kaggle\Annotations\Mouse_bite\04_mouse_bite_06;0.850294502617801;0.6517857142857143;73;50;3056;2464;0.023887434554973823;0.020292207792207792;.\data\pcb_defects_kaggle\images/Mouse_bite/04_mouse_bite_06.jpg;2
568;mouse_bite;1257;1197;1342;1253;.\data\pcb_defects_kaggle\Annotations\Mouse_bite\04_mouse_bite_07;0.42522905759162305;0.4971590909090909;85;56;3056;2464;0.027814136125654452;0.022727272727272728;.\data\pcb_defects_kaggle\images/Mouse_bite/04_mouse_bite_07.jpg;2
569;mouse_bite;2410;1137;2470;1221;.\data\pcb_defects_kaggle\Annotations\Mouse_bite\04_mouse_bite_07;0.7984293193717278;0.4784902597402597;60;84;3056;2464;0.01963350785340314;0.03409090909090909;.\data\pcb_defects_kaggle\images/Mouse_bite/04_mouse_bite_07.jpg;2
570;mouse_bite;751;1206;824;1257;.\data\pcb_defects_kaggle\Annotations\Mouse_bite\04_mouse_bite_07;0.25768979057591623;0.49979707792207795;73;51;3056;2464;0.023887434554973823;0.020698051948051948;.\data\pcb_defects_kaggle\images/Mouse_bite/04_mouse_bite_07.jpg;2
571;mouse_bite;1474;1069;1555;1146;.\data\pcb_defects_kaggle\Annotations\Mouse_bite\04_mouse_bite_08;0.4955824607329843;0.4494724025974026;81;77;3056;2464;0.02650523560209424;0.03125;.\data\pcb_defects_kaggle\images/Mouse_bite/04_mouse_bite_08.jpg;2
572;mouse_bite;426;1357;481;1419;.\data\pcb_defects_kaggle\Annotations\Mouse_bite\04_mouse_bite_08;0.14839659685863874;0.5633116883116883;55;62;3056;2464;0.01799738219895288;0.025162337662337664;.\data\pcb_defects_kaggle\images/Mouse_bite/04_mouse_bite_08.jpg;2
573;mouse_bite;1739;811;1795;875;.\data\pcb_defects_kaggle\Annotations\Mouse_bite\04_mouse_bite_08;0.5782068062827225;0.34212662337662336;56;64;3056;2464;0.01832460732984293;0.025974025974025976;.\data\pcb_defects_kaggle\images/Mouse_bite/04_mouse_bite_08.jpg;2
574;mouse_bite;1126;1495;1182;1561;.\data\pcb_defects_kaggle\Annotations\Mouse_bite\04_mouse_bite_09;0.3776178010471204;0.6201298701298701;56;66;3056;2464;0.01832460732984293;0.026785714285714284;.\data\pcb_defects_kaggle\images/Mouse_bite/04_mouse_bite_09.jpg;2
575;mouse_bite;1673;1508;1726;1573;.\data\pcb_defects_kaggle\Annotations\Mouse_bite\04_mouse_bite_09;0.556119109947644;0.625202922077922;53;65;3056;2464;0.017342931937172776;0.026379870129870128;.\data\pcb_defects_kaggle\images/Mouse_bite/04_mouse_bite_09.jpg;2
576;mouse_bite;1959;1353;2026;1451;.\data\pcb_defects_kaggle\Annotations\Mouse_bite\04_mouse_bite_09;0.6519960732984293;0.5689935064935064;67;98;3056;2464;0.021924083769633507;0.03977272727272727;.\data\pcb_defects_kaggle\images/Mouse_bite/04_mouse_bite_09.jpg;2
577;mouse_bite;1588;1861;1673;1928;.\data\pcb_defects_kaggle\Annotations\Mouse_bite\04_mouse_bite_10;0.5335405759162304;0.7688717532467533;85;67;3056;2464;0.027814136125654452;0.02719155844155844;.\data\pcb_defects_kaggle\images/Mouse_bite/04_mouse_bite_10.jpg;2
578;mouse_bite;591;1386;657;1477;.\data\pcb_defects_kaggle\Annotations\Mouse_bite\04_mouse_bite_10;0.20418848167539266;0.5809659090909091;66;91;3056;2464;0.021596858638743454;0.036931818181818184;.\data\pcb_defects_kaggle\images/Mouse_bite/04_mouse_bite_10.jpg;2
579;mouse_bite;488;1601;542;1686;.\data\pcb_defects_kaggle\Annotations\Mouse_bite\04_mouse_bite_10;0.16852094240837695;0.6670048701298701;54;85;3056;2464;0.01767015706806283;0.03449675324675325;.\data\pcb_defects_kaggle\images/Mouse_bite/04_mouse_bite_10.jpg;2
580;mouse_bite;1659;271;1751;335;.\data\pcb_defects_kaggle\Annotations\Mouse_bite\04_mouse_bite_11;0.5579188481675392;0.12297077922077922;92;64;3056;2464;0.030104712041884817;0.025974025974025976;.\data\pcb_defects_kaggle\images/Mouse_bite/04_mouse_bite_11.jpg;2
581;mouse_bite;1208;1151;1299;1222;.\data\pcb_defects_kaggle\Annotations\Mouse_bite\04_mouse_bite_11;0.41017670157068065;0.4815340909090909;91;71;3056;2464;0.029777486910994765;0.028814935064935064;.\data\pcb_defects_kaggle\images/Mouse_bite/04_mouse_bite_11.jpg;2
582;mouse_bite;2273;751;2353;821;.\data\pcb_defects_kaggle\Annotations\Mouse_bite\04_mouse_bite_11;0.756871727748691;0.3189935064935065;80;70;3056;2464;0.02617801047120419;0.028409090909090908;.\data\pcb_defects_kaggle\images/Mouse_bite/04_mouse_bite_11.jpg;2
583;mouse_bite;2302;439;2393;508;.\data\pcb_defects_kaggle\Annotations\Mouse_bite\04_mouse_bite_12;0.7681609947643979;0.1921672077922078;91;69;3056;2464;0.029777486910994765;0.028003246753246752;.\data\pcb_defects_kaggle\images/Mouse_bite/04_mouse_bite_12.jpg;2
584;mouse_bite;473;504;575;573;.\data\pcb_defects_kaggle\Annotations\Mouse_bite\04_mouse_bite_12;0.17146596858638743;0.21854707792207792;102;69;3056;2464;0.03337696335078534;0.028003246753246752;.\data\pcb_defects_kaggle\images/Mouse_bite/04_mouse_bite_12.jpg;2
585;mouse_bite;513;1015;606;1070;.\data\pcb_defects_kaggle\Annotations\Mouse_bite\04_mouse_bite_12;0.1830824607329843;0.4230925324675325;93;55;3056;2464;0.03043193717277487;0.022321428571428572;.\data\pcb_defects_kaggle\images/Mouse_bite/04_mouse_bite_12.jpg;2
586;mouse_bite;855;1237;957;1304;.\data\pcb_defects_kaggle\Annotations\Mouse_bite\04_mouse_bite_13;0.2964659685863874;0.515625;102;67;3056;2464;0.03337696335078534;0.02719155844155844;.\data\pcb_defects_kaggle\images/Mouse_bite/04_mouse_bite_13.jpg;2
587;mouse_bite;2084;1093;2177;1166;.\data\pcb_defects_kaggle\Annotations\Mouse_bite\04_mouse_bite_13;0.6971531413612565;0.458400974025974;93;73;3056;2464;0.03043193717277487;0.029626623376623376;.\data\pcb_defects_kaggle\images/Mouse_bite/04_mouse_bite_13.jpg;2
588;mouse_bite;871;1801;930;1881;.\data\pcb_defects_kaggle\Annotations\Mouse_bite\04_mouse_bite_13;0.29466623036649214;0.7471590909090909;59;80;3056;2464;0.01930628272251309;0.032467532467532464;.\data\pcb_defects_kaggle\images/Mouse_bite/04_mouse_bite_13.jpg;2
589;mouse_bite;748;1126;824;1177;.\data\pcb_defects_kaggle\Annotations\Mouse_bite\04_mouse_bite_14;0.25719895287958117;0.46732954545454547;76;51;3056;2464;0.024869109947643978;0.020698051948051948;.\data\pcb_defects_kaggle\images/Mouse_bite/04_mouse_bite_14.jpg;2
590;mouse_bite;2222;1208;2282;1297;.\data\pcb_defects_kaggle\Annotations\Mouse_bite\04_mouse_bite_14;0.7369109947643979;0.5083198051948052;60;89;3056;2464;0.01963350785340314;0.03612012987012987;.\data\pcb_defects_kaggle\images/Mouse_bite/04_mouse_bite_14.jpg;2
591;mouse_bite;1973;1735;2053;1802;.\data\pcb_defects_kaggle\Annotations\Mouse_bite\04_mouse_bite_14;0.6587041884816754;0.7177353896103896;80;67;3056;2464;0.02617801047120419;0.02719155844155844;.\data\pcb_defects_kaggle\images/Mouse_bite/04_mouse_bite_14.jpg;2
592;mouse_bite;1666;1202;1751;1259;.\data\pcb_defects_kaggle\Annotations\Mouse_bite\04_mouse_bite_15;0.5590641361256544;0.4993912337662338;85;57;3056;2464;0.027814136125654452;0.023133116883116884;.\data\pcb_defects_kaggle\images/Mouse_bite/04_mouse_bite_15.jpg;2
593;mouse_bite;593;1335;651;1415;.\data\pcb_defects_kaggle\Annotations\Mouse_bite\04_mouse_bite_15;0.20353403141361257;0.5580357142857143;58;80;3056;2464;0.018979057591623036;0.032467532467532464;.\data\pcb_defects_kaggle\images/Mouse_bite/04_mouse_bite_15.jpg;2
594;mouse_bite;1571;715;1646;795;.\data\pcb_defects_kaggle\Annotations\Mouse_bite\04_mouse_bite_15;0.5263416230366492;0.30641233766233766;75;80;3056;2464;0.02454188481675393;0.032467532467532464;.\data\pcb_defects_kaggle\images/Mouse_bite/04_mouse_bite_15.jpg;2
595;mouse_bite;1795;806;1841;875;.\data\pcb_defects_kaggle\Annotations\Mouse_bite\04_mouse_bite_16;0.5948952879581152;0.341112012987013;46;69;3056;2464;0.015052356020942409;0.028003246753246752;.\data\pcb_defects_kaggle\images/Mouse_bite/04_mouse_bite_16.jpg;2
596;mouse_bite;2048;655;2117;733;.\data\pcb_defects_kaggle\Annotations\Mouse_bite\04_mouse_bite_16;0.681446335078534;0.28165584415584416;69;78;3056;2464;0.022578534031413612;0.03165584415584415;.\data\pcb_defects_kaggle\images/Mouse_bite/04_mouse_bite_16.jpg;2
597;mouse_bite;1771;1259;1861;1313;.\data\pcb_defects_kaggle\Annotations\Mouse_bite\04_mouse_bite_16;0.5942408376963351;0.5219155844155844;90;54;3056;2464;0.029450261780104712;0.021915584415584416;.\data\pcb_defects_kaggle\images/Mouse_bite/04_mouse_bite_16.jpg;2
598;mouse_bite;1219;264;1275;348;.\data\pcb_defects_kaggle\Annotations\Mouse_bite\04_mouse_bite_17;0.40804973821989526;0.1241883116883117;56;84;3056;2464;0.01832460732984293;0.03409090909090909;.\data\pcb_defects_kaggle\images/Mouse_bite/04_mouse_bite_17.jpg;2
599;mouse_bite;891;1021;950;1099;.\data\pcb_defects_kaggle\Annotations\Mouse_bite\04_mouse_bite_17;0.3012107329842932;0.4301948051948052;59;78;3056;2464;0.01930628272251309;0.03165584415584415;.\data\pcb_defects_kaggle\images/Mouse_bite/04_mouse_bite_17.jpg;2
600;mouse_bite;1993;961;2082;1024;.\data\pcb_defects_kaggle\Annotations\Mouse_bite\04_mouse_bite_17;0.6667212041884817;0.4028003246753247;89;63;3056;2464;0.02912303664921466;0.02556818181818182;.\data\pcb_defects_kaggle\images/Mouse_bite/04_mouse_bite_17.jpg;2
601;mouse_bite;1810;1088;1891;1150;.\data\pcb_defects_kaggle\Annotations\Mouse_bite\04_mouse_bite_18;0.6055301047120419;0.45413961038961037;81;62;3056;2464;0.02650523560209424;0.025162337662337664;.\data\pcb_defects_kaggle\images/Mouse_bite/04_mouse_bite_18.jpg;2
602;mouse_bite;593;1368;655;1448;.\data\pcb_defects_kaggle\Annotations\Mouse_bite\04_mouse_bite_18;0.20418848167539266;0.5714285714285714;62;80;3056;2464;0.020287958115183247;0.032467532467532464;.\data\pcb_defects_kaggle\images/Mouse_bite/04_mouse_bite_18.jpg;2
603;mouse_bite;1626;890;1681;957;.\data\pcb_defects_kaggle\Annotations\Mouse_bite\04_mouse_bite_18;0.5410667539267016;0.37479707792207795;55;67;3056;2464;0.01799738219895288;0.02719155844155844;.\data\pcb_defects_kaggle\images/Mouse_bite/04_mouse_bite_18.jpg;2
604;mouse_bite;1175;1626;1237;1704;.\data\pcb_defects_kaggle\Annotations\Mouse_bite\04_mouse_bite_19;0.3946335078534031;0.6757305194805194;62;78;3056;2464;0.020287958115183247;0.03165584415584415;.\data\pcb_defects_kaggle\images/Mouse_bite/04_mouse_bite_19.jpg;2
605;mouse_bite;2228;1381;2281;1457;.\data\pcb_defects_kaggle\Annotations\Mouse_bite\04_mouse_bite_19;0.737729057591623;0.5758928571428571;53;76;3056;2464;0.017342931937172776;0.030844155844155844;.\data\pcb_defects_kaggle\images/Mouse_bite/04_mouse_bite_19.jpg;2
606;mouse_bite;433;1350;491;1428;.\data\pcb_defects_kaggle\Annotations\Mouse_bite\04_mouse_bite_19;0.1511780104712042;0.5637175324675324;58;78;3056;2464;0.018979057591623036;0.03165584415584415;.\data\pcb_defects_kaggle\images/Mouse_bite/04_mouse_bite_19.jpg;2
607;mouse_bite;401;508;479;575;.\data\pcb_defects_kaggle\Annotations\Mouse_bite\04_mouse_bite_20;0.14397905759162305;0.2197646103896104;78;67;3056;2464;0.025523560209424083;0.02719155844155844;.\data\pcb_defects_kaggle\images/Mouse_bite/04_mouse_bite_20.jpg;2
608;mouse_bite;2024;430;2101;481;.\data\pcb_defects_kaggle\Annotations\Mouse_bite\04_mouse_bite_20;0.674901832460733;0.184862012987013;77;51;3056;2464;0.02519633507853403;0.020698051948051948;.\data\pcb_defects_kaggle\images/Mouse_bite/04_mouse_bite_20.jpg;2
609;mouse_bite;1275;1621;1333;1706;.\data\pcb_defects_kaggle\Annotations\Mouse_bite\04_mouse_bite_20;0.42670157068062825;0.6751217532467533;58;85;3056;2464;0.018979057591623036;0.03449675324675325;.\data\pcb_defects_kaggle\images/Mouse_bite/04_mouse_bite_20.jpg;2
610;mouse_bite;910;278;972;320;.\data\pcb_defects_kaggle\Annotations\Mouse_bite\05_mouse_bite_01;0.36988993710691825;0.13868274582560297;62;42;2544;2156;0.02437106918238994;0.01948051948051948;.\data\pcb_defects_kaggle\images/Mouse_bite/05_mouse_bite_01.jpg;2
611;mouse_bite;652;976;717;1021;.\data\pcb_defects_kaggle\Annotations\Mouse_bite\05_mouse_bite_01;0.269064465408805;0.46312615955473097;65;45;2544;2156;0.025550314465408806;0.020871985157699443;.\data\pcb_defects_kaggle\images/Mouse_bite/05_mouse_bite_01.jpg;2
612;mouse_bite;1222;817;1266;890;.\data\pcb_defects_kaggle\Annotations\Mouse_bite\05_mouse_bite_01;0.4889937106918239;0.39587198515769945;44;73;2544;2156;0.01729559748427673;0.03385899814471243;.\data\pcb_defects_kaggle\images/Mouse_bite/05_mouse_bite_01.jpg;2
613;mouse_bite;1577;621;1635;662;.\data\pcb_defects_kaggle\Annotations\Mouse_bite\05_mouse_bite_01;0.6312893081761006;0.2975417439703154;58;41;2544;2156;0.02279874213836478;0.019016697588126158;.\data\pcb_defects_kaggle\images/Mouse_bite/05_mouse_bite_01.jpg;2
614;mouse_bite;1828;1331;1910;1379;.\data\pcb_defects_kaggle\Annotations\Mouse_bite\05_mouse_bite_01;0.7346698113207547;0.62847866419295;82;48;2544;2156;0.03223270440251572;0.022263450834879406;.\data\pcb_defects_kaggle\images/Mouse_bite/05_mouse_bite_01.jpg;2
615;mouse_bite;683;573;762;621;.\data\pcb_defects_kaggle\Annotations\Mouse_bite\05_mouse_bite_02;0.28400157232704404;0.27690166975881264;79;48;2544;2156;0.031053459119496855;0.022263450834879406;.\data\pcb_defects_kaggle\images/Mouse_bite/05_mouse_bite_02.jpg;2
616;mouse_bite;1217;685;1263;762;.\data\pcb_defects_kaggle\Annotations\Mouse_bite\05_mouse_bite_02;0.48742138364779874;0.3355751391465677;46;77;2544;2156;0.018081761006289308;0.03571428571428571;.\data\pcb_defects_kaggle\images/Mouse_bite/05_mouse_bite_02.jpg;2
617;mouse_bite;1980;910;2027;987;.\data\pcb_defects_kaggle\Annotations\Mouse_bite\05_mouse_bite_02;0.7875393081761006;0.43993506493506496;47;77;2544;2156;0.018474842767295597;0.03571428571428571;.\data\pcb_defects_kaggle\images/Mouse_bite/05_mouse_bite_02.jpg;2
618;mouse_bite;1506;1701;1569;1740;.\data\pcb_defects_kaggle\Annotations\Mouse_bite\05_mouse_bite_02;0.6043632075471698;0.7980055658627088;63;39;2544;2156;0.024764150943396228;0.018089053803339517;.\data\pcb_defects_kaggle\images/Mouse_bite/05_mouse_bite_02.jpg;2
619;mouse_bite;1014;1771;1050;1838;.\data\pcb_defects_kaggle\Annotations\Mouse_bite\05_mouse_bite_02;0.4056603773584906;0.8369666048237476;36;67;2544;2156;0.014150943396226415;0.031076066790352505;.\data\pcb_defects_kaggle\images/Mouse_bite/05_mouse_bite_02.jpg;2
620;mouse_bite;780;332;850;385;.\data\pcb_defects_kaggle\Annotations\Mouse_bite\05_mouse_bite_03;0.3203616352201258;0.16628014842300556;70;53;2544;2156;0.027515723270440252;0.02458256029684601;.\data\pcb_defects_kaggle\images/Mouse_bite/05_mouse_bite_03.jpg;2
621;mouse_bite;166;957;208;1035;.\data\pcb_defects_kaggle\Annotations\Mouse_bite\05_mouse_bite_03;0.0735062893081761;0.4619666048237477;42;78;2544;2156;0.01650943396226415;0.036178107606679034;.\data\pcb_defects_kaggle\images/Mouse_bite/05_mouse_bite_03.jpg;2
622;mouse_bite;1774;357;1830;435;.\data\pcb_defects_kaggle\Annotations\Mouse_bite\05_mouse_bite_03;0.7083333333333334;0.1836734693877551;56;78;2544;2156;0.0220125786163522;0.036178107606679034;.\data\pcb_defects_kaggle\images/Mouse_bite/05_mouse_bite_03.jpg;2
623;mouse_bite;1975;885;2024;967;.\data\pcb_defects_kaggle\Annotations\Mouse_bite\05_mouse_bite_03;0.7859669811320755;0.4294990723562152;49;82;2544;2156;0.019261006289308175;0.038033395176252316;.\data\pcb_defects_kaggle\images/Mouse_bite/05_mouse_bite_03.jpg;2
624;mouse_bite;978;1095;1045;1160;.\data\pcb_defects_kaggle\Annotations\Mouse_bite\05_mouse_bite_03;0.3976022012578616;0.5229591836734694;67;65;2544;2156;0.026336477987421385;0.030148423005565864;.\data\pcb_defects_kaggle\images/Mouse_bite/05_mouse_bite_03.jpg;2
625;mouse_bite;1028;688;1086;735;.\data\pcb_defects_kaggle\Annotations\Mouse_bite\05_mouse_bite_04;0.4154874213836478;0.3300092764378479;58;47;2544;2156;0.02279874213836478;0.021799628942486084;.\data\pcb_defects_kaggle\images/Mouse_bite/05_mouse_bite_04.jpg;2
626;mouse_bite;1563;859;1624;918;.\data\pcb_defects_kaggle\Annotations\Mouse_bite\05_mouse_bite_04;0.626375786163522;0.41210575139146566;61;59;2544;2156;0.02397798742138365;0.02736549165120594;.\data\pcb_defects_kaggle\images/Mouse_bite/05_mouse_bite_04.jpg;2
627;mouse_bite;2075;1651;2125;1696;.\data\pcb_defects_kaggle\Annotations\Mouse_bite\05_mouse_bite_04;0.8254716981132075;0.7762059369202227;50;45;2544;2156;0.019654088050314465;0.020871985157699443;.\data\pcb_defects_kaggle\images/Mouse_bite/05_mouse_bite_04.jpg;2
628;mouse_bite;1502;1701;1552;1746;.\data\pcb_defects_kaggle\Annotations\Mouse_bite\05_mouse_bite_04;0.6002358490566038;0.7993970315398887;50;45;2544;2156;0.019654088050314465;0.020871985157699443;.\data\pcb_defects_kaggle\images/Mouse_bite/05_mouse_bite_04.jpg;2
629;mouse_bite;169;821;220;896;.\data\pcb_defects_kaggle\Annotations\Mouse_bite\05_mouse_bite_04;0.07645440251572327;0.39819109461966606;51;75;2544;2156;0.020047169811320754;0.034786641929499075;.\data\pcb_defects_kaggle\images/Mouse_bite/05_mouse_bite_04.jpg;2
630;mouse_bite;1601;578;1651;618;.\data\pcb_defects_kaggle\Annotations\Mouse_bite\05_mouse_bite_05;0.6391509433962265;0.27736549165120594;50;40;2544;2156;0.019654088050314465;0.01855287569573284;.\data\pcb_defects_kaggle\images/Mouse_bite/05_mouse_bite_05.jpg;2
631;mouse_bite;295;1357;370;1420;.\data\pcb_defects_kaggle\Annotations\Mouse_bite\05_mouse_bite_05;0.1306996855345912;0.6440166975881262;75;63;2544;2156;0.0294811320754717;0.02922077922077922;.\data\pcb_defects_kaggle\images/Mouse_bite/05_mouse_bite_05.jpg;2
632;mouse_bite;1378;1496;1416;1570;.\data\pcb_defects_kaggle\Annotations\Mouse_bite\05_mouse_bite_05;0.5491352201257862;0.711038961038961;38;74;2544;2156;0.014937106918238994;0.03432282003710575;.\data\pcb_defects_kaggle\images/Mouse_bite/05_mouse_bite_05.jpg;2
633;mouse_bite;1467;1890;1539;1934;.\data\pcb_defects_kaggle\Annotations\Mouse_bite\05_mouse_bite_05;0.5908018867924528;0.8868274582560297;72;44;2544;2156;0.02830188679245283;0.02040816326530612;.\data\pcb_defects_kaggle\images/Mouse_bite/05_mouse_bite_05.jpg;2
634;mouse_bite;1866;257;1924;323;.\data\pcb_defects_kaggle\Annotations\Mouse_bite\05_mouse_bite_05;0.7448899371069182;0.1345083487940631;58;66;2544;2156;0.02279874213836478;0.030612244897959183;.\data\pcb_defects_kaggle\images/Mouse_bite/05_mouse_bite_05.jpg;2
635;mouse_bite;1217;618;1263;696;.\data\pcb_defects_kaggle\Annotations\Mouse_bite\05_mouse_bite_06;0.48742138364779874;0.3047309833024119;46;78;2544;2156;0.018081761006289308;0.036178107606679034;.\data\pcb_defects_kaggle\images/Mouse_bite/05_mouse_bite_06.jpg;2
636;mouse_bite;710;804;788;849;.\data\pcb_defects_kaggle\Annotations\Mouse_bite\05_mouse_bite_06;0.29441823899371067;0.38334879406307976;78;45;2544;2156;0.030660377358490566;0.020871985157699443;.\data\pcb_defects_kaggle\images/Mouse_bite/05_mouse_bite_06.jpg;2
637;mouse_bite;1603;1374;1667;1426;.\data\pcb_defects_kaggle\Annotations\Mouse_bite\05_mouse_bite_06;0.6426886792452831;0.6493506493506493;64;52;2544;2156;0.025157232704402517;0.02411873840445269;.\data\pcb_defects_kaggle\images/Mouse_bite/05_mouse_bite_06.jpg;2
638;mouse_bite;2270;1523;2333;1570;.\data\pcb_defects_kaggle\Annotations\Mouse_bite\05_mouse_bite_06;0.9046776729559748;0.7173005565862709;63;47;2544;2156;0.024764150943396228;0.021799628942486084;.\data\pcb_defects_kaggle\images/Mouse_bite/05_mouse_bite_06.jpg;2
639;mouse_bite;2183;1810;2266;1860;.\data\pcb_defects_kaggle\Annotations\Mouse_bite\05_mouse_bite_06;0.8744103773584906;0.851113172541744;83;50;2544;2156;0.03262578616352201;0.023191094619666047;.\data\pcb_defects_kaggle\images/Mouse_bite/05_mouse_bite_06.jpg;2
640;mouse_bite;1430;298;1535;362;.\data\pcb_defects_kaggle\Annotations\Mouse_bite\05_mouse_bite_07;0.5827437106918238;0.15306122448979592;105;64;2544;2156;0.041273584905660375;0.029684601113172542;.\data\pcb_defects_kaggle\images/Mouse_bite/05_mouse_bite_07.jpg;2
641;mouse_bite;1549;857;1638;907;.\data\pcb_defects_kaggle\Annotations\Mouse_bite\05_mouse_bite_07;0.626375786163522;0.4090909090909091;89;50;2544;2156;0.03498427672955975;0.023191094619666047;.\data\pcb_defects_kaggle\images/Mouse_bite/05_mouse_bite_07.jpg;2
642;mouse_bite;2395;1613;2439;1676;.\data\pcb_defects_kaggle\Annotations\Mouse_bite\05_mouse_bite_07;0.9500786163522013;0.7627551020408163;44;63;2544;2156;0.01729559748427673;0.02922077922077922;.\data\pcb_defects_kaggle\images/Mouse_bite/05_mouse_bite_07.jpg;2
643;mouse_bite;1560;1860;1639;1904;.\data\pcb_defects_kaggle\Annotations\Mouse_bite\05_mouse_bite_07;0.6287342767295597;0.87291280148423;79;44;2544;2156;0.031053459119496855;0.02040816326530612;.\data\pcb_defects_kaggle\images/Mouse_bite/05_mouse_bite_07.jpg;2
644;mouse_bite;592;1304;685;1356;.\data\pcb_defects_kaggle\Annotations\Mouse_bite\05_mouse_bite_07;0.25098270440251574;0.6168831168831169;93;52;2544;2156;0.036556603773584904;0.02411873840445269;.\data\pcb_defects_kaggle\images/Mouse_bite/05_mouse_bite_07.jpg;2
645;mouse_bite;388;338;464;382;.\data\pcb_defects_kaggle\Annotations\Mouse_bite\05_mouse_bite_07;0.16745283018867924;0.16697588126159554;76;44;2544;2156;0.029874213836477988;0.02040816326530612;.\data\pcb_defects_kaggle\images/Mouse_bite/05_mouse_bite_07.jpg;2
646;mouse_bite;520;1087;603;1126;.\data\pcb_defects_kaggle\Annotations\Mouse_bite\05_mouse_bite_08;0.22071540880503146;0.5132189239332097;83;39;2544;2156;0.03262578616352201;0.018089053803339517;.\data\pcb_defects_kaggle\images/Mouse_bite/05_mouse_bite_08.jpg;2
647;mouse_bite;94;956;128;1032;.\data\pcb_defects_kaggle\Annotations\Mouse_bite\05_mouse_bite_08;0.04363207547169811;0.461038961038961;34;76;2544;2156;0.013364779874213837;0.03525046382189239;.\data\pcb_defects_kaggle\images/Mouse_bite/05_mouse_bite_08.jpg;2
648;mouse_bite;2030;640;2072;720;.\data\pcb_defects_kaggle\Annotations\Mouse_bite\05_mouse_bite_08;0.8062106918238994;0.31539888682745826;42;80;2544;2156;0.01650943396226415;0.03710575139146568;.\data\pcb_defects_kaggle\images/Mouse_bite/05_mouse_bite_08.jpg;2
649;mouse_bite;2256;1316;2310;1393;.\data\pcb_defects_kaggle\Annotations\Mouse_bite\05_mouse_bite_08;0.8974056603773585;0.6282467532467533;54;77;2544;2156;0.02122641509433962;0.03571428571428571;.\data\pcb_defects_kaggle\images/Mouse_bite/05_mouse_bite_08.jpg;2
650;mouse_bite;1172;1292;1214;1370;.\data\pcb_defects_kaggle\Annotations\Mouse_bite\05_mouse_bite_08;0.46894654088050314;0.6173469387755102;42;78;2544;2156;0.01650943396226415;0.036178107606679034;.\data\pcb_defects_kaggle\images/Mouse_bite/05_mouse_bite_08.jpg;2
651;mouse_bite;981;567;1052;612;.\data\pcb_defects_kaggle\Annotations\Mouse_bite\05_mouse_bite_09;0.3995676100628931;0.2734230055658627;71;45;2544;2156;0.02790880503144654;0.020871985157699443;.\data\pcb_defects_kaggle\images/Mouse_bite/05_mouse_bite_09.jpg;2
652;mouse_bite;1525;579;1588;621;.\data\pcb_defects_kaggle\Annotations\Mouse_bite\05_mouse_bite_09;0.6118317610062893;0.2782931354359926;63;42;2544;2156;0.024764150943396228;0.01948051948051948;.\data\pcb_defects_kaggle\images/Mouse_bite/05_mouse_bite_09.jpg;2
653;mouse_bite;1624;1013;1675;1068;.\data\pcb_defects_kaggle\Annotations\Mouse_bite\05_mouse_bite_09;0.6483883647798742;0.48260667903525045;51;55;2544;2156;0.020047169811320754;0.025510204081632654;.\data\pcb_defects_kaggle\images/Mouse_bite/05_mouse_bite_09.jpg;2
654;mouse_bite;1605;1467;1650;1509;.\data\pcb_defects_kaggle\Annotations\Mouse_bite\05_mouse_bite_09;0.6397405660377359;0.6901669758812616;45;42;2544;2156;0.01768867924528302;0.01948051948051948;.\data\pcb_defects_kaggle\images/Mouse_bite/05_mouse_bite_09.jpg;2
655;mouse_bite;1542;1663;1601;1710;.\data\pcb_defects_kaggle\Annotations\Mouse_bite\05_mouse_bite_09;0.6177279874213837;0.7822356215213359;59;47;2544;2156;0.023191823899371068;0.021799628942486084;.\data\pcb_defects_kaggle\images/Mouse_bite/05_mouse_bite_09.jpg;2
656;mouse_bite;1291;632;1350;729;.\data\pcb_defects_kaggle\Annotations\Mouse_bite\05_mouse_bite_10;0.519064465408805;0.31563079777365494;59;97;2544;2156;0.023191823899371068;0.044990723562152134;.\data\pcb_defects_kaggle\images/Mouse_bite/05_mouse_bite_10.jpg;2
657;mouse_bite;1838;971;1894;1062;.\data\pcb_defects_kaggle\Annotations\Mouse_bite\05_mouse_bite_10;0.7334905660377359;0.4714749536178108;56;91;2544;2156;0.0220125786163522;0.04220779220779221;.\data\pcb_defects_kaggle\images/Mouse_bite/05_mouse_bite_10.jpg;2
658;mouse_bite;1092;1698;1163;1746;.\data\pcb_defects_kaggle\Annotations\Mouse_bite\05_mouse_bite_10;0.4431996855345912;0.7987012987012987;71;48;2544;2156;0.02790880503144654;0.022263450834879406;.\data\pcb_defects_kaggle\images/Mouse_bite/05_mouse_bite_10.jpg;2
659;mouse_bite;1944;1332;2031;1378;.\data\pcb_defects_kaggle\Annotations\Mouse_bite\05_mouse_bite_10;0.78125;0.62847866419295;87;46;2544;2156;0.03419811320754717;0.021335807050092765;.\data\pcb_defects_kaggle\images/Mouse_bite/05_mouse_bite_10.jpg;2
660;mouse_bite;1524;1267;1563;1335;.\data\pcb_defects_kaggle\Annotations\Mouse_bite\05_mouse_bite_10;0.6067216981132075;0.6034322820037106;39;68;2544;2156;0.015330188679245283;0.03153988868274583;.\data\pcb_defects_kaggle\images/Mouse_bite/05_mouse_bite_10.jpg;2
661;mouse_bite;1299;366;1372;407;.\data\pcb_defects_kaggle\Annotations\Mouse_bite\06_mouse_bite_01;0.4656555090655509;0.1668825561312608;73;41;2868;2316;0.025453277545327755;0.01770293609671848;.\data\pcb_defects_kaggle\images/Mouse_bite/06_mouse_bite_01.jpg;2
662;mouse_bite;1406;681;1445;741;.\data\pcb_defects_kaggle\Annotations\Mouse_bite\06_mouse_bite_01;0.49703626220362623;0.3069948186528497;39;60;2868;2316;0.013598326359832637;0.025906735751295335;.\data\pcb_defects_kaggle\images/Mouse_bite/06_mouse_bite_01.jpg;2
663;mouse_bite;1508;1609;1567;1644;.\data\pcb_defects_kaggle\Annotations\Mouse_bite\06_mouse_bite_01;0.5360878661087866;0.7022884283246977;59;35;2868;2316;0.020571827057182707;0.015112262521588947;.\data\pcb_defects_kaggle\images/Mouse_bite/06_mouse_bite_01.jpg;2
664;mouse_bite;2528;1580;2567;1654;.\data\pcb_defects_kaggle\Annotations\Mouse_bite\06_mouse_bite_01;0.8882496513249651;0.6981865284974094;39;74;2868;2316;0.013598326359832637;0.03195164075993091;.\data\pcb_defects_kaggle\images/Mouse_bite/06_mouse_bite_01.jpg;2
665;mouse_bite;589;1634;627;1693;.\data\pcb_defects_kaggle\Annotations\Mouse_bite\06_mouse_bite_01;0.21199442119944212;0.7182642487046632;38;59;2868;2316;0.013249651324965132;0.02547495682210708;.\data\pcb_defects_kaggle\images/Mouse_bite/06_mouse_bite_01.jpg;2
666;mouse_bite;491;968;559;1010;.\data\pcb_defects_kaggle\Annotations\Mouse_bite\06_mouse_bite_02;0.18305439330543932;0.4270293609671848;68;42;2868;2316;0.023709902370990237;0.018134715025906734;.\data\pcb_defects_kaggle\images/Mouse_bite/06_mouse_bite_02.jpg;2
667;mouse_bite;1274;1668;1310;1724;.\data\pcb_defects_kaggle\Annotations\Mouse_bite\06_mouse_bite_02;0.4504881450488145;0.7322970639032815;36;56;2868;2316;0.012552301255230125;0.024179620034542316;.\data\pcb_defects_kaggle\images/Mouse_bite/06_mouse_bite_02.jpg;2
668;mouse_bite;2084;980;2130;1056;.\data\pcb_defects_kaggle\Annotations\Mouse_bite\06_mouse_bite_02;0.7346582984658299;0.43955094991364424;46;76;2868;2316;0.01603905160390516;0.03281519861830743;.\data\pcb_defects_kaggle\images/Mouse_bite/06_mouse_bite_02.jpg;2
669;mouse_bite;1546;1101;1615;1135;.\data\pcb_defects_kaggle\Annotations\Mouse_bite\06_mouse_bite_02;0.5510808926080892;0.48272884283246975;69;34;2868;2316;0.02405857740585774;0.01468048359240069;.\data\pcb_defects_kaggle\images/Mouse_bite/06_mouse_bite_02.jpg;2
670;mouse_bite;1142;917;1201;950;.\data\pcb_defects_kaggle\Annotations\Mouse_bite\06_mouse_bite_02;0.4084728033472803;0.40306563039723664;59;33;2868;2316;0.020571827057182707;0.014248704663212436;.\data\pcb_defects_kaggle\images/Mouse_bite/06_mouse_bite_02.jpg;2
671;mouse_bite;1796;508;1854;545;.\data\pcb_defects_kaggle\Annotations\Mouse_bite\06_mouse_bite_02;0.6363319386331938;0.22733160621761658;58;37;2868;2316;0.020223152022315203;0.015975820379965457;.\data\pcb_defects_kaggle\images/Mouse_bite/06_mouse_bite_02.jpg;2
672;mouse_bite;1152;398;1237;447;.\data\pcb_defects_kaggle\Annotations\Mouse_bite\06_mouse_bite_03;0.4164923291492329;0.182426597582038;85;49;2868;2316;0.029637377963737797;0.021157167530224525;.\data\pcb_defects_kaggle\images/Mouse_bite/06_mouse_bite_03.jpg;2
673;mouse_bite;1290;604;1366;649;.\data\pcb_defects_kaggle\Annotations\Mouse_bite\06_mouse_bite_03;0.4630404463040446;0.2705094991364421;76;45;2868;2316;0.026499302649930265;0.019430051813471502;.\data\pcb_defects_kaggle\images/Mouse_bite/06_mouse_bite_03.jpg;2
674;mouse_bite;2046;718;2087;783;.\data\pcb_defects_kaggle\Annotations\Mouse_bite\06_mouse_bite_03;0.720536959553696;0.32405008635578586;41;65;2868;2316;0.014295676429567642;0.028065630397236616;.\data\pcb_defects_kaggle\images/Mouse_bite/06_mouse_bite_03.jpg;2
675;mouse_bite;818;1532;896;1565;.\data\pcb_defects_kaggle\Annotations\Mouse_bite\06_mouse_bite_03;0.2988145048814505;0.6686096718480138;78;33;2868;2316;0.027196652719665274;0.014248704663212436;.\data\pcb_defects_kaggle\images/Mouse_bite/06_mouse_bite_03.jpg;2
676;mouse_bite;199;981;244;1074;.\data\pcb_defects_kaggle\Annotations\Mouse_bite\06_mouse_bite_03;0.07723152022315202;0.44365284974093266;45;93;2868;2316;0.015690376569037656;0.04015544041450777;.\data\pcb_defects_kaggle\images/Mouse_bite/06_mouse_bite_03.jpg;2
677;mouse_bite;1224;606;1302;647;.\data\pcb_defects_kaggle\Annotations\Mouse_bite\06_mouse_bite_04;0.44037656903765693;0.2705094991364421;78;41;2868;2316;0.027196652719665274;0.01770293609671848;.\data\pcb_defects_kaggle\images/Mouse_bite/06_mouse_bite_04.jpg;2
678;mouse_bite;2242;842;2285;926;.\data\pcb_defects_kaggle\Annotations\Mouse_bite\06_mouse_bite_04;0.7892259414225942;0.38169257340241797;43;84;2868;2316;0.01499302649930265;0.03626943005181347;.\data\pcb_defects_kaggle\images/Mouse_bite/06_mouse_bite_04.jpg;2
679;mouse_bite;1958;1432;1996;1516;.\data\pcb_defects_kaggle\Annotations\Mouse_bite\06_mouse_bite_04;0.6893305439330544;0.6364421416234888;38;84;2868;2316;0.013249651324965132;0.03626943005181347;.\data\pcb_defects_kaggle\images/Mouse_bite/06_mouse_bite_04.jpg;2
680;mouse_bite;939;1288;975;1363;.\data\pcb_defects_kaggle\Annotations\Mouse_bite\06_mouse_bite_04;0.33368200836820083;0.5723229706390328;36;75;2868;2316;0.012552301255230125;0.03238341968911917;.\data\pcb_defects_kaggle\images/Mouse_bite/06_mouse_bite_04.jpg;2
681;mouse_bite;922;1068;985;1102;.\data\pcb_defects_kaggle\Annotations\Mouse_bite\06_mouse_bite_04;0.33246164574616455;0.4684801381692573;63;34;2868;2316;0.021966527196652718;0.01468048359240069;.\data\pcb_defects_kaggle\images/Mouse_bite/06_mouse_bite_04.jpg;2
682;mouse_bite;1747;576;1827;613;.\data\pcb_defects_kaggle\Annotations\Mouse_bite\06_mouse_bite_05;0.6230822873082287;0.25669257340241797;80;37;2868;2316;0.02789400278940028;0.015975820379965457;.\data\pcb_defects_kaggle\images/Mouse_bite/06_mouse_bite_05.jpg;2
683;mouse_bite;826;368;912;406;.\data\pcb_defects_kaggle\Annotations\Mouse_bite\06_mouse_bite_05;0.30299860529986056;0.16709844559585493;86;38;2868;2316;0.0299860529986053;0.016407599309153715;.\data\pcb_defects_kaggle\images/Mouse_bite/06_mouse_bite_05.jpg;2
684;mouse_bite;163;1220;204;1310;.\data\pcb_defects_kaggle\Annotations\Mouse_bite\06_mouse_bite_05;0.06398186889818688;0.5462003454231433;41;90;2868;2316;0.014295676429567642;0.038860103626943004;.\data\pcb_defects_kaggle\images/Mouse_bite/06_mouse_bite_05.jpg;2
685;mouse_bite;1059;1894;1115;1928;.\data\pcb_defects_kaggle\Annotations\Mouse_bite\06_mouse_bite_05;0.37900976290097627;0.8251295336787565;56;34;2868;2316;0.019525801952580194;0.01468048359240069;.\data\pcb_defects_kaggle\images/Mouse_bite/06_mouse_bite_05.jpg;2
686;mouse_bite;1824;1080;1856;1155;.\data\pcb_defects_kaggle\Annotations\Mouse_bite\06_mouse_bite_05;0.6415620641562064;0.48251295336787564;32;75;2868;2316;0.011157601115760111;0.03238341968911917;.\data\pcb_defects_kaggle\images/Mouse_bite/06_mouse_bite_05.jpg;2
687;mouse_bite;2239;845;2283;928;.\data\pcb_defects_kaggle\Annotations\Mouse_bite\06_mouse_bite_06;0.7883542538354253;0.38277202072538863;44;83;2868;2316;0.015341701534170154;0.035837651122625214;.\data\pcb_defects_kaggle\images/Mouse_bite/06_mouse_bite_06.jpg;2
688;mouse_bite;2073;1480;2108;1567;.\data\pcb_defects_kaggle\Annotations\Mouse_bite\06_mouse_bite_06;0.728905160390516;0.6578151986183074;35;87;2868;2316;0.012203626220362623;0.03756476683937824;.\data\pcb_defects_kaggle\images/Mouse_bite/06_mouse_bite_06.jpg;2
689;mouse_bite;2346;1715;2408;1821;.\data\pcb_defects_kaggle\Annotations\Mouse_bite\06_mouse_bite_06;0.8288005578800558;0.7633851468048359;62;106;2868;2316;0.021617852161785217;0.045768566493955096;.\data\pcb_defects_kaggle\images/Mouse_bite/06_mouse_bite_06.jpg;2
690;mouse_bite;1250;1263;1325;1299;.\data\pcb_defects_kaggle\Annotations\Mouse_bite\06_mouse_bite_06;0.44891910739191077;0.5531088082901554;75;36;2868;2316;0.02615062761506276;0.015544041450777202;.\data\pcb_defects_kaggle\images/Mouse_bite/06_mouse_bite_06.jpg;2
691;mouse_bite;692;1529;772;1566;.\data\pcb_defects_kaggle\Annotations\Mouse_bite\06_mouse_bite_06;0.25523012552301255;0.6681778929188256;80;37;2868;2316;0.02789400278940028;0.015975820379965457;.\data\pcb_defects_kaggle\images/Mouse_bite/06_mouse_bite_06.jpg;2
692;mouse_bite;1801;508;1862;545;.\data\pcb_defects_kaggle\Annotations\Mouse_bite\06_mouse_bite_07;0.6385983263598326;0.22733160621761658;61;37;2868;2316;0.021269177126917713;0.015975820379965457;.\data\pcb_defects_kaggle\images/Mouse_bite/06_mouse_bite_07.jpg;2
693;mouse_bite;935;401;1023;444;.\data\pcb_defects_kaggle\Annotations\Mouse_bite\06_mouse_bite_07;0.3413528591352859;0.182426597582038;88;43;2868;2316;0.030683403068340307;0.018566493955094993;.\data\pcb_defects_kaggle\images/Mouse_bite/06_mouse_bite_07.jpg;2
694;mouse_bite;1194;685;1278;725;.\data\pcb_defects_kaggle\Annotations\Mouse_bite\06_mouse_bite_07;0.4309623430962343;0.30440414507772023;84;40;2868;2316;0.029288702928870293;0.017271157167530225;.\data\pcb_defects_kaggle\images/Mouse_bite/06_mouse_bite_07.jpg;2
695;mouse_bite;1062;1063;1154;1102;.\data\pcb_defects_kaggle\Annotations\Mouse_bite\06_mouse_bite_07;0.38633193863319387;0.4674006908462867;92;39;2868;2316;0.03207810320781032;0.01683937823834197;.\data\pcb_defects_kaggle\images/Mouse_bite/06_mouse_bite_07.jpg;2
696;mouse_bite;1189;1290;1265;1325;.\data\pcb_defects_kaggle\Annotations\Mouse_bite\06_mouse_bite_07;0.42782426778242677;0.5645509499136442;76;35;2868;2316;0.026499302649930265;0.015112262521588947;.\data\pcb_defects_kaggle\images/Mouse_bite/06_mouse_bite_07.jpg;2
697;mouse_bite;2240;714;2286;834;.\data\pcb_defects_kaggle\Annotations\Mouse_bite\06_mouse_bite_08;0.7890516039051604;0.33419689119170987;46;120;2868;2316;0.01603905160390516;0.05181347150259067;.\data\pcb_defects_kaggle\images/Mouse_bite/06_mouse_bite_08.jpg;2
698;mouse_bite;1930;1297;1961;1380;.\data\pcb_defects_kaggle\Annotations\Mouse_bite\06_mouse_bite_08;0.678347280334728;0.5779360967184801;31;83;2868;2316;0.010808926080892609;0.035837651122625214;.\data\pcb_defects_kaggle\images/Mouse_bite/06_mouse_bite_08.jpg;2
699;mouse_bite;1439;1083;1533;1113;.\data\pcb_defects_kaggle\Annotations\Mouse_bite\06_mouse_bite_08;0.5181311018131102;0.4740932642487047;94;30;2868;2316;0.03277545327754533;0.012953367875647668;.\data\pcb_defects_kaggle\images/Mouse_bite/06_mouse_bite_08.jpg;2
700;mouse_bite;1874;1780;1959;1810;.\data\pcb_defects_kaggle\Annotations\Mouse_bite\06_mouse_bite_08;0.6682357043235704;0.7750431778929189;85;30;2868;2316;0.029637377963737797;0.012953367875647668;.\data\pcb_defects_kaggle\images/Mouse_bite/06_mouse_bite_08.jpg;2
701;mouse_bite;893;1760;978;1799;.\data\pcb_defects_kaggle\Annotations\Mouse_bite\06_mouse_bite_08;0.3261854951185495;0.7683506044905009;85;39;2868;2316;0.029637377963737797;0.01683937823834197;.\data\pcb_defects_kaggle\images/Mouse_bite/06_mouse_bite_08.jpg;2
702;mouse_bite;1539;724;1576;795;.\data\pcb_defects_kaggle\Annotations\Mouse_bite\06_mouse_bite_08;0.5430613668061367;0.3279360967184801;37;71;2868;2316;0.01290097629009763;0.03065630397236615;.\data\pcb_defects_kaggle\images/Mouse_bite/06_mouse_bite_08.jpg;2
703;mouse_bite;415;762;490;803;.\data\pcb_defects_kaggle\Annotations\Mouse_bite\06_mouse_bite_09;0.15777545327754533;0.33786701208981;75;41;2868;2316;0.02615062761506276;0.01770293609671848;.\data\pcb_defects_kaggle\images/Mouse_bite/06_mouse_bite_09.jpg;2
704;mouse_bite;806;705;846;788;.\data\pcb_defects_kaggle\Annotations\Mouse_bite\06_mouse_bite_09;0.2880055788005579;0.3223229706390328;40;83;2868;2316;0.01394700139470014;0.035837651122625214;.\data\pcb_defects_kaggle\images/Mouse_bite/06_mouse_bite_09.jpg;2
705;mouse_bite;968;1259;1017;1360;.\data\pcb_defects_kaggle\Annotations\Mouse_bite\06_mouse_bite_09;0.3460599721059972;0.5654145077720207;49;101;2868;2316;0.01708507670850767;0.043609671848013815;.\data\pcb_defects_kaggle\images/Mouse_bite/06_mouse_bite_09.jpg;2
706;mouse_bite;307;1380;352;1454;.\data\pcb_defects_kaggle\Annotations\Mouse_bite\06_mouse_bite_09;0.1148884239888424;0.6118307426597582;45;74;2868;2316;0.015690376569037656;0.03195164075993091;.\data\pcb_defects_kaggle\images/Mouse_bite/06_mouse_bite_09.jpg;2
707;mouse_bite;524;1871;565;1963;.\data\pcb_defects_kaggle\Annotations\Mouse_bite\06_mouse_bite_09;0.18985355648535565;0.8277202072538861;41;92;2868;2316;0.014295676429567642;0.039723661485319514;.\data\pcb_defects_kaggle\images/Mouse_bite/06_mouse_bite_09.jpg;2
708;mouse_bite;1851;915;1882;997;.\data\pcb_defects_kaggle\Annotations\Mouse_bite\06_mouse_bite_10;0.6508019525801952;0.41278065630397237;31;82;2868;2316;0.010808926080892609;0.03540587219343696;.\data\pcb_defects_kaggle\images/Mouse_bite/06_mouse_bite_10.jpg;2
709;mouse_bite;2073;1638;2111;1714;.\data\pcb_defects_kaggle\Annotations\Mouse_bite\06_mouse_bite_10;0.7294281729428173;0.7236614853195165;38;76;2868;2316;0.013249651324965132;0.03281519861830743;.\data\pcb_defects_kaggle\images/Mouse_bite/06_mouse_bite_10.jpg;2
710;mouse_bite;1231;1629;1270;1702;.\data\pcb_defects_kaggle\Annotations\Mouse_bite\06_mouse_bite_10;0.4360181311018131;0.7191278065630398;39;73;2868;2316;0.013598326359832637;0.03151986183074266;.\data\pcb_defects_kaggle\images/Mouse_bite/06_mouse_bite_10.jpg;2
711;mouse_bite;1609;1265;1679;1296;.\data\pcb_defects_kaggle\Annotations\Mouse_bite\06_mouse_bite_10;0.5732217573221757;0.5528929188255614;70;31;2868;2316;0.024407252440725245;0.013385146804835924;.\data\pcb_defects_kaggle\images/Mouse_bite/06_mouse_bite_10.jpg;2
712;mouse_bite;1003;763;1097;789;.\data\pcb_defects_kaggle\Annotations\Mouse_bite\06_mouse_bite_10;0.36610878661087864;0.33506044905008636;94;26;2868;2316;0.03277545327754533;0.011226252158894647;.\data\pcb_defects_kaggle\images/Mouse_bite/06_mouse_bite_10.jpg;2
713;mouse_bite;1098;544;1149;622;.\data\pcb_defects_kaggle\Annotations\Mouse_bite\07_mouse_bite_01;0.3868801652892562;0.30348776678813116;51;78;2904;1921;0.01756198347107438;0.04060385216033316;.\data\pcb_defects_kaggle\images/Mouse_bite/07_mouse_bite_01.jpg;2
714;mouse_bite;1696;882;1748;969;.\data\pcb_defects_kaggle\Annotations\Mouse_bite\07_mouse_bite_01;0.5929752066115702;0.48178032274856847;52;87;2904;1921;0.01790633608815427;0.045288912024986985;.\data\pcb_defects_kaggle\images/Mouse_bite/07_mouse_bite_01.jpg;2
715;mouse_bite;1927;629;1987;688;.\data\pcb_defects_kaggle\Annotations\Mouse_bite\07_mouse_bite_01;0.6738980716253443;0.3427902134305049;60;59;2904;1921;0.02066115702479339;0.03071317022384175;.\data\pcb_defects_kaggle\images/Mouse_bite/07_mouse_bite_01.jpg;2
716;mouse_bite;705;926;756;1019;.\data\pcb_defects_kaggle\Annotations\Mouse_bite\07_mouse_bite_01;0.2515495867768595;0.5062467464862052;51;93;2904;1921;0.01756198347107438;0.048412285268089536;.\data\pcb_defects_kaggle\images/Mouse_bite/07_mouse_bite_01.jpg;2
717;mouse_bite;1651;1312;1737;1367;.\data\pcb_defects_kaggle\Annotations\Mouse_bite\07_mouse_bite_01;0.5833333333333334;0.6972930765226445;86;55;2904;1921;0.029614325068870524;0.028630921395106715;.\data\pcb_defects_kaggle\images/Mouse_bite/07_mouse_bite_01.jpg;2
718;mouse_bite;1187;408;1242;488;.\data\pcb_defects_kaggle\Annotations\Mouse_bite\07_mouse_bite_02;0.4182162534435262;0.2332118688183238;55;80;2904;1921;0.01893939393939394;0.041644976574700676;.\data\pcb_defects_kaggle\images/Mouse_bite/07_mouse_bite_02.jpg;2
719;mouse_bite;1913;627;1991;686;.\data\pcb_defects_kaggle\Annotations\Mouse_bite\07_mouse_bite_02;0.6721763085399449;0.34174908901613743;78;59;2904;1921;0.026859504132231406;0.03071317022384175;.\data\pcb_defects_kaggle\images/Mouse_bite/07_mouse_bite_02.jpg;2
720;mouse_bite;1765;819;1829;900;.\data\pcb_defects_kaggle\Annotations\Mouse_bite\07_mouse_bite_02;0.618801652892562;0.4474232170744404;64;81;2904;1921;0.02203856749311295;0.042165538781884435;.\data\pcb_defects_kaggle\images/Mouse_bite/07_mouse_bite_02.jpg;2
721;mouse_bite;1070;957;1151;1012;.\data\pcb_defects_kaggle\Annotations\Mouse_bite\07_mouse_bite_02;0.38240358126721763;0.5124934929724102;81;55;2904;1921;0.027892561983471075;0.028630921395106715;.\data\pcb_defects_kaggle\images/Mouse_bite/07_mouse_bite_02.jpg;2
722;mouse_bite;1049;1639;1158;1696;.\data\pcb_defects_kaggle\Annotations\Mouse_bite\07_mouse_bite_02;0.3799931129476584;0.8680374804789173;109;57;2904;1921;0.03753443526170799;0.029672045809474232;.\data\pcb_defects_kaggle\images/Mouse_bite/07_mouse_bite_02.jpg;2
723;mouse_bite;1092;576;1147;646;.\data\pcb_defects_kaggle\Annotations\Mouse_bite\07_mouse_bite_03;0.38550275482093666;0.3180635085892764;55;70;2904;1921;0.01893939393939394;0.03643935450286309;.\data\pcb_defects_kaggle\images/Mouse_bite/07_mouse_bite_03.jpg;2
724;mouse_bite;706;962;763;1046;.\data\pcb_defects_kaggle\Annotations\Mouse_bite\07_mouse_bite_03;0.2529269972451791;0.5226444560124935;57;84;2904;1921;0.01962809917355372;0.04372722540343571;.\data\pcb_defects_kaggle\images/Mouse_bite/07_mouse_bite_03.jpg;2
725;mouse_bite;1960;557;2020;620;.\data\pcb_defects_kaggle\Annotations\Mouse_bite\07_mouse_bite_03;0.6852617079889807;0.30635085892764186;60;63;2904;1921;0.02066115702479339;0.03279541905257678;.\data\pcb_defects_kaggle\images/Mouse_bite/07_mouse_bite_03.jpg;2
726;mouse_bite;2546;574;2594;665;.\data\pcb_defects_kaggle\Annotations\Mouse_bite\07_mouse_bite_03;0.8849862258953168;0.32248828735033835;48;91;2904;1921;0.01652892561983471;0.04737116085372202;.\data\pcb_defects_kaggle\images/Mouse_bite/07_mouse_bite_03.jpg;2
727;mouse_bite;2328;1032;2382;1141;.\data\pcb_defects_kaggle\Annotations\Mouse_bite\07_mouse_bite_03;0.8109504132231405;0.5655908381051535;54;109;2904;1921;0.01859504132231405;0.05674128058302967;.\data\pcb_defects_kaggle\images/Mouse_bite/07_mouse_bite_03.jpg;2
728;mouse_bite;1767;812;1829;884;.\data\pcb_defects_kaggle\Annotations\Mouse_bite\07_mouse_bite_04;0.6191460055096418;0.44143675169182717;62;72;2904;1921;0.02134986225895317;0.03748047891723061;.\data\pcb_defects_kaggle\images/Mouse_bite/07_mouse_bite_04.jpg;2
729;mouse_bite;1517;524;1555;591;.\data\pcb_defects_kaggle\Annotations\Mouse_bite\07_mouse_bite_04;0.5289256198347108;0.29021343050494536;38;67;2904;1921;0.013085399449035813;0.034877667881311816;.\data\pcb_defects_kaggle\images/Mouse_bite/07_mouse_bite_04.jpg;2
730;mouse_bite;987;201;1080;272;.\data\pcb_defects_kaggle\Annotations\Mouse_bite\07_mouse_bite_04;0.35588842975206614;0.12311296199895888;93;71;2904;1921;0.03202479338842975;0.03695991671004685;.\data\pcb_defects_kaggle\images/Mouse_bite/07_mouse_bite_04.jpg;2
731;mouse_bite;799;950;856;1015;.\data\pcb_defects_kaggle\Annotations\Mouse_bite\07_mouse_bite_04;0.2849517906336088;0.5114523685580427;57;65;2904;1921;0.01962809917355372;0.0338365434669443;.\data\pcb_defects_kaggle\images/Mouse_bite/07_mouse_bite_04.jpg;2
732;mouse_bite;515;762;598;857;.\data\pcb_defects_kaggle\Annotations\Mouse_bite\07_mouse_bite_04;0.19163223140495866;0.4213951067152525;83;95;2904;1921;0.028581267217630855;0.04945340968245705;.\data\pcb_defects_kaggle\images/Mouse_bite/07_mouse_bite_04.jpg;2
733;mouse_bite;1617;679;1696;732;.\data\pcb_defects_kaggle\Annotations\Mouse_bite\07_mouse_bite_05;0.5704201101928374;0.3672566371681416;79;53;2904;1921;0.027203856749311296;0.027589796980739198;.\data\pcb_defects_kaggle\images/Mouse_bite/07_mouse_bite_05.jpg;2
734;mouse_bite;2080;877;2160;926;.\data\pcb_defects_kaggle\Annotations\Mouse_bite\07_mouse_bite_05;0.7300275482093664;0.46928682977615827;80;49;2904;1921;0.027548209366391185;0.025507548152004164;.\data\pcb_defects_kaggle\images/Mouse_bite/07_mouse_bite_05.jpg;2
735;mouse_bite;2101;1322;2184;1374;.\data\pcb_defects_kaggle\Annotations\Mouse_bite\07_mouse_bite_05;0.737775482093664;0.7017178552837064;83;52;2904;1921;0.028581267217630855;0.02706923477355544;.\data\pcb_defects_kaggle\images/Mouse_bite/07_mouse_bite_05.jpg;2
736;mouse_bite;1472;891;1536;955;.\data\pcb_defects_kaggle\Annotations\Mouse_bite\07_mouse_bite_05;0.5179063360881543;0.48047891723060904;64;64;2904;1921;0.02203856749311295;0.03331598125976054;.\data\pcb_defects_kaggle\images/Mouse_bite/07_mouse_bite_05.jpg;2
737;mouse_bite;1109;1124;1190;1174;.\data\pcb_defects_kaggle\Annotations\Mouse_bite\07_mouse_bite_05;0.3958333333333333;0.5981259760541384;81;50;2904;1921;0.027892561983471075;0.026028110359187923;.\data\pcb_defects_kaggle\images/Mouse_bite/07_mouse_bite_05.jpg;2
738;mouse_bite;696;398;799;462;.\data\pcb_defects_kaggle\Annotations\Mouse_bite\07_mouse_bite_06;0.25740358126721763;0.22384174908901613;103;64;2904;1921;0.03546831955922865;0.03331598125976054;.\data\pcb_defects_kaggle\images/Mouse_bite/07_mouse_bite_06.jpg;2
739;mouse_bite;1655;177;1777;255;.\data\pcb_defects_kaggle\Annotations\Mouse_bite\07_mouse_bite_06;0.5909090909090909;0.11244143675169183;122;78;2904;1921;0.04201101928374656;0.04060385216033316;.\data\pcb_defects_kaggle\images/Mouse_bite/07_mouse_bite_06.jpg;2
740;mouse_bite;880;863;953;934;.\data\pcb_defects_kaggle\Annotations\Mouse_bite\07_mouse_bite_06;0.315599173553719;0.46772514315460695;73;71;2904;1921;0.025137741046831957;0.03695991671004685;.\data\pcb_defects_kaggle\images/Mouse_bite/07_mouse_bite_06.jpg;2
741;mouse_bite;2044;665;2098;724;.\data\pcb_defects_kaggle\Annotations\Mouse_bite\07_mouse_bite_06;0.7131542699724518;0.3615304528891202;54;59;2904;1921;0.01859504132231405;0.03071317022384175;.\data\pcb_defects_kaggle\images/Mouse_bite/07_mouse_bite_06.jpg;2
742;mouse_bite;2336;439;2387;520;.\data\pcb_defects_kaggle\Annotations\Mouse_bite\07_mouse_bite_06;0.8131887052341598;0.24960957834461217;51;81;2904;1921;0.01756198347107438;0.042165538781884435;.\data\pcb_defects_kaggle\images/Mouse_bite/07_mouse_bite_06.jpg;2
743;mouse_bite;1317;598;1399;648;.\data\pcb_defects_kaggle\Annotations\Mouse_bite\07_mouse_bite_07;0.46763085399449034;0.3243102550754815;82;50;2904;1921;0.028236914600550965;0.026028110359187923;.\data\pcb_defects_kaggle\images/Mouse_bite/07_mouse_bite_07.jpg;2
744;mouse_bite;1555;886;1627;951;.\data\pcb_defects_kaggle\Annotations\Mouse_bite\07_mouse_bite_07;0.5478650137741047;0.4781363872982821;72;65;2904;1921;0.024793388429752067;0.0338365434669443;.\data\pcb_defects_kaggle\images/Mouse_bite/07_mouse_bite_07.jpg;2
745;mouse_bite;1923;610;1989;682;.\data\pcb_defects_kaggle\Annotations\Mouse_bite\07_mouse_bite_07;0.6735537190082644;0.336283185840708;66;72;2904;1921;0.022727272727272728;0.03748047891723061;.\data\pcb_defects_kaggle\images/Mouse_bite/07_mouse_bite_07.jpg;2
746;mouse_bite;1237;869;1342;919;.\data\pcb_defects_kaggle\Annotations\Mouse_bite\07_mouse_bite_07;0.44404269972451793;0.4653826132222801;105;50;2904;1921;0.03615702479338843;0.026028110359187923;.\data\pcb_defects_kaggle\images/Mouse_bite/07_mouse_bite_07.jpg;2
747;mouse_bite;442;844;532;912;.\data\pcb_defects_kaggle\Annotations\Mouse_bite\07_mouse_bite_07;0.16769972451790632;0.45705361790733995;90;68;2904;1921;0.030991735537190084;0.035398230088495575;.\data\pcb_defects_kaggle\images/Mouse_bite/07_mouse_bite_07.jpg;2
748;mouse_bite;1087;555;1148;644;.\data\pcb_defects_kaggle\Annotations\Mouse_bite\07_mouse_bite_08;0.38481404958677684;0.3120770432066632;61;89;2904;1921;0.02100550964187328;0.0463300364393545;.\data\pcb_defects_kaggle\images/Mouse_bite/07_mouse_bite_08.jpg;2
749;mouse_bite;1046;1308;1142;1367;.\data\pcb_defects_kaggle\Annotations\Mouse_bite\07_mouse_bite_08;0.37672176308539945;0.696251952108277;96;59;2904;1921;0.03305785123966942;0.03071317022384175;.\data\pcb_defects_kaggle\images/Mouse_bite/07_mouse_bite_08.jpg;2
750;mouse_bite;1768;631;1846;693;.\data\pcb_defects_kaggle\Annotations\Mouse_bite\07_mouse_bite_08;0.6222451790633609;0.3446121811556481;78;62;2904;1921;0.026859504132231406;0.032274856845393024;.\data\pcb_defects_kaggle\images/Mouse_bite/07_mouse_bite_08.jpg;2
751;mouse_bite;2113;831;2208;881;.\data\pcb_defects_kaggle\Annotations\Mouse_bite\07_mouse_bite_08;0.7439738292011019;0.44560124934929723;95;50;2904;1921;0.03271349862258953;0.026028110359187923;.\data\pcb_defects_kaggle\images/Mouse_bite/07_mouse_bite_08.jpg;2
752;mouse_bite;2677;517;2744;620;.\data\pcb_defects_kaggle\Annotations\Mouse_bite\07_mouse_bite_08;0.9333677685950413;0.2959396147839667;67;103;2904;1921;0.023071625344352618;0.05361790733992712;.\data\pcb_defects_kaggle\images/Mouse_bite/07_mouse_bite_08.jpg;2
753;mouse_bite;960;384;1025;469;.\data\pcb_defects_kaggle\Annotations\Mouse_bite\07_mouse_bite_09;0.34176997245179064;0.222019781363873;65;85;2904;1921;0.022382920110192838;0.04424778761061947;.\data\pcb_defects_kaggle\images/Mouse_bite/07_mouse_bite_09.jpg;2
754;mouse_bite;1617;629;1696;686;.\data\pcb_defects_kaggle\Annotations\Mouse_bite\07_mouse_bite_09;0.5704201101928374;0.3422696512233212;79;57;2904;1921;0.027203856749311296;0.029672045809474232;.\data\pcb_defects_kaggle\images/Mouse_bite/07_mouse_bite_09.jpg;2
755;mouse_bite;1975;700;2044;777;.\data\pcb_defects_kaggle\Annotations\Mouse_bite\07_mouse_bite_09;0.6919765840220385;0.3844351900052056;69;77;2904;1921;0.023760330578512397;0.0400832899531494;.\data\pcb_defects_kaggle\images/Mouse_bite/07_mouse_bite_09.jpg;2
756;mouse_bite;2322;1015;2384;1112;.\data\pcb_defects_kaggle\Annotations\Mouse_bite\07_mouse_bite_09;0.8102617079889807;0.5536179073399271;62;97;2904;1921;0.02134986225895317;0.05049453409682457;.\data\pcb_defects_kaggle\images/Mouse_bite/07_mouse_bite_09.jpg;2
757;mouse_bite;879;877;929;948;.\data\pcb_defects_kaggle\Annotations\Mouse_bite\07_mouse_bite_09;0.31129476584022037;0.4750130140551796;50;71;2904;1921;0.01721763085399449;0.03695991671004685;.\data\pcb_defects_kaggle\images/Mouse_bite/07_mouse_bite_09.jpg;2
758;mouse_bite;1561;869;1617;941;.\data\pcb_defects_kaggle\Annotations\Mouse_bite\07_mouse_bite_10;0.5471763085399449;0.4711087975013014;56;72;2904;1921;0.01928374655647383;0.03748047891723061;.\data\pcb_defects_kaggle\images/Mouse_bite/07_mouse_bite_10.jpg;2
759;mouse_bite;1972;927;2056;981;.\data\pcb_defects_kaggle\Annotations\Mouse_bite\07_mouse_bite_10;0.6935261707988981;0.4966163456533056;84;54;2904;1921;0.028925619834710745;0.028110359187922956;.\data\pcb_defects_kaggle\images/Mouse_bite/07_mouse_bite_10.jpg;2
760;mouse_bite;960;1122;1046;1184;.\data\pcb_defects_kaggle\Annotations\Mouse_bite\07_mouse_bite_10;0.3453856749311295;0.6002082248828735;86;62;2904;1921;0.029614325068870524;0.032274856845393024;.\data\pcb_defects_kaggle\images/Mouse_bite/07_mouse_bite_10.jpg;2
761;mouse_bite;2330;439;2384;526;.\data\pcb_defects_kaggle\Annotations\Mouse_bite\07_mouse_bite_10;0.8116391184573003;0.25117126496616343;54;87;2904;1921;0.01859504132231405;0.045288912024986985;.\data\pcb_defects_kaggle\images/Mouse_bite/07_mouse_bite_10.jpg;2
762;mouse_bite;1792;467;1863;550;.\data\pcb_defects_kaggle\Annotations\Mouse_bite\07_mouse_bite_10;0.6293044077134986;0.2647058823529412;71;83;2904;1921;0.024449035812672177;0.04320666319625195;.\data\pcb_defects_kaggle\images/Mouse_bite/07_mouse_bite_10.jpg;2
763;mouse_bite;1559;1182;1612;1241;.\data\pcb_defects_kaggle\Annotations\Mouse_bite\08_mouse_bite_01;0.5746647335991302;0.5624419684308264;53;59;2759;2154;0.01920985864443639;0.027390900649953576;.\data\pcb_defects_kaggle\images/Mouse_bite/08_mouse_bite_01.jpg;2
764;mouse_bite;571;1305;628;1354;.\data\pcb_defects_kaggle\Annotations\Mouse_bite\08_mouse_bite_01;0.21728887277999276;0.6172237697307336;57;49;2759;2154;0.020659659296846683;0.02274837511606314;.\data\pcb_defects_kaggle\images/Mouse_bite/08_mouse_bite_01.jpg;2
765;mouse_bite;2253;397;2340;462;.\data\pcb_defects_kaggle\Annotations\Mouse_bite\08_mouse_bite_01;0.8323667995650598;0.19939647168059424;87;65;2759;2154;0.031533164189923885;0.030176415970287838;.\data\pcb_defects_kaggle\images/Mouse_bite/08_mouse_bite_01.jpg;2
766;mouse_bite;2143;697;2205;746;.\data\pcb_defects_kaggle\Annotations\Mouse_bite\08_mouse_bite_01;0.7879666545849946;0.334958217270195;62;49;2759;2154;0.02247191011235955;0.02274837511606314;.\data\pcb_defects_kaggle\images/Mouse_bite/08_mouse_bite_01.jpg;2
767;mouse_bite;1576;1818;1658;1874;.\data\pcb_defects_kaggle\Annotations\Mouse_bite\08_mouse_bite_01;0.5860819137368611;0.8570102135561746;82;56;2759;2154;0.029720913374411018;0.025998142989786442;.\data\pcb_defects_kaggle\images/Mouse_bite/08_mouse_bite_01.jpg;2
768;mouse_bite;1768;595;1850;639;.\data\pcb_defects_kaggle\Annotations\Mouse_bite\08_mouse_bite_02;0.6556723450525552;0.2864438254410399;82;44;2759;2154;0.029720913374411018;0.02042711234911792;.\data\pcb_defects_kaggle\images/Mouse_bite/08_mouse_bite_02.jpg;2
769;mouse_bite;2002;762;2069;829;.\data\pcb_defects_kaggle\Annotations\Mouse_bite\08_mouse_bite_02;0.7377673069952881;0.3693129062209842;67;67;2759;2154;0.024284160927872417;0.031104921077065924;.\data\pcb_defects_kaggle\images/Mouse_bite/08_mouse_bite_02.jpg;2
770;mouse_bite;1666;911;1738;977;.\data\pcb_defects_kaggle\Annotations\Mouse_bite\08_mouse_bite_02;0.61689017760058;0.4382544103992572;72;66;2759;2154;0.026096411743385284;0.03064066852367688;.\data\pcb_defects_kaggle\images/Mouse_bite/08_mouse_bite_02.jpg;2
771;mouse_bite;450;908;522;990;.\data\pcb_defects_kaggle\Annotations\Mouse_bite\08_mouse_bite_02;0.17615077926785067;0.44057567316620244;72;82;2759;2154;0.026096411743385284;0.03806870937790158;.\data\pcb_defects_kaggle\images/Mouse_bite/08_mouse_bite_02.jpg;2
772;mouse_bite;764;1238;837;1287;.\data\pcb_defects_kaggle\Annotations\Mouse_bite\08_mouse_bite_02;0.29014135556361;0.5861188486536676;73;49;2759;2154;0.026458861906487857;0.02274837511606314;.\data\pcb_defects_kaggle\images/Mouse_bite/08_mouse_bite_02.jpg;2
773;mouse_bite;2240;1061;2305;1136;.\data\pcb_defects_kaggle\Annotations\Mouse_bite\08_mouse_bite_03;0.823667995650598;0.5099814298978644;65;75;2759;2154;0.02355926060166727;0.034818941504178275;.\data\pcb_defects_kaggle\images/Mouse_bite/08_mouse_bite_03.jpg;2
774;mouse_bite;1789;1292;1846;1336;.\data\pcb_defects_kaggle\Annotations\Mouse_bite\08_mouse_bite_03;0.6587531714389272;0.6100278551532033;57;44;2759;2154;0.020659659296846683;0.02042711234911792;.\data\pcb_defects_kaggle\images/Mouse_bite/08_mouse_bite_03.jpg;2
775;mouse_bite;1247;1308;1299;1367;.\data\pcb_defects_kaggle\Annotations\Mouse_bite\08_mouse_bite_03;0.46139905762957595;0.6209377901578459;52;59;2759;2154;0.018847408481333816;0.027390900649953576;.\data\pcb_defects_kaggle\images/Mouse_bite/08_mouse_bite_03.jpg;2
776;mouse_bite;1059;1808;1142;1870;.\data\pcb_defects_kaggle\Annotations\Mouse_bite\08_mouse_bite_03;0.398876404494382;0.8537604456824512;83;62;2759;2154;0.03008336353751359;0.028783658310120707;.\data\pcb_defects_kaggle\images/Mouse_bite/08_mouse_bite_03.jpg;2
777;mouse_bite;2374;1297;2432;1369;.\data\pcb_defects_kaggle\Annotations\Mouse_bite\08_mouse_bite_03;0.8709677419354839;0.6188486536675951;58;72;2759;2154;0.021022109459949256;0.033426183844011144;.\data\pcb_defects_kaggle\images/Mouse_bite/08_mouse_bite_03.jpg;2
778;mouse_bite;1035;918;1086;974;.\data\pcb_defects_kaggle\Annotations\Mouse_bite\08_mouse_bite_04;0.38437839797027906;0.4391829155060353;51;56;2759;2154;0.018484958318231243;0.025998142989786442;.\data\pcb_defects_kaggle\images/Mouse_bite/08_mouse_bite_04.jpg;2
779;mouse_bite;459;1370;517;1416;.\data\pcb_defects_kaggle\Annotations\Mouse_bite\08_mouse_bite_04;0.1768756795940558;0.6467038068709378;58;46;2759;2154;0.021022109459949256;0.02135561745589601;.\data\pcb_defects_kaggle\images/Mouse_bite/08_mouse_bite_04.jpg;2
780;mouse_bite;2399;1000;2455;1054;.\data\pcb_defects_kaggle\Annotations\Mouse_bite\08_mouse_bite_04;0.8796665458499456;0.4767873723305478;56;54;2759;2154;0.02029720913374411;0.025069637883008356;.\data\pcb_defects_kaggle\images/Mouse_bite/08_mouse_bite_04.jpg;2
781;mouse_bite;2222;687;2278;747;.\data\pcb_defects_kaggle\Annotations\Mouse_bite\08_mouse_bite_04;0.8155128669807902;0.3328690807799443;56;60;2759;2154;0.02029720913374411;0.027855153203342618;.\data\pcb_defects_kaggle\images/Mouse_bite/08_mouse_bite_04.jpg;2
782;mouse_bite;546;574;604;647;.\data\pcb_defects_kaggle\Annotations\Mouse_bite\08_mouse_bite_04;0.2084088437839797;0.28342618384401114;58;73;2759;2154;0.021022109459949256;0.033890436397400185;.\data\pcb_defects_kaggle\images/Mouse_bite/08_mouse_bite_04.jpg;2
783;mouse_bite;2091;764;2138;818;.\data\pcb_defects_kaggle\Annotations\Mouse_bite\08_mouse_bite_05;0.7664008698803915;0.3672237697307335;47;54;2759;2154;0.01703515766582095;0.025069637883008356;.\data\pcb_defects_kaggle\images/Mouse_bite/08_mouse_bite_05.jpg;2
784;mouse_bite;1514;595;1586;643;.\data\pcb_defects_kaggle\Annotations\Mouse_bite\08_mouse_bite_05;0.5617977528089888;0.287372330547818;72;48;2759;2154;0.026096411743385284;0.022284122562674095;.\data\pcb_defects_kaggle\images/Mouse_bite/08_mouse_bite_05.jpg;2
785;mouse_bite;1566;1202;1625;1264;.\data\pcb_defects_kaggle\Annotations\Mouse_bite\08_mouse_bite_05;0.5782892352301559;0.5724233983286908;59;62;2759;2154;0.02138455962305183;0.028783658310120707;.\data\pcb_defects_kaggle\images/Mouse_bite/08_mouse_bite_05.jpg;2
786;mouse_bite;1246;1326;1302;1387;.\data\pcb_defects_kaggle\Annotations\Mouse_bite\08_mouse_bite_05;0.4617615077926785;0.6297585886722377;56;61;2759;2154;0.02029720913374411;0.028319405756731662;.\data\pcb_defects_kaggle\images/Mouse_bite/08_mouse_bite_05.jpg;2
787;mouse_bite;293;1227;350;1288;.\data\pcb_defects_kaggle\Annotations\Mouse_bite\08_mouse_bite_05;0.11652772743747734;0.5837975858867224;57;61;2759;2154;0.020659659296846683;0.028319405756731662;.\data\pcb_defects_kaggle\images/Mouse_bite/08_mouse_bite_05.jpg;2
788;mouse_bite;892;920;950;979;.\data\pcb_defects_kaggle\Annotations\Mouse_bite\08_mouse_bite_06;0.3338166002174701;0.44080779944289694;58;59;2759;2154;0.021022109459949256;0.027390900649953576;.\data\pcb_defects_kaggle\images/Mouse_bite/08_mouse_bite_06.jpg;2
789;mouse_bite;1951;1177;1996;1239;.\data\pcb_defects_kaggle\Annotations\Mouse_bite\08_mouse_bite_06;0.7152953968829286;0.5608170844939647;45;62;2759;2154;0.016310257339615802;0.028783658310120707;.\data\pcb_defects_kaggle\images/Mouse_bite/08_mouse_bite_06.jpg;2
790;mouse_bite;2237;1285;2312;1366;.\data\pcb_defects_kaggle\Annotations\Mouse_bite\08_mouse_bite_06;0.8243928959768032;0.6153667595171773;75;81;2759;2154;0.027183762232693004;0.037604456824512536;.\data\pcb_defects_kaggle\images/Mouse_bite/08_mouse_bite_06.jpg;2
791;mouse_bite;1251;1295;1305;1361;.\data\pcb_defects_kaggle\Annotations\Mouse_bite\08_mouse_bite_06;0.4632113084450888;0.61652739090065;54;66;2759;2154;0.019572308807538963;0.03064066852367688;.\data\pcb_defects_kaggle\images/Mouse_bite/08_mouse_bite_06.jpg;2
792;mouse_bite;558;584;615;656;.\data\pcb_defects_kaggle\Annotations\Mouse_bite\08_mouse_bite_06;0.2125770206596593;0.2878365831012071;57;72;2759;2154;0.020659659296846683;0.033426183844011144;.\data\pcb_defects_kaggle\images/Mouse_bite/08_mouse_bite_06.jpg;2
793;mouse_bite;1033;977;1086;1028;.\data\pcb_defects_kaggle\Annotations\Mouse_bite\08_mouse_bite_07;0.3840159478071765;0.46541318477251625;53;51;2759;2154;0.01920985864443639;0.023676880222841225;.\data\pcb_defects_kaggle\images/Mouse_bite/08_mouse_bite_07.jpg;2
794;mouse_bite;1953;1050;2010;1111;.\data\pcb_defects_kaggle\Annotations\Mouse_bite\08_mouse_bite_07;0.7181949981877492;0.5016248839368617;57;61;2759;2154;0.020659659296846683;0.028319405756731662;.\data\pcb_defects_kaggle\images/Mouse_bite/08_mouse_bite_07.jpg;2
795;mouse_bite;2396;987;2450;1061;.\data\pcb_defects_kaggle\Annotations\Mouse_bite\08_mouse_bite_07;0.8782167451975353;0.4753946146703807;54;74;2759;2154;0.019572308807538963;0.034354688950789226;.\data\pcb_defects_kaggle\images/Mouse_bite/08_mouse_bite_07.jpg;2
796;mouse_bite;2371;1634;2456;1690;.\data\pcb_defects_kaggle\Annotations\Mouse_bite\08_mouse_bite_07;0.8747734686480609;0.7715877437325905;85;56;2759;2154;0.030808263863718738;0.025998142989786442;.\data\pcb_defects_kaggle\images/Mouse_bite/08_mouse_bite_07.jpg;2
797;mouse_bite;1987;1784;2058;1839;.\data\pcb_defects_kaggle\Annotations\Mouse_bite\08_mouse_bite_07;0.7330554548749547;0.8409935004642526;71;55;2759;2154;0.02573396158028271;0.0255338904363974;.\data\pcb_defects_kaggle\images/Mouse_bite/08_mouse_bite_07.jpg;2
798;mouse_bite;1258;1302;1305;1361;.\data\pcb_defects_kaggle\Annotations\Mouse_bite\08_mouse_bite_08;0.4644798840159478;0.6181522748375116;47;59;2759;2154;0.01703515766582095;0.027390900649953576;.\data\pcb_defects_kaggle\images/Mouse_bite/08_mouse_bite_08.jpg;2
799;mouse_bite;617;900;668;966;.\data\pcb_defects_kaggle\Annotations\Mouse_bite\08_mouse_bite_08;0.23287422979340341;0.4331476323119777;51;66;2759;2154;0.018484958318231243;0.03064066852367688;.\data\pcb_defects_kaggle\images/Mouse_bite/08_mouse_bite_08.jpg;2
800;mouse_bite;2274;1206;2333;1264;.\data\pcb_defects_kaggle\Annotations\Mouse_bite\08_mouse_bite_08;0.8349039507067778;0.5733519034354689;59;58;2759;2154;0.02138455962305183;0.02692664809656453;.\data\pcb_defects_kaggle\images/Mouse_bite/08_mouse_bite_08.jpg;2
801;mouse_bite;2555;1343;2610;1421;.\data\pcb_defects_kaggle\Annotations\Mouse_bite\08_mouse_bite_08;0.9360275462123958;0.6415970287836583;55;78;2759;2154;0.019934758970641536;0.036211699164345405;.\data\pcb_defects_kaggle\images/Mouse_bite/08_mouse_bite_08.jpg;2
802;mouse_bite;1520;592;1586;638;.\data\pcb_defects_kaggle\Annotations\Mouse_bite\08_mouse_bite_08;0.5628851032982964;0.28551532033426186;66;46;2759;2154;0.023921710764769843;0.02135561745589601;.\data\pcb_defects_kaggle\images/Mouse_bite/08_mouse_bite_08.jpg;2
803;mouse_bite;1846;621;1925;667;.\data\pcb_defects_kaggle\Annotations\Mouse_bite\08_mouse_bite_09;0.6833997825299022;0.2989786443825441;79;46;2759;2154;0.028633562885103298;0.02135561745589601;.\data\pcb_defects_kaggle\images/Mouse_bite/08_mouse_bite_09.jpg;2
804;mouse_bite;2078;1067;2132;1125;.\data\pcb_defects_kaggle\Annotations\Mouse_bite\08_mouse_bite_09;0.762957593330917;0.5088207985143919;54;58;2759;2154;0.019572308807538963;0.02692664809656453;.\data\pcb_defects_kaggle\images/Mouse_bite/08_mouse_bite_09.jpg;2
805;mouse_bite;1248;990;1307;1033;.\data\pcb_defects_kaggle\Annotations\Mouse_bite\08_mouse_bite_09;0.4630300833635375;0.46959145775301764;59;43;2759;2154;0.02138455962305183;0.019962859795728878;.\data\pcb_defects_kaggle\images/Mouse_bite/08_mouse_bite_09.jpg;2
806;mouse_bite;2550;1652;2607;1720;.\data\pcb_defects_kaggle\Annotations\Mouse_bite\08_mouse_bite_09;0.9345777455599855;0.7827298050139275;57;68;2759;2154;0.020659659296846683;0.031569173630454965;.\data\pcb_defects_kaggle\images/Mouse_bite/08_mouse_bite_09.jpg;2
807;mouse_bite;269;1757;319;1816;.\data\pcb_defects_kaggle\Annotations\Mouse_bite\08_mouse_bite_09;0.10656034795215658;0.8293871866295265;50;59;2759;2154;0.01812250815512867;0.027390900649953576;.\data\pcb_defects_kaggle\images/Mouse_bite/08_mouse_bite_09.jpg;2
808;mouse_bite;1668;916;1712;980;.\data\pcb_defects_kaggle\Annotations\Mouse_bite\08_mouse_bite_10;0.6125407756433491;0.4401114206128134;44;64;2759;2154;0.01594780717651323;0.029712163416898793;.\data\pcb_defects_kaggle\images/Mouse_bite/08_mouse_bite_10.jpg;2
809;mouse_bite;2230;685;2274;754;.\data\pcb_defects_kaggle\Annotations\Mouse_bite\08_mouse_bite_10;0.8162377673069953;0.3340297121634169;44;69;2759;2154;0.01594780717651323;0.03203342618384401;.\data\pcb_defects_kaggle\images/Mouse_bite/08_mouse_bite_10.jpg;2
810;mouse_bite;2281;413;2346;451;.\data\pcb_defects_kaggle\Annotations\Mouse_bite\08_mouse_bite_10;0.8385284523378036;0.20055710306406685;65;38;2759;2154;0.02355926060166727;0.017641597028783658;.\data\pcb_defects_kaggle\images/Mouse_bite/08_mouse_bite_10.jpg;2
811;mouse_bite;1189;1300;1225;1362;.\data\pcb_defects_kaggle\Annotations\Mouse_bite\08_mouse_bite_10;0.4374773468648061;0.6179201485608171;36;62;2759;2154;0.013048205871692642;0.028783658310120707;.\data\pcb_defects_kaggle\images/Mouse_bite/08_mouse_bite_10.jpg;2
812;mouse_bite;1812;1880;1853;1962;.\data\pcb_defects_kaggle\Annotations\Mouse_bite\08_mouse_bite_10;0.6641899238854657;0.8918291550603529;41;82;2759;2154;0.014860456687205509;0.03806870937790158;.\data\pcb_defects_kaggle\images/Mouse_bite/08_mouse_bite_10.jpg;2
813;mouse_bite;1758;1212;1800;1269;.\data\pcb_defects_kaggle\Annotations\Mouse_bite\09_mouse_bite_01;0.6410810810810811;0.5745715609078277;42;57;2775;2159;0.015135135135135135;0.026401111625752663;.\data\pcb_defects_kaggle\images/Mouse_bite/09_mouse_bite_01.jpg;2
814;mouse_bite;1269;1631;1345;1677;.\data\pcb_defects_kaggle\Annotations\Mouse_bite\09_mouse_bite_01;0.470990990990991;0.7660954145437703;76;46;2775;2159;0.02738738738738739;0.021306160259379342;.\data\pcb_defects_kaggle\images/Mouse_bite/09_mouse_bite_01.jpg;2
815;mouse_bite;1517;815;1581;853;.\data\pcb_defects_kaggle\Annotations\Mouse_bite\09_mouse_bite_01;0.5581981981981982;0.38628994905048636;64;38;2775;2159;0.023063063063063063;0.01760074108383511;.\data\pcb_defects_kaggle\images/Mouse_bite/09_mouse_bite_01.jpg;2
816;mouse_bite;1125;435;1176;492;.\data\pcb_defects_kaggle\Annotations\Mouse_bite\09_mouse_bite_01;0.4145945945945946;0.21468272348309403;51;57;2775;2159;0.018378378378378378;0.026401111625752663;.\data\pcb_defects_kaggle\images/Mouse_bite/09_mouse_bite_01.jpg;2
817;mouse_bite;528;813;576;886;.\data\pcb_defects_kaggle\Annotations\Mouse_bite\09_mouse_bite_01;0.1989189189189189;0.39346919870310326;48;73;2775;2159;0.017297297297297298;0.03381194997684113;.\data\pcb_defects_kaggle\images/Mouse_bite/09_mouse_bite_01.jpg;2
818;mouse_bite;1543;433;1607;510;.\data\pcb_defects_kaggle\Annotations\Mouse_bite\09_mouse_bite_02;0.5675675675675675;0.21838814265863826;64;77;2775;2159;0.023063063063063063;0.035664659564613246;.\data\pcb_defects_kaggle\images/Mouse_bite/09_mouse_bite_02.jpg;2
819;mouse_bite;1194;861;1263;907;.\data\pcb_defects_kaggle\Annotations\Mouse_bite\09_mouse_bite_02;0.4427027027027027;0.4094488188976378;69;46;2775;2159;0.024864864864864864;0.021306160259379342;.\data\pcb_defects_kaggle\images/Mouse_bite/09_mouse_bite_02.jpg;2
820;mouse_bite;1949;1118;1990;1189;.\data\pcb_defects_kaggle\Annotations\Mouse_bite\09_mouse_bite_02;0.7097297297297297;0.5342751273737841;41;71;2775;2159;0.014774774774774775;0.03288559518295507;.\data\pcb_defects_kaggle\images/Mouse_bite/09_mouse_bite_02.jpg;2
821;mouse_bite;2076;1641;2149;1679;.\data\pcb_defects_kaggle\Annotations\Mouse_bite\09_mouse_bite_02;0.7612612612612613;0.7688744789254285;73;38;2775;2159;0.026306306306306305;0.01760074108383511;.\data\pcb_defects_kaggle\images/Mouse_bite/09_mouse_bite_02.jpg;2
822;mouse_bite;2040;174;2090;243;.\data\pcb_defects_kaggle\Annotations\Mouse_bite\09_mouse_bite_02;0.7441441441441441;0.09657248726262159;50;69;2775;2159;0.018018018018018018;0.03195924038906901;.\data\pcb_defects_kaggle\images/Mouse_bite/09_mouse_bite_02.jpg;2
823;mouse_bite;1554;730;1620;769;.\data\pcb_defects_kaggle\Annotations\Mouse_bite\09_mouse_bite_03;0.5718918918918919;0.34715145900880034;66;39;2775;2159;0.023783783783783784;0.018063918480778138;.\data\pcb_defects_kaggle\images/Mouse_bite/09_mouse_bite_03.jpg;2
824;mouse_bite;774;699;836;768;.\data\pcb_defects_kaggle\Annotations\Mouse_bite\09_mouse_bite_03;0.29009009009009007;0.3397406206577119;62;69;2775;2159;0.022342342342342343;0.03195924038906901;.\data\pcb_defects_kaggle\images/Mouse_bite/09_mouse_bite_03.jpg;2
825;mouse_bite;1545;1630;1625;1679;.\data\pcb_defects_kaggle\Annotations\Mouse_bite\09_mouse_bite_03;0.5711711711711712;0.7663270032422418;80;49;2775;2159;0.02882882882882883;0.02269569245020843;.\data\pcb_defects_kaggle\images/Mouse_bite/09_mouse_bite_03.jpg;2
826;mouse_bite;484;1336;563;1387;.\data\pcb_defects_kaggle\Annotations\Mouse_bite\09_mouse_bite_03;0.18864864864864864;0.6306160259379342;79;51;2775;2159;0.02846846846846847;0.023622047244094488;.\data\pcb_defects_kaggle\images/Mouse_bite/09_mouse_bite_03.jpg;2
827;mouse_bite;923;1120;959;1166;.\data\pcb_defects_kaggle\Annotations\Mouse_bite\09_mouse_bite_03;0.3390990990990991;0.5294117647058824;36;46;2775;2159;0.012972972972972972;0.021306160259379342;.\data\pcb_defects_kaggle\images/Mouse_bite/09_mouse_bite_03.jpg;2
828;mouse_bite;1622;504;1674;576;.\data\pcb_defects_kaggle\Annotations\Mouse_bite\09_mouse_bite_04;0.5938738738738739;0.25011579434923575;52;72;2775;2159;0.018738738738738738;0.0333487725798981;.\data\pcb_defects_kaggle\images/Mouse_bite/09_mouse_bite_04.jpg;2
829;mouse_bite;1127;717;1171;784;.\data\pcb_defects_kaggle\Annotations\Mouse_bite\09_mouse_bite_04;0.41405405405405404;0.3476146364057434;44;67;2775;2159;0.015855855855855857;0.031032885595182955;.\data\pcb_defects_kaggle\images/Mouse_bite/09_mouse_bite_04.jpg;2
830;mouse_bite;1133;1118;1172;1168;.\data\pcb_defects_kaggle\Annotations\Mouse_bite\09_mouse_bite_04;0.4153153153153153;0.5294117647058824;39;50;2775;2159;0.014054054054054054;0.02315886984715146;.\data\pcb_defects_kaggle\images/Mouse_bite/09_mouse_bite_04.jpg;2
831;mouse_bite;646;417;697;482;.\data\pcb_defects_kaggle\Annotations\Mouse_bite\09_mouse_bite_04;0.24198198198198198;0.20819823992589162;51;65;2775;2159;0.018378378378378378;0.030106530801296896;.\data\pcb_defects_kaggle\images/Mouse_bite/09_mouse_bite_04.jpg;2
832;mouse_bite;2276;481;2328;531;.\data\pcb_defects_kaggle\Annotations\Mouse_bite\09_mouse_bite_04;0.8295495495495495;0.23436776285317276;52;50;2775;2159;0.018738738738738738;0.02315886984715146;.\data\pcb_defects_kaggle\images/Mouse_bite/09_mouse_bite_04.jpg;2
833;mouse_bite;1477;497;1530;566;.\data\pcb_defects_kaggle\Annotations\Mouse_bite\09_mouse_bite_05;0.5418018018018018;0.24617878647522;53;69;2775;2159;0.0190990990990991;0.03195924038906901;.\data\pcb_defects_kaggle\images/Mouse_bite/09_mouse_bite_05.jpg;2
834;mouse_bite;1749;1023;1825;1063;.\data\pcb_defects_kaggle\Annotations\Mouse_bite\09_mouse_bite_05;0.6439639639639639;0.48309402501157944;76;40;2775;2159;0.02738738738738739;0.018527095877721167;.\data\pcb_defects_kaggle\images/Mouse_bite/09_mouse_bite_05.jpg;2
835;mouse_bite;792;253;831;322;.\data\pcb_defects_kaggle\Annotations\Mouse_bite\09_mouse_bite_05;0.29243243243243244;0.1331635016211209;39;69;2775;2159;0.014054054054054054;0.03195924038906901;.\data\pcb_defects_kaggle\images/Mouse_bite/09_mouse_bite_05.jpg;2
836;mouse_bite;2277;1061;2341;1105;.\data\pcb_defects_kaggle\Annotations\Mouse_bite\09_mouse_bite_05;0.8320720720720721;0.5016211208893006;64;44;2775;2159;0.023063063063063063;0.020379805465493284;.\data\pcb_defects_kaggle\images/Mouse_bite/09_mouse_bite_05.jpg;2
837;mouse_bite;386;851;427;941;.\data\pcb_defects_kaggle\Annotations\Mouse_bite\09_mouse_bite_05;0.1464864864864865;0.41500694766095414;41;90;2775;2159;0.014774774774774775;0.041685965724872626;.\data\pcb_defects_kaggle\images/Mouse_bite/09_mouse_bite_05.jpg;2
838;mouse_bite;986;431;1033;499;.\data\pcb_defects_kaggle\Annotations\Mouse_bite\09_mouse_bite_06;0.3637837837837838;0.21537748957850858;47;68;2775;2159;0.016936936936936937;0.031496062992125984;.\data\pcb_defects_kaggle\images/Mouse_bite/09_mouse_bite_06.jpg;2
839;mouse_bite;861;951;933;1004;.\data\pcb_defects_kaggle\Annotations\Mouse_bite\09_mouse_bite_06;0.3232432432432432;0.452755905511811;72;53;2775;2159;0.025945945945945945;0.024548402037980546;.\data\pcb_defects_kaggle\images/Mouse_bite/09_mouse_bite_06.jpg;2
840;mouse_bite;1305;1236;1366;1281;.\data\pcb_defects_kaggle\Annotations\Mouse_bite\09_mouse_bite_06;0.4812612612612613;0.5829087540528022;61;45;2775;2159;0.021981981981981983;0.020842982862436313;.\data\pcb_defects_kaggle\images/Mouse_bite/09_mouse_bite_06.jpg;2
841;mouse_bite;2631;689;2679;761;.\data\pcb_defects_kaggle\Annotations\Mouse_bite\09_mouse_bite_06;0.9567567567567568;0.33580361278369614;48;72;2775;2159;0.017297297297297298;0.0333487725798981;.\data\pcb_defects_kaggle\images/Mouse_bite/09_mouse_bite_06.jpg;2
842;mouse_bite;2307;556;2379;613;.\data\pcb_defects_kaggle\Annotations\Mouse_bite\09_mouse_bite_06;0.8443243243243244;0.27072718851320055;72;57;2775;2159;0.025945945945945945;0.026401111625752663;.\data\pcb_defects_kaggle\images/Mouse_bite/09_mouse_bite_06.jpg;2
843;mouse_bite;1130;430;1187;505;.\data\pcb_defects_kaggle\Annotations\Mouse_bite\09_mouse_bite_07;0.4174774774774775;0.21653543307086615;57;75;2775;2159;0.02054054054054054;0.03473830477072719;.\data\pcb_defects_kaggle\images/Mouse_bite/09_mouse_bite_07.jpg;2
844;mouse_bite;1666;523;1713;600;.\data\pcb_defects_kaggle\Annotations\Mouse_bite\09_mouse_bite_07;0.6088288288288288;0.26007410838351086;47;77;2775;2159;0.016936936936936937;0.035664659564613246;.\data\pcb_defects_kaggle\images/Mouse_bite/09_mouse_bite_07.jpg;2
845;mouse_bite;513;794;572;877;.\data\pcb_defects_kaggle\Annotations\Mouse_bite\09_mouse_bite_07;0.1954954954954955;0.3869847151459009;59;83;2775;2159;0.021261261261261263;0.03844372394627142;.\data\pcb_defects_kaggle\images/Mouse_bite/09_mouse_bite_07.jpg;2
846;mouse_bite;948;904;1018;959;.\data\pcb_defects_kaggle\Annotations\Mouse_bite\09_mouse_bite_07;0.3542342342342342;0.4314497452524317;70;55;2775;2159;0.025225225225225224;0.025474756831866605;.\data\pcb_defects_kaggle\images/Mouse_bite/09_mouse_bite_07.jpg;2
847;mouse_bite;2558;1715;2620;1756;.\data\pcb_defects_kaggle\Annotations\Mouse_bite\09_mouse_bite_07;0.932972972972973;0.8038443723946271;62;41;2775;2159;0.022342342342342343;0.018990273274664196;.\data\pcb_defects_kaggle\images/Mouse_bite/09_mouse_bite_07.jpg;2
848;mouse_bite;1479;431;1525;497;.\data\pcb_defects_kaggle\Annotations\Mouse_bite\09_mouse_bite_08;0.5412612612612613;0.21491431218156554;46;66;2775;2159;0.016576576576576577;0.030569708198239925;.\data\pcb_defects_kaggle\images/Mouse_bite/09_mouse_bite_08.jpg;2
849;mouse_bite;1846;990;1918;1036;.\data\pcb_defects_kaggle\Annotations\Mouse_bite\09_mouse_bite_08;0.6781981981981982;0.46919870310328854;72;46;2775;2159;0.025945945945945945;0.021306160259379342;.\data\pcb_defects_kaggle\images/Mouse_bite/09_mouse_bite_08.jpg;2
850;mouse_bite;2587;1007;2654;1071;.\data\pcb_defects_kaggle\Annotations\Mouse_bite\09_mouse_bite_08;0.9443243243243243;0.4812413154238073;67;64;2775;2159;0.024144144144144144;0.029643353404353867;.\data\pcb_defects_kaggle\images/Mouse_bite/09_mouse_bite_08.jpg;2
851;mouse_bite;567;1272;613;1333;.\data\pcb_defects_kaggle\Annotations\Mouse_bite\09_mouse_bite_08;0.2126126126126126;0.6032885595182955;46;61;2775;2159;0.016576576576576577;0.02825382121352478;.\data\pcb_defects_kaggle\images/Mouse_bite/09_mouse_bite_08.jpg;2
852;mouse_bite;2431;635;2504;677;.\data\pcb_defects_kaggle\Annotations\Mouse_bite\09_mouse_bite_08;0.8891891891891892;0.30384437239462714;73;42;2775;2159;0.026306306306306305;0.019453450671607225;.\data\pcb_defects_kaggle\images/Mouse_bite/09_mouse_bite_08.jpg;2
853;mouse_bite;941;558;1000;612;.\data\pcb_defects_kaggle\Annotations\Mouse_bite\09_mouse_bite_09;0.3497297297297297;0.27095877721167205;59;54;2775;2159;0.021261261261261263;0.025011579434923575;.\data\pcb_defects_kaggle\images/Mouse_bite/09_mouse_bite_09.jpg;2
854;mouse_bite;581;500;656;569;.\data\pcb_defects_kaggle\Annotations\Mouse_bite\09_mouse_bite_09;0.22288288288288288;0.2475683186660491;75;69;2775;2159;0.02702702702702703;0.03195924038906901;.\data\pcb_defects_kaggle\images/Mouse_bite/09_mouse_bite_09.jpg;2
855;mouse_bite;1659;1017;1738;1059;.\data\pcb_defects_kaggle\Annotations\Mouse_bite\09_mouse_bite_09;0.612072072072072;0.4807781380268643;79;42;2775;2159;0.02846846846846847;0.019453450671607225;.\data\pcb_defects_kaggle\images/Mouse_bite/09_mouse_bite_09.jpg;2
856;mouse_bite;1864;328;1945;374;.\data\pcb_defects_kaggle\Annotations\Mouse_bite\09_mouse_bite_09;0.6863063063063063;0.16257526632700325;81;46;2775;2159;0.02918918918918919;0.021306160259379342;.\data\pcb_defects_kaggle\images/Mouse_bite/09_mouse_bite_09.jpg;2
857;mouse_bite;1300;1494;1390;1541;.\data\pcb_defects_kaggle\Annotations\Mouse_bite\09_mouse_bite_09;0.4846846846846847;0.7028716998610468;90;47;2775;2159;0.032432432432432434;0.02176933765632237;.\data\pcb_defects_kaggle\images/Mouse_bite/09_mouse_bite_09.jpg;2
858;mouse_bite;1487;289;1543;361;.\data\pcb_defects_kaggle\Annotations\Mouse_bite\09_mouse_bite_10;0.5459459459459459;0.1505326540064845;56;72;2775;2159;0.02018018018018018;0.0333487725798981;.\data\pcb_defects_kaggle\images/Mouse_bite/09_mouse_bite_10.jpg;2
859;mouse_bite;1022;554;1084;605;.\data\pcb_defects_kaggle\Annotations\Mouse_bite\09_mouse_bite_10;0.37945945945945947;0.2684113015284854;62;51;2775;2159;0.022342342342342343;0.023622047244094488;.\data\pcb_defects_kaggle\images/Mouse_bite/09_mouse_bite_10.jpg;2
860;mouse_bite;1120;713;1179;784;.\data\pcb_defects_kaggle\Annotations\Mouse_bite\09_mouse_bite_10;0.4142342342342342;0.34668828161185733;59;71;2775;2159;0.021261261261261263;0.03288559518295507;.\data\pcb_defects_kaggle\images/Mouse_bite/09_mouse_bite_10.jpg;2
861;mouse_bite;2104;964;2195;1013;.\data\pcb_defects_kaggle\Annotations\Mouse_bite\09_mouse_bite_10;0.7745945945945946;0.45785085687818433;91;49;2775;2159;0.03279279279279279;0.02269569245020843;.\data\pcb_defects_kaggle\images/Mouse_bite/09_mouse_bite_10.jpg;2
862;mouse_bite;569;1112;631;1177;.\data\pcb_defects_kaggle\Annotations\Mouse_bite\09_mouse_bite_10;0.21621621621621623;0.5301065308012969;62;65;2775;2159;0.022342342342342343;0.030106530801296896;.\data\pcb_defects_kaggle\images/Mouse_bite/09_mouse_bite_10.jpg;2
863;mouse_bite;966;411;1042;499;.\data\pcb_defects_kaggle\Annotations\Mouse_bite\10_mouse_bite_01;0.44821428571428573;0.22569444444444445;76;88;2240;2016;0.033928571428571426;0.04365079365079365;.\data\pcb_defects_kaggle\images/Mouse_bite/10_mouse_bite_01.jpg;2
864;mouse_bite;1532;941;1633;1022;.\data\pcb_defects_kaggle\Annotations\Mouse_bite\10_mouse_bite_01;0.7064732142857143;0.4868551587301587;101;81;2240;2016;0.045089285714285714;0.04017857142857143;.\data\pcb_defects_kaggle\images/Mouse_bite/10_mouse_bite_01.jpg;2
865;mouse_bite;1017;1035;1097;1112;.\data\pcb_defects_kaggle\Annotations\Mouse_bite\10_mouse_bite_01;0.471875;0.5324900793650794;80;77;2240;2016;0.03571428571428571;0.03819444444444445;.\data\pcb_defects_kaggle\images/Mouse_bite/10_mouse_bite_01.jpg;2
866;mouse_bite;1494;1300;1575;1396;.\data\pcb_defects_kaggle\Annotations\Mouse_bite\10_mouse_bite_01;0.6850446428571428;0.6686507936507936;81;96;2240;2016;0.03616071428571429;0.047619047619047616;.\data\pcb_defects_kaggle\images/Mouse_bite/10_mouse_bite_01.jpg;2
867;mouse_bite;1907;1419;1975;1479;.\data\pcb_defects_kaggle\Annotations\Mouse_bite\10_mouse_bite_01;0.8665178571428571;0.71875;68;60;2240;2016;0.030357142857142857;0.02976190476190476;.\data\pcb_defects_kaggle\images/Mouse_bite/10_mouse_bite_01.jpg;2
868;mouse_bite;1291;561;1366;640;.\data\pcb_defects_kaggle\Annotations\Mouse_bite\10_mouse_bite_02;0.5930803571428571;0.2978670634920635;75;79;2240;2016;0.033482142857142856;0.039186507936507936;.\data\pcb_defects_kaggle\images/Mouse_bite/10_mouse_bite_02.jpg;2
869;mouse_bite;927;802;1011;882;.\data\pcb_defects_kaggle\Annotations\Mouse_bite\10_mouse_bite_02;0.43258928571428573;0.4176587301587302;84;80;2240;2016;0.0375;0.03968253968253968;.\data\pcb_defects_kaggle\images/Mouse_bite/10_mouse_bite_02.jpg;2
870;mouse_bite;1520;957;1611;1022;.\data\pcb_defects_kaggle\Annotations\Mouse_bite\10_mouse_bite_02;0.6988839285714286;0.4908234126984127;91;65;2240;2016;0.040625;0.032242063492063495;.\data\pcb_defects_kaggle\images/Mouse_bite/10_mouse_bite_02.jpg;2
871;mouse_bite;1910;1008;1975;1063;.\data\pcb_defects_kaggle\Annotations\Mouse_bite\10_mouse_bite_02;0.8671875;0.513640873015873;65;55;2240;2016;0.029017857142857144;0.027281746031746032;.\data\pcb_defects_kaggle\images/Mouse_bite/10_mouse_bite_02.jpg;2
872;mouse_bite;1833;416;1908;471;.\data\pcb_defects_kaggle\Annotations\Mouse_bite\10_mouse_bite_02;0.8350446428571429;0.21999007936507936;75;55;2240;2016;0.033482142857142856;0.027281746031746032;.\data\pcb_defects_kaggle\images/Mouse_bite/10_mouse_bite_02.jpg;2
873;mouse_bite;940;1427;1017;1496;.\data\pcb_defects_kaggle\Annotations\Mouse_bite\10_mouse_bite_02;0.4368303571428571;0.7249503968253969;77;69;2240;2016;0.034375;0.03422619047619048;.\data\pcb_defects_kaggle\images/Mouse_bite/10_mouse_bite_02.jpg;2
874;mouse_bite;962;425;1032;518;.\data\pcb_defects_kaggle\Annotations\Mouse_bite\10_mouse_bite_03;0.4450892857142857;0.23387896825396826;70;93;2240;2016;0.03125;0.046130952380952384;.\data\pcb_defects_kaggle\images/Mouse_bite/10_mouse_bite_03.jpg;2
875;mouse_bite;1668;1044;1743;1122;.\data\pcb_defects_kaggle\Annotations\Mouse_bite\10_mouse_bite_03;0.7613839285714286;0.5372023809523809;75;78;2240;2016;0.033482142857142856;0.03869047619047619;.\data\pcb_defects_kaggle\images/Mouse_bite/10_mouse_bite_03.jpg;2
876;mouse_bite;1853;600;1927;667;.\data\pcb_defects_kaggle\Annotations\Mouse_bite\10_mouse_bite_03;0.84375;0.3142361111111111;74;67;2240;2016;0.033035714285714286;0.033234126984126984;.\data\pcb_defects_kaggle\images/Mouse_bite/10_mouse_bite_03.jpg;2
877;mouse_bite;1833;1648;1917;1716;.\data\pcb_defects_kaggle\Annotations\Mouse_bite\10_mouse_bite_03;0.8370535714285714;0.8343253968253969;84;68;2240;2016;0.0375;0.03373015873015873;.\data\pcb_defects_kaggle\images/Mouse_bite/10_mouse_bite_03.jpg;2
878;mouse_bite;1808;1212;1887;1267;.\data\pcb_defects_kaggle\Annotations\Mouse_bite\10_mouse_bite_03;0.8247767857142857;0.6148313492063492;79;55;2240;2016;0.03526785714285714;0.027281746031746032;.\data\pcb_defects_kaggle\images/Mouse_bite/10_mouse_bite_03.jpg;2
879;mouse_bite;1416;341;1501;400;.\data\pcb_defects_kaggle\Annotations\Mouse_bite\10_mouse_bite_04;0.6511160714285714;0.18377976190476192;85;59;2240;2016;0.03794642857142857;0.029265873015873016;.\data\pcb_defects_kaggle\images/Mouse_bite/10_mouse_bite_04.jpg;2
880;mouse_bite;1146;731;1249;806;.\data\pcb_defects_kaggle\Annotations\Mouse_bite\10_mouse_bite_04;0.5345982142857143;0.3812003968253968;103;75;2240;2016;0.04598214285714286;0.03720238095238095;.\data\pcb_defects_kaggle\images/Mouse_bite/10_mouse_bite_04.jpg;2
881;mouse_bite;1023;1161;1107;1238;.\data\pcb_defects_kaggle\Annotations\Mouse_bite\10_mouse_bite_04;0.47544642857142855;0.5949900793650794;84;77;2240;2016;0.0375;0.03819444444444445;.\data\pcb_defects_kaggle\images/Mouse_bite/10_mouse_bite_04.jpg;2
882;mouse_bite;1197;1647;1297;1721;.\data\pcb_defects_kaggle\Annotations\Mouse_bite\10_mouse_bite_04;0.5566964285714285;0.8353174603174603;100;74;2240;2016;0.044642857142857144;0.03670634920634921;.\data\pcb_defects_kaggle\images/Mouse_bite/10_mouse_bite_04.jpg;2
883;mouse_bite;742;853;839;942;.\data\pcb_defects_kaggle\Annotations\Mouse_bite\10_mouse_bite_04;0.3529017857142857;0.44518849206349204;97;89;2240;2016;0.04330357142857143;0.0441468253968254;.\data\pcb_defects_kaggle\images/Mouse_bite/10_mouse_bite_04.jpg;2
884;mouse_bite;1155;406;1249;486;.\data\pcb_defects_kaggle\Annotations\Mouse_bite\10_mouse_bite_05;0.5366071428571428;0.22123015873015872;94;80;2240;2016;0.04196428571428571;0.03968253968253968;.\data\pcb_defects_kaggle\images/Mouse_bite/10_mouse_bite_05.jpg;2
885;mouse_bite;1975;486;2043;554;.\data\pcb_defects_kaggle\Annotations\Mouse_bite\10_mouse_bite_05;0.896875;0.25793650793650796;68;68;2240;2016;0.030357142857142857;0.03373015873015873;.\data\pcb_defects_kaggle\images/Mouse_bite/10_mouse_bite_05.jpg;2
886;mouse_bite;903;789;1007;863;.\data\pcb_defects_kaggle\Annotations\Mouse_bite\10_mouse_bite_05;0.4263392857142857;0.4097222222222222;104;74;2240;2016;0.04642857142857143;0.03670634920634921;.\data\pcb_defects_kaggle\images/Mouse_bite/10_mouse_bite_05.jpg;2
887;mouse_bite;1659;1042;1737;1132;.\data\pcb_defects_kaggle\Annotations\Mouse_bite\10_mouse_bite_05;0.7580357142857143;0.5391865079365079;78;90;2240;2016;0.03482142857142857;0.044642857142857144;.\data\pcb_defects_kaggle\images/Mouse_bite/10_mouse_bite_05.jpg;2
888;mouse_bite;1801;1518;1878;1571;.\data\pcb_defects_kaggle\Annotations\Mouse_bite\10_mouse_bite_05;0.8212053571428571;0.7661210317460317;77;53;2240;2016;0.034375;0.02628968253968254;.\data\pcb_defects_kaggle\images/Mouse_bite/10_mouse_bite_05.jpg;2
889;mouse_bite;973;375;1032;432;.\data\pcb_defects_kaggle\Annotations\Mouse_bite\11_mouse_bite_01;0.439307624890447;0.17949288256227758;59;57;2282;2248;0.025854513584574933;0.025355871886120998;.\data\pcb_defects_kaggle\images/Mouse_bite/11_mouse_bite_01.jpg;2
890;mouse_bite;1253;401;1320;460;.\data\pcb_defects_kaggle\Annotations\Mouse_bite\11_mouse_bite_01;0.5637598597721297;0.1915035587188612;67;59;2282;2248;0.029360210341805432;0.026245551601423486;.\data\pcb_defects_kaggle\images/Mouse_bite/11_mouse_bite_01.jpg;2
891;mouse_bite;1509;1088;1571;1173;.\data\pcb_defects_kaggle\Annotations\Mouse_bite\11_mouse_bite_01;0.6748466257668712;0.5028914590747331;62;85;2282;2248;0.02716914986853637;0.037811387900355875;.\data\pcb_defects_kaggle\images/Mouse_bite/11_mouse_bite_01.jpg;2
892;mouse_bite;920;1476;986;1552;.\data\pcb_defects_kaggle\Annotations\Mouse_bite\11_mouse_bite_01;0.41761612620508326;0.6734875444839857;66;76;2282;2248;0.028921998247151623;0.033807829181494664;.\data\pcb_defects_kaggle\images/Mouse_bite/11_mouse_bite_01.jpg;2
893;mouse_bite;575;853;647;922;.\data\pcb_defects_kaggle\Annotations\Mouse_bite\11_mouse_bite_01;0.2677475898334794;0.39479537366548045;72;69;2282;2248;0.03155127081507449;0.03069395017793594;.\data\pcb_defects_kaggle\images/Mouse_bite/11_mouse_bite_01.jpg;2
894;mouse_bite;758;337;819;406;.\data\pcb_defects_kaggle\Annotations\Mouse_bite\11_mouse_bite_02;0.34553023663453114;0.1652580071174377;61;69;2282;2248;0.02673093777388256;0.03069395017793594;.\data\pcb_defects_kaggle\images/Mouse_bite/11_mouse_bite_02.jpg;2
895;mouse_bite;1488;529;1565;599;.\data\pcb_defects_kaggle\Annotations\Mouse_bite\11_mouse_bite_02;0.6689307624890447;0.2508896797153025;77;70;2282;2248;0.03374233128834356;0.03113879003558719;.\data\pcb_defects_kaggle\images/Mouse_bite/11_mouse_bite_02.jpg;2
896;mouse_bite;1070;719;1139;796;.\data\pcb_defects_kaggle\Annotations\Mouse_bite\11_mouse_bite_02;0.4840052585451358;0.3369661921708185;69;77;2282;2248;0.030236634531113058;0.03425266903914591;.\data\pcb_defects_kaggle\images/Mouse_bite/11_mouse_bite_02.jpg;2
897;mouse_bite;1139;1113;1240;1173;.\data\pcb_defects_kaggle\Annotations\Mouse_bite\11_mouse_bite_02;0.5212532865907099;0.5084519572953736;101;60;2282;2248;0.04425942156003506;0.026690391459074734;.\data\pcb_defects_kaggle\images/Mouse_bite/11_mouse_bite_02.jpg;2
898;mouse_bite;1734;1686;1814;1742;.\data\pcb_defects_kaggle\Annotations\Mouse_bite\11_mouse_bite_02;0.7773882559158632;0.7624555160142349;80;56;2282;2248;0.035056967572304996;0.02491103202846975;.\data\pcb_defects_kaggle\images/Mouse_bite/11_mouse_bite_02.jpg;2
899;mouse_bite;1078;644;1145;722;.\data\pcb_defects_kaggle\Annotations\Mouse_bite\11_mouse_bite_03;0.48707274320771254;0.3038256227758007;67;78;2282;2248;0.029360210341805432;0.03469750889679715;.\data\pcb_defects_kaggle\images/Mouse_bite/11_mouse_bite_03.jpg;2
900;mouse_bite;304;524;391;627;.\data\pcb_defects_kaggle\Annotations\Mouse_bite\11_mouse_bite_03;0.15227870289219983;0.2560053380782918;87;103;2282;2248;0.03812445223488168;0.04581850533807829;.\data\pcb_defects_kaggle\images/Mouse_bite/11_mouse_bite_03.jpg;2
901;mouse_bite;1086;1468;1132;1544;.\data\pcb_defects_kaggle\Annotations\Mouse_bite\11_mouse_bite_03;0.485977212971078;0.6699288256227758;46;76;2282;2248;0.020157756354075372;0.033807829181494664;.\data\pcb_defects_kaggle\images/Mouse_bite/11_mouse_bite_03.jpg;2
902;mouse_bite;517;1458;576;1534;.\data\pcb_defects_kaggle\Annotations\Mouse_bite\11_mouse_bite_03;0.2394829097283085;0.6654804270462633;59;76;2282;2248;0.025854513584574933;0.033807829181494664;.\data\pcb_defects_kaggle\images/Mouse_bite/11_mouse_bite_03.jpg;2
903;mouse_bite;614;1147;680;1216;.\data\pcb_defects_kaggle\Annotations\Mouse_bite\11_mouse_bite_03;0.28352322524101664;0.5255782918149466;66;69;2282;2248;0.028921998247151623;0.03069395017793594;.\data\pcb_defects_kaggle\images/Mouse_bite/11_mouse_bite_03.jpg;2
904;mouse_bite;773;596;860;668;.\data\pcb_defects_kaggle\Annotations\Mouse_bite\11_mouse_bite_04;0.3578001752848379;0.28113879003558717;87;72;2282;2248;0.03812445223488168;0.03202846975088968;.\data\pcb_defects_kaggle\images/Mouse_bite/11_mouse_bite_04.jpg;2
905;mouse_bite;1029;1152;1112;1206;.\data\pcb_defects_kaggle\Annotations\Mouse_bite\11_mouse_bite_04;0.46910604732690625;0.5244661921708185;83;54;2282;2248;0.036371603856266435;0.02402135231316726;.\data\pcb_defects_kaggle\images/Mouse_bite/11_mouse_bite_04.jpg;2
906;mouse_bite;827;1386;902;1453;.\data\pcb_defects_kaggle\Annotations\Mouse_bite\11_mouse_bite_04;0.37883435582822084;0.631450177935943;75;67;2282;2248;0.03286590709903593;0.029804270462633453;.\data\pcb_defects_kaggle\images/Mouse_bite/11_mouse_bite_04.jpg;2
907;mouse_bite;698;1608;781;1676;.\data\pcb_defects_kaggle\Annotations\Mouse_bite\11_mouse_bite_04;0.3240578439964943;0.7304270462633452;83;68;2282;2248;0.036371603856266435;0.030249110320284697;.\data\pcb_defects_kaggle\images/Mouse_bite/11_mouse_bite_04.jpg;2
908;mouse_bite;494;740;553;822;.\data\pcb_defects_kaggle\Annotations\Mouse_bite\11_mouse_bite_04;0.22940403155127082;0.3474199288256228;59;82;2282;2248;0.025854513584574933;0.036476868327402136;.\data\pcb_defects_kaggle\images/Mouse_bite/11_mouse_bite_04.jpg;2
909;mouse_bite;839;127;937;188;.\data\pcb_defects_kaggle\Annotations\Mouse_bite\11_mouse_bite_05;0.38913234005258546;0.07006227758007118;98;61;2282;2248;0.04294478527607362;0.027135231316725978;.\data\pcb_defects_kaggle\images/Mouse_bite/11_mouse_bite_05.jpg;2
910;mouse_bite;781;606;871;673;.\data\pcb_defects_kaggle\Annotations\Mouse_bite\11_mouse_bite_05;0.3619631901840491;0.2844750889679715;90;67;2282;2248;0.03943908851884312;0.029804270462633453;.\data\pcb_defects_kaggle\images/Mouse_bite/11_mouse_bite_05.jpg;2
911;mouse_bite;1160;1111;1258;1160;.\data\pcb_defects_kaggle\Annotations\Mouse_bite\11_mouse_bite_05;0.5297984224364592;0.5051156583629893;98;49;2282;2248;0.04294478527607362;0.02179715302491103;.\data\pcb_defects_kaggle\images/Mouse_bite/11_mouse_bite_05.jpg;2
912;mouse_bite;535;1127;622;1196;.\data\pcb_defects_kaggle\Annotations\Mouse_bite\11_mouse_bite_05;0.2535056967572305;0.5166814946619217;87;69;2282;2248;0.03812445223488168;0.03069395017793594;.\data\pcb_defects_kaggle\images/Mouse_bite/11_mouse_bite_05.jpg;2
913;mouse_bite;743;1570;840;1640;.\data\pcb_defects_kaggle\Annotations\Mouse_bite\11_mouse_bite_05;0.34684487291849253;0.7139679715302492;97;70;2282;2248;0.04250657318141981;0.03113879003558719;.\data\pcb_defects_kaggle\images/Mouse_bite/11_mouse_bite_05.jpg;2
914;mouse_bite;1073;660;1140;745;.\data\pcb_defects_kaggle\Annotations\Mouse_bite\11_mouse_bite_06;0.4848816827344435;0.3125;67;85;2282;2248;0.029360210341805432;0.037811387900355875;.\data\pcb_defects_kaggle\images/Mouse_bite/11_mouse_bite_06.jpg;2
915;mouse_bite;584;842;661;903;.\data\pcb_defects_kaggle\Annotations\Mouse_bite\11_mouse_bite_06;0.27278702892199824;0.38812277580071175;77;61;2282;2248;0.03374233128834356;0.027135231316725978;.\data\pcb_defects_kaggle\images/Mouse_bite/11_mouse_bite_06.jpg;2
916;mouse_bite;309;1401;381;1486;.\data\pcb_defects_kaggle\Annotations\Mouse_bite\11_mouse_bite_06;0.1511831726555653;0.6421263345195729;72;85;2282;2248;0.03155127081507449;0.037811387900355875;.\data\pcb_defects_kaggle\images/Mouse_bite/11_mouse_bite_06.jpg;2
917;mouse_bite;1357;1394;1452;1462;.\data\pcb_defects_kaggle\Annotations\Mouse_bite\11_mouse_bite_06;0.6154688869412795;0.6352313167259787;95;68;2282;2248;0.04163014899211218;0.030249110320284697;.\data\pcb_defects_kaggle\images/Mouse_bite/11_mouse_bite_06.jpg;2
918;mouse_bite;1884;1786;1940;1886;.\data\pcb_defects_kaggle\Annotations\Mouse_bite\11_mouse_bite_06;0.8378615249780894;0.8167259786476868;56;100;2282;2248;0.024539877300613498;0.04448398576512456;.\data\pcb_defects_kaggle\images/Mouse_bite/11_mouse_bite_06.jpg;2
919;mouse_bite;1012;531;1093;596;.\data\pcb_defects_kaggle\Annotations\Mouse_bite\11_mouse_bite_07;0.4612182296231376;0.25066725978647686;81;65;2282;2248;0.03549517966695881;0.02891459074733096;.\data\pcb_defects_kaggle\images/Mouse_bite/11_mouse_bite_07.jpg;2
920;mouse_bite;1278;326;1381;413;.\data\pcb_defects_kaggle\Annotations\Mouse_bite\11_mouse_bite_07;0.5826029798422436;0.16436832740213522;103;87;2282;2248;0.04513584574934268;0.03870106761565836;.\data\pcb_defects_kaggle\images/Mouse_bite/11_mouse_bite_07.jpg;2
921;mouse_bite;504;203;594;294;.\data\pcb_defects_kaggle\Annotations\Mouse_bite\11_mouse_bite_07;0.24057843996494302;0.11054270462633452;90;91;2282;2248;0.03943908851884312;0.04048042704626335;.\data\pcb_defects_kaggle\images/Mouse_bite/11_mouse_bite_07.jpg;2
922;mouse_bite;814;1062;901;1119;.\data\pcb_defects_kaggle\Annotations\Mouse_bite\11_mouse_bite_07;0.37576687116564417;0.4850978647686833;87;57;2282;2248;0.03812445223488168;0.025355871886120998;.\data\pcb_defects_kaggle\images/Mouse_bite/11_mouse_bite_07.jpg;2
923;mouse_bite;620;1372;680;1421;.\data\pcb_defects_kaggle\Annotations\Mouse_bite\11_mouse_bite_07;0.2848378615249781;0.6212188612099644;60;49;2282;2248;0.026292725679228746;0.02179715302491103;.\data\pcb_defects_kaggle\images/Mouse_bite/11_mouse_bite_07.jpg;2
924;mouse_bite;1511;1073;1565;1165;.\data\pcb_defects_kaggle\Annotations\Mouse_bite\11_mouse_bite_08;0.6739702015775635;0.49777580071174377;54;92;2282;2248;0.02366345311130587;0.04092526690391459;.\data\pcb_defects_kaggle\images/Mouse_bite/11_mouse_bite_08.jpg;2
925;mouse_bite;676;1068;755;1124;.\data\pcb_defects_kaggle\Annotations\Mouse_bite\11_mouse_bite_08;0.3135407537248028;0.4875444839857651;79;56;2282;2248;0.034618755477651184;0.02491103202846975;.\data\pcb_defects_kaggle\images/Mouse_bite/11_mouse_bite_08.jpg;2
926;mouse_bite;925;1203;994;1255;.\data\pcb_defects_kaggle\Annotations\Mouse_bite\11_mouse_bite_08;0.42046450482033304;0.5467081850533808;69;52;2282;2248;0.030236634531113058;0.023131672597864767;.\data\pcb_defects_kaggle\images/Mouse_bite/11_mouse_bite_08.jpg;2
927;mouse_bite;1432;1591;1489;1665;.\data\pcb_defects_kaggle\Annotations\Mouse_bite\11_mouse_bite_08;0.6400087642418931;0.7241992882562278;57;74;2282;2248;0.02497808939526731;0.03291814946619217;.\data\pcb_defects_kaggle\images/Mouse_bite/11_mouse_bite_08.jpg;2
928;mouse_bite;1039;524;1117;598;.\data\pcb_defects_kaggle\Annotations\Mouse_bite\11_mouse_bite_08;0.4723926380368098;0.24955516014234874;78;74;2282;2248;0.03418054338299737;0.03291814946619217;.\data\pcb_defects_kaggle\images/Mouse_bite/11_mouse_bite_08.jpg;2
929;mouse_bite;1073;657;1147;731;.\data\pcb_defects_kaggle\Annotations\Mouse_bite\11_mouse_bite_09;0.4864154250657318;0.3087188612099644;74;74;2282;2248;0.03242769500438212;0.03291814946619217;.\data\pcb_defects_kaggle\images/Mouse_bite/11_mouse_bite_09.jpg;2
930;mouse_bite;1255;1155;1330;1209;.\data\pcb_defects_kaggle\Annotations\Mouse_bite\11_mouse_bite_09;0.5663891323400526;0.5258007117437722;75;54;2282;2248;0.03286590709903593;0.02402135231316726;.\data\pcb_defects_kaggle\images/Mouse_bite/11_mouse_bite_09.jpg;2
931;mouse_bite;1101;1950;1199;2017;.\data\pcb_defects_kaggle\Annotations\Mouse_bite\11_mouse_bite_09;0.5039439088518843;0.8823398576512456;98;67;2282;2248;0.04294478527607362;0.029804270462633453;.\data\pcb_defects_kaggle\images/Mouse_bite/11_mouse_bite_09.jpg;2
932;mouse_bite;511;1399;573;1488;.\data\pcb_defects_kaggle\Annotations\Mouse_bite\11_mouse_bite_09;0.23751095530236635;0.6421263345195729;62;89;2282;2248;0.02716914986853637;0.03959074733096085;.\data\pcb_defects_kaggle\images/Mouse_bite/11_mouse_bite_09.jpg;2
933;mouse_bite;658;1650;739;1729;.\data\pcb_defects_kaggle\Annotations\Mouse_bite\11_mouse_bite_09;0.306091148115688;0.7515569395017794;81;79;2282;2248;0.03549517966695881;0.035142348754448396;.\data\pcb_defects_kaggle\images/Mouse_bite/11_mouse_bite_09.jpg;2
934;mouse_bite;734;855;822;917;.\data\pcb_defects_kaggle\Annotations\Mouse_bite\11_mouse_bite_10;0.3409290096406661;0.39412811387900354;88;62;2282;2248;0.03856266432953549;0.027580071174377226;.\data\pcb_defects_kaggle\images/Mouse_bite/11_mouse_bite_10.jpg;2
935;mouse_bite;1006;1070;1104;1127;.\data\pcb_defects_kaggle\Annotations\Mouse_bite\11_mouse_bite_10;0.46231375985977213;0.4886565836298932;98;57;2282;2248;0.04294478527607362;0.025355871886120998;.\data\pcb_defects_kaggle\images/Mouse_bite/11_mouse_bite_10.jpg;2
936;mouse_bite;734;1116;817;1170;.\data\pcb_defects_kaggle\Annotations\Mouse_bite\11_mouse_bite_10;0.3398334794040315;0.5084519572953736;83;54;2282;2248;0.036371603856266435;0.02402135231316726;.\data\pcb_defects_kaggle\images/Mouse_bite/11_mouse_bite_10.jpg;2
937;mouse_bite;1071;1491;1137;1567;.\data\pcb_defects_kaggle\Annotations\Mouse_bite\11_mouse_bite_10;0.48378615249780893;0.6801601423487544;66;76;2282;2248;0.028921998247151623;0.033807829181494664;.\data\pcb_defects_kaggle\images/Mouse_bite/11_mouse_bite_10.jpg;2
938;mouse_bite;1425;1867;1491;1947;.\data\pcb_defects_kaggle\Annotations\Mouse_bite\11_mouse_bite_10;0.6389132340052586;0.8483096085409253;66;80;2282;2248;0.028921998247151623;0.03558718861209965;.\data\pcb_defects_kaggle\images/Mouse_bite/11_mouse_bite_10.jpg;2
939;mouse_bite;1757;463;1809;537;.\data\pcb_defects_kaggle\Annotations\Mouse_bite\12_mouse_bite_01;0.705021747726374;0.1976284584980237;52;74;2529;2530;0.02056148675365757;0.02924901185770751;.\data\pcb_defects_kaggle\images/Mouse_bite/12_mouse_bite_01.jpg;2
940;mouse_bite;911;734;987;784;.\data\pcb_defects_kaggle\Annotations\Mouse_bite\12_mouse_bite_01;0.3752471332542507;0.3;76;50;2529;2530;0.030051403716884143;0.019762845849802372;.\data\pcb_defects_kaggle\images/Mouse_bite/12_mouse_bite_01.jpg;2
941;mouse_bite;627;1204;680;1279;.\data\pcb_defects_kaggle\Annotations\Mouse_bite\12_mouse_bite_01;0.2584025306445235;0.4907114624505929;53;75;2529;2530;0.02095689996045868;0.029644268774703556;.\data\pcb_defects_kaggle\images/Mouse_bite/12_mouse_bite_01.jpg;2
942;mouse_bite;1761;1446;1806;1513;.\data\pcb_defects_kaggle\Annotations\Mouse_bite\12_mouse_bite_01;0.7052194543297746;0.5847826086956521;45;67;2529;2530;0.017793594306049824;0.026482213438735178;.\data\pcb_defects_kaggle\images/Mouse_bite/12_mouse_bite_01.jpg;2
943;mouse_bite;1268;1785;1322;1828;.\data\pcb_defects_kaggle\Annotations\Mouse_bite\12_mouse_bite_01;0.5120601028074337;0.7140316205533597;54;43;2529;2530;0.021352313167259787;0.01699604743083004;.\data\pcb_defects_kaggle\images/Mouse_bite/12_mouse_bite_01.jpg;2
944;mouse_bite;1317;503;1369;572;.\data\pcb_defects_kaggle\Annotations\Mouse_bite\12_mouse_bite_02;0.5310399367338869;0.2124505928853755;52;69;2529;2530;0.02056148675365757;0.02727272727272727;.\data\pcb_defects_kaggle\images/Mouse_bite/12_mouse_bite_02.jpg;2
945;mouse_bite;2217;401;2273;475;.\data\pcb_defects_kaggle\Annotations\Mouse_bite\12_mouse_bite_02;0.8877026492684855;0.17312252964426877;56;74;2529;2530;0.022143139580862;0.02924901185770751;.\data\pcb_defects_kaggle\images/Mouse_bite/12_mouse_bite_02.jpg;2
946;mouse_bite;1660;1414;1704;1474;.\data\pcb_defects_kaggle\Annotations\Mouse_bite\12_mouse_bite_02;0.6650850138394623;0.5707509881422925;44;60;2529;2530;0.017398181099248716;0.023715415019762844;.\data\pcb_defects_kaggle\images/Mouse_bite/12_mouse_bite_02.jpg;2
947;mouse_bite;324;1163;367;1234;.\data\pcb_defects_kaggle\Annotations\Mouse_bite\12_mouse_bite_02;0.13661526294978252;0.47371541501976283;43;71;2529;2530;0.017002767892447607;0.02806324110671937;.\data\pcb_defects_kaggle\images/Mouse_bite/12_mouse_bite_02.jpg;2
948;mouse_bite;1027;1075;1095;1128;.\data\pcb_defects_kaggle\Annotations\Mouse_bite\12_mouse_bite_02;0.4195334124159747;0.43537549407114623;68;53;2529;2530;0.026888098062475288;0.020948616600790514;.\data\pcb_defects_kaggle\images/Mouse_bite/12_mouse_bite_02.jpg;2
949;mouse_bite;1409;337;1462;406;.\data\pcb_defects_kaggle\Annotations\Mouse_bite\12_mouse_bite_03;0.5676156583629893;0.14683794466403163;53;69;2529;2530;0.02095689996045868;0.02727272727272727;.\data\pcb_defects_kaggle\images/Mouse_bite/12_mouse_bite_03.jpg;2
950;mouse_bite;1655;681;1711;757;.\data\pcb_defects_kaggle\Annotations\Mouse_bite\12_mouse_bite_03;0.6654804270462633;0.2841897233201581;56;76;2529;2530;0.022143139580862;0.030039525691699605;.\data\pcb_defects_kaggle\images/Mouse_bite/12_mouse_bite_03.jpg;2
951;mouse_bite;2271;532;2326;617;.\data\pcb_defects_kaggle\Annotations\Mouse_bite\12_mouse_bite_03;0.9088572558323448;0.22707509881422924;55;85;2529;2530;0.021747726374060895;0.03359683794466403;.\data\pcb_defects_kaggle\images/Mouse_bite/12_mouse_bite_03.jpg;2
952;mouse_bite;911;1194;1007;1250;.\data\pcb_defects_kaggle\Annotations\Mouse_bite\12_mouse_bite_03;0.3792012653222618;0.48300395256916995;96;56;2529;2530;0.03795966785290629;0.022134387351778657;.\data\pcb_defects_kaggle\images/Mouse_bite/12_mouse_bite_03.jpg;2
953;mouse_bite;1784;1239;1860;1288;.\data\pcb_defects_kaggle\Annotations\Mouse_bite\12_mouse_bite_03;0.7204428627916173;0.49940711462450593;76;49;2529;2530;0.030051403716884143;0.019367588932806323;.\data\pcb_defects_kaggle\images/Mouse_bite/12_mouse_bite_03.jpg;2
954;mouse_bite;627;677;706;730;.\data\pcb_defects_kaggle\Annotations\Mouse_bite\12_mouse_bite_04;0.2635429023329379;0.27806324110671937;79;53;2529;2530;0.031237643337287464;0.020948616600790514;.\data\pcb_defects_kaggle\images/Mouse_bite/12_mouse_bite_04.jpg;2
955;mouse_bite;626;1217;680;1294;.\data\pcb_defects_kaggle\Annotations\Mouse_bite\12_mouse_bite_04;0.258204824041123;0.49624505928853757;54;77;2529;2530;0.021352313167259787;0.030434782608695653;.\data\pcb_defects_kaggle\images/Mouse_bite/12_mouse_bite_04.jpg;2
956;mouse_bite;1753;1444;1800;1517;.\data\pcb_defects_kaggle\Annotations\Mouse_bite\12_mouse_bite_04;0.7024515618821668;0.5851778656126482;47;73;2529;2530;0.018584420719652037;0.028853754940711462;.\data\pcb_defects_kaggle\images/Mouse_bite/12_mouse_bite_04.jpg;2
957;mouse_bite;1547;1786;1631;1839;.\data\pcb_defects_kaggle\Annotations\Mouse_bite\12_mouse_bite_04;0.6283115856069593;0.7164031620553359;84;53;2529;2530;0.033214709371293;0.020948616600790514;.\data\pcb_defects_kaggle\images/Mouse_bite/12_mouse_bite_04.jpg;2
958;mouse_bite;107;1741;162;1823;.\data\pcb_defects_kaggle\Annotations\Mouse_bite\12_mouse_bite_04;0.05318307631474891;0.7043478260869566;55;82;2529;2530;0.021747726374060895;0.03241106719367589;.\data\pcb_defects_kaggle\images/Mouse_bite/12_mouse_bite_04.jpg;2
959;mouse_bite;1342;1077;1418;1126;.\data\pcb_defects_kaggle\Annotations\Mouse_bite\12_mouse_bite_05;0.5456702253855279;0.43537549407114623;76;49;2529;2530;0.030051403716884143;0.019367588932806323;.\data\pcb_defects_kaggle\images/Mouse_bite/12_mouse_bite_05.jpg;2
960;mouse_bite;793;1535;882;1588;.\data\pcb_defects_kaggle\Annotations\Mouse_bite\12_mouse_bite_05;0.33115856069592725;0.617193675889328;89;53;2529;2530;0.03519177540529854;0.020948616600790514;.\data\pcb_defects_kaggle\images/Mouse_bite/12_mouse_bite_05.jpg;2
961;mouse_bite;1813;1459;1858;1537;.\data\pcb_defects_kaggle\Annotations\Mouse_bite\12_mouse_bite_05;0.7257809410834322;0.5920948616600791;45;78;2529;2530;0.017793594306049824;0.0308300395256917;.\data\pcb_defects_kaggle\images/Mouse_bite/12_mouse_bite_05.jpg;2
962;mouse_bite;749;1783;813;1830;.\data\pcb_defects_kaggle\Annotations\Mouse_bite\12_mouse_bite_05;0.3088177145116647;0.7140316205533597;64;47;2529;2530;0.02530644523527086;0.01857707509881423;.\data\pcb_defects_kaggle\images/Mouse_bite/12_mouse_bite_05.jpg;2
963;mouse_bite;2371;1670;2417;1741;.\data\pcb_defects_kaggle\Annotations\Mouse_bite\12_mouse_bite_05;0.9466192170818505;0.6741106719367589;46;71;2529;2530;0.01818900751285093;0.02806324110671937;.\data\pcb_defects_kaggle\images/Mouse_bite/12_mouse_bite_05.jpg;2
964;mouse_bite;1546;903;1598;977;.\data\pcb_defects_kaggle\Annotations\Mouse_bite\12_mouse_bite_06;0.6215895610913404;0.3715415019762846;52;74;2529;2530;0.02056148675365757;0.02924901185770751;.\data\pcb_defects_kaggle\images/Mouse_bite/12_mouse_bite_06.jpg;2
965;mouse_bite;1958;546;2011;623;.\data\pcb_defects_kaggle\Annotations\Mouse_bite\12_mouse_bite_06;0.7846975088967971;0.23102766798418972;53;77;2529;2530;0.02095689996045868;0.030434782608695653;.\data\pcb_defects_kaggle\images/Mouse_bite/12_mouse_bite_06.jpg;2
966;mouse_bite;1804;1454;1855;1530;.\data\pcb_defects_kaggle\Annotations\Mouse_bite\12_mouse_bite_06;0.7234084618426255;0.5897233201581028;51;76;2529;2530;0.020166073546856466;0.030039525691699605;.\data\pcb_defects_kaggle\images/Mouse_bite/12_mouse_bite_06.jpg;2
967;mouse_bite;735;1132;815;1181;.\data\pcb_defects_kaggle\Annotations\Mouse_bite\12_mouse_bite_06;0.30644523527085804;0.4571146245059289;80;49;2529;2530;0.03163305654408857;0.019367588932806323;.\data\pcb_defects_kaggle\images/Mouse_bite/12_mouse_bite_06.jpg;2
968;mouse_bite;624;1470;697;1523;.\data\pcb_defects_kaggle\Annotations\Mouse_bite\12_mouse_bite_06;0.2611704230921313;0.591501976284585;73;53;2529;2530;0.028865164096480822;0.020948616600790514;.\data\pcb_defects_kaggle\images/Mouse_bite/12_mouse_bite_06.jpg;2
969;mouse_bite;1751;710;1807;804;.\data\pcb_defects_kaggle\Annotations\Mouse_bite\12_mouse_bite_07;0.7034400948991696;0.2992094861660079;56;94;2529;2530;0.022143139580862;0.03715415019762846;.\data\pcb_defects_kaggle\images/Mouse_bite/12_mouse_bite_07.jpg;2
970;mouse_bite;2186;1046;2273;1094;.\data\pcb_defects_kaggle\Annotations\Mouse_bite\12_mouse_bite_07;0.8815737445630684;0.42292490118577075;87;48;2529;2530;0.03440094899169632;0.018972332015810278;.\data\pcb_defects_kaggle\images/Mouse_bite/12_mouse_bite_07.jpg;2
971;mouse_bite;482;1099;557;1152;.\data\pcb_defects_kaggle\Annotations\Mouse_bite\12_mouse_bite_07;0.20541716093317516;0.44486166007905137;75;53;2529;2530;0.02965599051008304;0.020948616600790514;.\data\pcb_defects_kaggle\images/Mouse_bite/12_mouse_bite_07.jpg;2
972;mouse_bite;1549;1663;1626;1710;.\data\pcb_defects_kaggle\Annotations\Mouse_bite\12_mouse_bite_07;0.6277184657967576;0.666600790513834;77;47;2529;2530;0.03044681692368525;0.01857707509881423;.\data\pcb_defects_kaggle\images/Mouse_bite/12_mouse_bite_07.jpg;2
973;mouse_bite;1658;1423;1702;1494;.\data\pcb_defects_kaggle\Annotations\Mouse_bite\12_mouse_bite_07;0.66429418742586;0.5764822134387352;44;71;2529;2530;0.017398181099248716;0.02806324110671937;.\data\pcb_defects_kaggle\images/Mouse_bite/12_mouse_bite_07.jpg;2
974;mouse_bite;1313;203;1358;277;.\data\pcb_defects_kaggle\Annotations\Mouse_bite\12_mouse_bite_08;0.5280743376828786;0.09486166007905138;45;74;2529;2530;0.017793594306049824;0.02924901185770751;.\data\pcb_defects_kaggle\images/Mouse_bite/12_mouse_bite_08.jpg;2
975;mouse_bite;2227;352;2273;428;.\data\pcb_defects_kaggle\Annotations\Mouse_bite\12_mouse_bite_08;0.8896797153024911;0.1541501976284585;46;76;2529;2530;0.01818900751285093;0.030039525691699605;.\data\pcb_defects_kaggle\images/Mouse_bite/12_mouse_bite_08.jpg;2
976;mouse_bite;966;732;1040;775;.\data\pcb_defects_kaggle\Annotations\Mouse_bite\12_mouse_bite_08;0.39659944642151046;0.29782608695652174;74;43;2529;2530;0.02926057730328193;0.01699604743083004;.\data\pcb_defects_kaggle\images/Mouse_bite/12_mouse_bite_08.jpg;2
977;mouse_bite;1302;1121;1375;1170;.\data\pcb_defects_kaggle\Annotations\Mouse_bite\12_mouse_bite_08;0.5292605773032819;0.4527667984189723;73;49;2529;2530;0.028865164096480822;0.019367588932806323;.\data\pcb_defects_kaggle\images/Mouse_bite/12_mouse_bite_08.jpg;2
978;mouse_bite;2335;1648;2387;1730;.\data\pcb_defects_kaggle\Annotations\Mouse_bite\12_mouse_bite_08;0.933570581257414;0.6675889328063241;52;82;2529;2530;0.02056148675365757;0.03241106719367589;.\data\pcb_defects_kaggle\images/Mouse_bite/12_mouse_bite_08.jpg;2
979;mouse_bite;1760;481;1802;555;.\data\pcb_defects_kaggle\Annotations\Mouse_bite\12_mouse_bite_09;0.7042309213127719;0.20474308300395258;42;74;2529;2530;0.0166073546856465;0.02924901185770751;.\data\pcb_defects_kaggle\images/Mouse_bite/12_mouse_bite_09.jpg;2
980;mouse_bite;1397;1075;1469;1126;.\data\pcb_defects_kaggle\Annotations\Mouse_bite\12_mouse_bite_09;0.5666271253459866;0.4349802371541502;72;51;2529;2530;0.028469750889679714;0.02015810276679842;.\data\pcb_defects_kaggle\images/Mouse_bite/12_mouse_bite_09.jpg;2
981;mouse_bite;2095;1186;2164;1235;.\data\pcb_defects_kaggle\Annotations\Mouse_bite\12_mouse_bite_09;0.8420324238829577;0.47845849802371543;69;49;2529;2530;0.027283511269276393;0.019367588932806323;.\data\pcb_defects_kaggle\images/Mouse_bite/12_mouse_bite_09.jpg;2
982;mouse_bite;751;1534;829;1584;.\data\pcb_defects_kaggle\Annotations\Mouse_bite\12_mouse_bite_09;0.31237643337287463;0.6162055335968379;78;50;2529;2530;0.03084223013048636;0.019762845849802372;.\data\pcb_defects_kaggle\images/Mouse_bite/12_mouse_bite_09.jpg;2
983;mouse_bite;111;1814;157;1892;.\data\pcb_defects_kaggle\Annotations\Mouse_bite\12_mouse_bite_09;0.05298536971134836;0.7324110671936759;46;78;2529;2530;0.01818900751285093;0.0308300395256917;.\data\pcb_defects_kaggle\images/Mouse_bite/12_mouse_bite_09.jpg;2
984;mouse_bite;1504;339;1551;395;.\data\pcb_defects_kaggle\Annotations\Mouse_bite\12_mouse_bite_10;0.6039936733886911;0.1450592885375494;47;56;2529;2530;0.018584420719652037;0.022134387351778657;.\data\pcb_defects_kaggle\images/Mouse_bite/12_mouse_bite_10.jpg;2
985;mouse_bite;1557;926;1607;981;.\data\pcb_defects_kaggle\Annotations\Mouse_bite\12_mouse_bite_10;0.6255436931593515;0.3768774703557312;50;55;2529;2530;0.019770660340055358;0.021739130434782608;.\data\pcb_defects_kaggle\images/Mouse_bite/12_mouse_bite_10.jpg;2
986;mouse_bite;758;1126;835;1181;.\data\pcb_defects_kaggle\Annotations\Mouse_bite\12_mouse_bite_10;0.31494661921708184;0.4559288537549407;77;55;2529;2530;0.03044681692368525;0.021739130434782608;.\data\pcb_defects_kaggle\images/Mouse_bite/12_mouse_bite_10.jpg;2
987;mouse_bite;527;1339;604;1390;.\data\pcb_defects_kaggle\Annotations\Mouse_bite\12_mouse_bite_10;0.2236061684460261;0.5393280632411067;77;51;2529;2530;0.03044681692368525;0.02015810276679842;.\data\pcb_defects_kaggle\images/Mouse_bite/12_mouse_bite_10.jpg;2
988;mouse_bite;2300;1695;2340;1772;.\data\pcb_defects_kaggle\Annotations\Mouse_bite\12_mouse_bite_10;0.9173586397785686;0.6851778656126483;40;77;2529;2530;0.015816528272044286;0.030434782608695653;.\data\pcb_defects_kaggle\images/Mouse_bite/12_mouse_bite_10.jpg;2
989;open_circuit;1539;1149;1584;1205;.\data\pcb_defects_kaggle\Annotations\Open_circuit\01_open_circuit_01;0.5146671061305208;0.7421185372005045;45;56;3034;1586;0.014831905075807514;0.03530895334174023;.\data\pcb_defects_kaggle\images/Open_circuit/01_open_circuit_01.jpg;3
990;open_circuit;1071;1342;1113;1380;.\data\pcb_defects_kaggle\Annotations\Open_circuit\01_open_circuit_01;0.35992089650626236;0.8581336696090794;42;38;3034;1586;0.013843111404087014;0.02395964691046658;.\data\pcb_defects_kaggle\images/Open_circuit/01_open_circuit_01.jpg;3
991;open_circuit;1684;467;1727;503;.\data\pcb_defects_kaggle\Annotations\Open_circuit\01_open_circuit_01;0.5621292023731048;0.30580075662042877;43;36;3034;1586;0.014172709294660513;0.02269861286254729;.\data\pcb_defects_kaggle\images/Open_circuit/01_open_circuit_01.jpg;3
992;open_circuit;1502;1349;1539;1378;.\data\pcb_defects_kaggle\Annotations\Open_circuit\01_open_circuit_02;0.5011535926170072;0.8597099621689785;37;29;3034;1586;0.012195121951219513;0.01828499369482976;.\data\pcb_defects_kaggle\images/Open_circuit/01_open_circuit_02.jpg;3
993;open_circuit;1653;1196;1684;1229;.\data\pcb_defects_kaggle\Annotations\Open_circuit\01_open_circuit_02;0.5499340804218853;0.7645018915510718;31;33;3034;1586;0.01021753460777851;0.02080706179066835;.\data\pcb_defects_kaggle\images/Open_circuit/01_open_circuit_02.jpg;3
994;open_circuit;775;1127;808;1165;.\data\pcb_defects_kaggle\Annotations\Open_circuit\01_open_circuit_02;0.2608767303889255;0.7225725094577553;33;38;3034;1586;0.010876730388925511;0.02395964691046658;.\data\pcb_defects_kaggle\images/Open_circuit/01_open_circuit_02.jpg;3
995;open_circuit;1419;1132;1460;1172;.\data\pcb_defects_kaggle\Annotations\Open_circuit\01_open_circuit_03;0.47445616348055375;0.7263556116015133;41;40;3034;1586;0.013513513513513514;0.025220680958385876;.\data\pcb_defects_kaggle\images/Open_circuit/01_open_circuit_03.jpg;3
996;open_circuit;599;909;633;942;.\data\pcb_defects_kaggle\Annotations\Open_circuit\01_open_circuit_03;0.2030323005932762;0.5835435056746532;34;33;3034;1586;0.01120632827949901;0.02080706179066835;.\data\pcb_defects_kaggle\images/Open_circuit/01_open_circuit_03.jpg;3
997;open_circuit;1688;350;1723;390;.\data\pcb_defects_kaggle\Annotations\Open_circuit\01_open_circuit_03;0.5621292023731048;0.23329129886506936;35;40;3034;1586;0.011535926170072512;0.025220680958385876;.\data\pcb_defects_kaggle\images/Open_circuit/01_open_circuit_03.jpg;3
998;open_circuit;2177;1090;2218;1134;.\data\pcb_defects_kaggle\Annotations\Open_circuit\01_open_circuit_04;0.724291364535267;0.7011349306431274;41;44;3034;1586;0.013513513513513514;0.027742749054224466;.\data\pcb_defects_kaggle\images/Open_circuit/01_open_circuit_04.jpg;3
999;open_circuit;2155;296;2192;331;.\data\pcb_defects_kaggle\Annotations\Open_circuit\01_open_circuit_04;0.716381015161503;0.1976670870113493;37;35;3034;1586;0.012195121951219513;0.022068095838587643;.\data\pcb_defects_kaggle\images/Open_circuit/01_open_circuit_04.jpg;3
1000;open_circuit;728;1278;762;1315;.\data\pcb_defects_kaggle\Annotations\Open_circuit\01_open_circuit_04;0.24555042847725775;0.8174653215636822;34;37;3034;1586;0.01120632827949901;0.023329129886506934;.\data\pcb_defects_kaggle\images/Open_circuit/01_open_circuit_04.jpg;3
1001;open_circuit;2204;604;2236;641;.\data\pcb_defects_kaggle\Annotations\Open_circuit\01_open_circuit_05;0.7317073170731707;0.3924968474148802;32;37;3034;1586;0.01054713249835201;0.023329129886506934;.\data\pcb_defects_kaggle\images/Open_circuit/01_open_circuit_05.jpg;3
1002;open_circuit;1015;1312;1050;1349;.\data\pcb_defects_kaggle\Annotations\Open_circuit\01_open_circuit_05;0.3403098220171391;0.8389029003783102;35;37;3034;1586;0.011535926170072512;0.023329129886506934;.\data\pcb_defects_kaggle\images/Open_circuit/01_open_circuit_05.jpg;3
1003;open_circuit;2713;946;2746;979;.\data\pcb_defects_kaggle\Annotations\Open_circuit\01_open_circuit_05;0.8996374423203691;0.6068726355611601;33;33;3034;1586;0.010876730388925511;0.02080706179066835;.\data\pcb_defects_kaggle\images/Open_circuit/01_open_circuit_05.jpg;3
1004;open_circuit;1513;927;1545;961;.\data\pcb_defects_kaggle\Annotations\Open_circuit\01_open_circuit_06;0.503955174686882;0.5952080706179067;32;34;3034;1586;0.01054713249835201;0.021437578814627996;.\data\pcb_defects_kaggle\images/Open_circuit/01_open_circuit_06.jpg;3
1005;open_circuit;714;1113;740;1141;.\data\pcb_defects_kaggle\Annotations\Open_circuit\01_open_circuit_06;0.23961766644693475;0.7105926860025221;26;28;3034;1586;0.008569545154911009;0.017654476670870115;.\data\pcb_defects_kaggle\images/Open_circuit/01_open_circuit_06.jpg;3
1006;open_circuit;175;1166;207;1209;.\data\pcb_defects_kaggle\Annotations\Open_circuit\01_open_circuit_06;0.06295319709953856;0.7487389659520807;32;43;3034;1586;0.01054713249835201;0.02711223203026482;.\data\pcb_defects_kaggle\images/Open_circuit/01_open_circuit_06.jpg;3
1007;open_circuit;2192;296;2232;332;.\data\pcb_defects_kaggle\Annotations\Open_circuit\01_open_circuit_07;0.7290705339485827;0.19798234552332913;40;36;3034;1586;0.013183915622940013;0.02269861286254729;.\data\pcb_defects_kaggle\images/Open_circuit/01_open_circuit_07.jpg;3
1008;open_circuit;2710;942;2743;977;.\data\pcb_defects_kaggle\Annotations\Open_circuit\01_open_circuit_07;0.8986486486486487;0.6049810844892812;33;35;3034;1586;0.010876730388925511;0.022068095838587643;.\data\pcb_defects_kaggle\images/Open_circuit/01_open_circuit_07.jpg;3
1009;open_circuit;2555;544;2590;577;.\data\pcb_defects_kaggle\Annotations\Open_circuit\01_open_circuit_07;0.8478905735003296;0.35340479192938207;35;33;3034;1586;0.011535926170072512;0.02080706179066835;.\data\pcb_defects_kaggle\images/Open_circuit/01_open_circuit_07.jpg;3
1010;open_circuit;1982;989;2023;1031;.\data\pcb_defects_kaggle\Annotations\Open_circuit\01_open_circuit_08;0.6600197758734344;0.6368221941992434;41;42;3034;1586;0.013513513513513514;0.02648171500630517;.\data\pcb_defects_kaggle\images/Open_circuit/01_open_circuit_08.jpg;3
1011;open_circuit;1674;635;1719;676;.\data\pcb_defects_kaggle\Annotations\Open_circuit\01_open_circuit_08;0.5591628213579433;0.41330390920554855;45;41;3034;1586;0.014831905075807514;0.025851197982345524;.\data\pcb_defects_kaggle\images/Open_circuit/01_open_circuit_08.jpg;3
1012;open_circuit;714;742;747;773;.\data\pcb_defects_kaggle\Annotations\Open_circuit\01_open_circuit_08;0.24077125906394198;0.4776166456494325;33;31;3034;1586;0.010876730388925511;0.019546027742749054;.\data\pcb_defects_kaggle\images/Open_circuit/01_open_circuit_08.jpg;3
1013;open_circuit;483;963;515;1002;.\data\pcb_defects_kaggle\Annotations\Open_circuit\01_open_circuit_09;0.16446934739617666;0.6194829760403531;32;39;3034;1586;0.01054713249835201;0.02459016393442623;.\data\pcb_defects_kaggle\images/Open_circuit/01_open_circuit_09.jpg;3
1014;open_circuit;2480;286;2514;321;.\data\pcb_defects_kaggle\Annotations\Open_circuit\01_open_circuit_09;0.8230059327620303;0.19136191677175285;34;35;3034;1586;0.01120632827949901;0.022068095838587643;.\data\pcb_defects_kaggle\images/Open_circuit/01_open_circuit_09.jpg;3
1015;open_circuit;2695;1231;2723;1261;.\data\pcb_defects_kaggle\Annotations\Open_circuit\01_open_circuit_09;0.8928806855636124;0.78562421185372;28;30;3034;1586;0.00922874093605801;0.018915510718789406;.\data\pcb_defects_kaggle\images/Open_circuit/01_open_circuit_09.jpg;3
1016;open_circuit;1412;1141;1456;1182;.\data\pcb_defects_kaggle\Annotations\Open_circuit\01_open_circuit_10;0.47264337508239945;0.7323455233291298;44;41;3034;1586;0.014502307185234015;0.025851197982345524;.\data\pcb_defects_kaggle\images/Open_circuit/01_open_circuit_10.jpg;3
1017;open_circuit;1694;239;1721;273;.\data\pcb_defects_kaggle\Annotations\Open_circuit\01_open_circuit_10;0.5627883981542519;0.1614123581336696;27;34;3034;1586;0.008899143045484509;0.021437578814627996;.\data\pcb_defects_kaggle\images/Open_circuit/01_open_circuit_10.jpg;3
1018;open_circuit;1207;974;1232;999;.\data\pcb_defects_kaggle\Annotations\Open_circuit\01_open_circuit_10;0.40194462755438365;0.6220050441361917;25;25;3034;1586;0.008239947264337508;0.015762925598991173;.\data\pcb_defects_kaggle\images/Open_circuit/01_open_circuit_10.jpg;3
1019;open_circuit;2620;524;2651;552;.\data\pcb_defects_kaggle\Annotations\Open_circuit\01_open_circuit_11;0.8686552406064602;0.33921815889029006;31;28;3034;1586;0.01021753460777851;0.017654476670870115;.\data\pcb_defects_kaggle\images/Open_circuit/01_open_circuit_11.jpg;3
1020;open_circuit;1684;1376;1713;1409;.\data\pcb_defects_kaggle\Annotations\Open_circuit\01_open_circuit_11;0.5598220171390903;0.8779949558638083;29;33;3034;1586;0.00955833882663151;0.02080706179066835;.\data\pcb_defects_kaggle\images/Open_circuit/01_open_circuit_11.jpg;3
1021;open_circuit;2548;575;2596;610;.\data\pcb_defects_kaggle\Annotations\Open_circuit\01_open_circuit_11;0.8477257745550428;0.3735813366960908;48;35;3034;1586;0.015820698747528016;0.022068095838587643;.\data\pcb_defects_kaggle\images/Open_circuit/01_open_circuit_11.jpg;3
1022;open_circuit;2716;946;2743;975;.\data\pcb_defects_kaggle\Annotations\Open_circuit\01_open_circuit_12;0.8996374423203691;0.6056116015132409;27;29;3034;1586;0.008899143045484509;0.01828499369482976;.\data\pcb_defects_kaggle\images/Open_circuit/01_open_circuit_12.jpg;3
1023;open_circuit;2714;1178;2740;1204;.\data\pcb_defects_kaggle\Annotations\Open_circuit\01_open_circuit_12;0.8988134475939354;0.7509457755359394;26;26;3034;1586;0.008569545154911009;0.01639344262295082;.\data\pcb_defects_kaggle\images/Open_circuit/01_open_circuit_12.jpg;3
1024;open_circuit;1706;587;1732;613;.\data\pcb_defects_kaggle\Annotations\Open_circuit\01_open_circuit_12;0.5665787738958471;0.37831021437578816;26;26;3034;1586;0.008569545154911009;0.01639344262295082;.\data\pcb_defects_kaggle\images/Open_circuit/01_open_circuit_12.jpg;3
1025;open_circuit;580;1083;605;1110;.\data\pcb_defects_kaggle\Annotations\Open_circuit\01_open_circuit_13;0.19528675016479893;0.6913619167717528;25;27;3034;1586;0.008239947264337508;0.017023959646910468;.\data\pcb_defects_kaggle\images/Open_circuit/01_open_circuit_13.jpg;3
1026;open_circuit;443;904;473;935;.\data\pcb_defects_kaggle\Annotations\Open_circuit\01_open_circuit_13;0.15095583388266315;0.5797604035308953;30;31;3034;1586;0.00988793671720501;0.019546027742749054;.\data\pcb_defects_kaggle\images/Open_circuit/01_open_circuit_13.jpg;3
1027;open_circuit;1330;792;1361;822;.\data\pcb_defects_kaggle\Annotations\Open_circuit\01_open_circuit_13;0.4434739617666447;0.5088272383354351;31;30;3034;1586;0.01021753460777851;0.018915510718789406;.\data\pcb_defects_kaggle\images/Open_circuit/01_open_circuit_13.jpg;3
1028;open_circuit;1120;1314;1180;1351;.\data\pcb_defects_kaggle\Annotations\Open_circuit\01_open_circuit_14;0.3790375741595254;0.8401639344262295;60;37;3034;1586;0.01977587343441002;0.023329129886506934;.\data\pcb_defects_kaggle\images/Open_circuit/01_open_circuit_14.jpg;3
1029;open_circuit;2829;826;2853;863;.\data\pcb_defects_kaggle\Annotations\Open_circuit\01_open_circuit_14;0.9363876071193145;0.5324716267339218;24;37;3034;1586;0.007910349373764008;0.023329129886506934;.\data\pcb_defects_kaggle\images/Open_circuit/01_open_circuit_14.jpg;3
1030;open_circuit;2029;758;2061;785;.\data\pcb_defects_kaggle\Annotations\Open_circuit\01_open_circuit_14;0.6740276862228082;0.4864438839848676;32;27;3034;1586;0.01054713249835201;0.017023959646910468;.\data\pcb_defects_kaggle\images/Open_circuit/01_open_circuit_14.jpg;3
1031;open_circuit;729;1278;758;1313;.\data\pcb_defects_kaggle\Annotations\Open_circuit\01_open_circuit_15;0.2450560316413975;0.8168348045397226;29;35;3034;1586;0.00955833882663151;0.022068095838587643;.\data\pcb_defects_kaggle\images/Open_circuit/01_open_circuit_15.jpg;3
1032;open_circuit;474;1048;518;1082;.\data\pcb_defects_kaggle\Annotations\Open_circuit\01_open_circuit_15;0.16348055372445616;0.6715006305170239;44;34;3034;1586;0.014502307185234015;0.021437578814627996;.\data\pcb_defects_kaggle\images/Open_circuit/01_open_circuit_15.jpg;3
1033;open_circuit;177;1124;206;1155;.\data\pcb_defects_kaggle\Annotations\Open_circuit\01_open_circuit_15;0.06311799604482532;0.7184741488020177;29;31;3034;1586;0.00955833882663151;0.019546027742749054;.\data\pcb_defects_kaggle\images/Open_circuit/01_open_circuit_15.jpg;3
1034;open_circuit;1835;817;1864;843;.\data\pcb_defects_kaggle\Annotations\Open_circuit\01_open_circuit_16;0.6095912986156888;0.5233291298865069;29;26;3034;1586;0.00955833882663151;0.01639344262295082;.\data\pcb_defects_kaggle\images/Open_circuit/01_open_circuit_16.jpg;3
1035;open_circuit;1514;884;1544;917;.\data\pcb_defects_kaggle\Annotations\Open_circuit\01_open_circuit_16;0.503955174686882;0.567780580075662;30;33;3034;1586;0.00988793671720501;0.02080706179066835;.\data\pcb_defects_kaggle\images/Open_circuit/01_open_circuit_16.jpg;3
1036;open_circuit;2594;722;2626;750;.\data\pcb_defects_kaggle\Annotations\Open_circuit\01_open_circuit_17;0.8602504943968359;0.4640605296343001;32;28;3034;1586;0.01054713249835201;0.017654476670870115;.\data\pcb_defects_kaggle\images/Open_circuit/01_open_circuit_17.jpg;3
1037;open_circuit;2425;1114;2454;1149;.\data\pcb_defects_kaggle\Annotations\Open_circuit\01_open_circuit_17;0.8040540540540541;0.7134300126103404;29;35;3034;1586;0.00955833882663151;0.022068095838587643;.\data\pcb_defects_kaggle\images/Open_circuit/01_open_circuit_17.jpg;3
1038;open_circuit;2138;874;2165;901;.\data\pcb_defects_kaggle\Annotations\Open_circuit\01_open_circuit_17;0.7091298615688859;0.5595838587641866;27;27;3034;1586;0.008899143045484509;0.017023959646910468;.\data\pcb_defects_kaggle\images/Open_circuit/01_open_circuit_17.jpg;3
1039;open_circuit;627;1273;667;1310;.\data\pcb_defects_kaggle\Annotations\Open_circuit\01_open_circuit_18;0.21324983520105473;0.814312736443884;40;37;3034;1586;0.013183915622940013;0.023329129886506934;.\data\pcb_defects_kaggle\images/Open_circuit/01_open_circuit_18.jpg;3
1040;open_circuit;314;1397;350;1427;.\data\pcb_defects_kaggle\Annotations\Open_circuit\01_open_circuit_18;0.1094264996704021;0.8902900378310215;36;30;3034;1586;0.011865524060646011;0.018915510718789406;.\data\pcb_defects_kaggle\images/Open_circuit/01_open_circuit_18.jpg;3
1041;open_circuit;1250;1153;1302;1188;.\data\pcb_defects_kaggle\Annotations\Open_circuit\01_open_circuit_18;0.4205669083717864;0.7380201765447667;52;35;3034;1586;0.017139090309822018;0.022068095838587643;.\data\pcb_defects_kaggle\images/Open_circuit/01_open_circuit_18.jpg;3
1042;open_circuit;1684;354;1723;385;.\data\pcb_defects_kaggle\Annotations\Open_circuit\01_open_circuit_19;0.5614700065919578;0.23297604035308953;39;31;3034;1586;0.012854317732366513;0.019546027742749054;.\data\pcb_defects_kaggle\images/Open_circuit/01_open_circuit_19.jpg;3
1043;open_circuit;713;1000;738;1027;.\data\pcb_defects_kaggle\Annotations\Open_circuit\01_open_circuit_19;0.2391232696110745;0.6390290037831021;25;27;3034;1586;0.008239947264337508;0.017023959646910468;.\data\pcb_defects_kaggle\images/Open_circuit/01_open_circuit_19.jpg;3
1044;open_circuit;2432;1173;2462;1203;.\data\pcb_defects_kaggle\Annotations\Open_circuit\01_open_circuit_19;0.8065260382333553;0.7490542244640606;30;30;3034;1586;0.00988793671720501;0.018915510718789406;.\data\pcb_defects_kaggle\images/Open_circuit/01_open_circuit_19.jpg;3
1045;open_circuit;2142;1160;2179;1190;.\data\pcb_defects_kaggle\Annotations\Open_circuit\01_open_circuit_20;0.7120962425840475;0.7408575031525851;37;30;3034;1586;0.012195121951219513;0.018915510718789406;.\data\pcb_defects_kaggle\images/Open_circuit/01_open_circuit_20.jpg;3
1046;open_circuit;2495;1412;2536;1442;.\data\pcb_defects_kaggle\Annotations\Open_circuit\01_open_circuit_20;0.82910349373764;0.8997477931904161;41;30;3034;1586;0.013513513513513514;0.018915510718789406;.\data\pcb_defects_kaggle\images/Open_circuit/01_open_circuit_20.jpg;3
1047;open_circuit;1988;1237;2018;1278;.\data\pcb_defects_kaggle\Annotations\Open_circuit\01_open_circuit_20;0.6601845748187212;0.792875157629256;30;41;3034;1586;0.00988793671720501;0.025851197982345524;.\data\pcb_defects_kaggle\images/Open_circuit/01_open_circuit_20.jpg;3
1048;open_circuit;434;2177;491;2244;.\data\pcb_defects_kaggle\Annotations\Open_circuit\04_open_circuit_01;0.15134162303664922;0.8971185064935064;57;67;3056;2464;0.018651832460732983;0.02719155844155844;.\data\pcb_defects_kaggle\images/Open_circuit/04_open_circuit_01.jpg;3
1049;open_circuit;440;1374;498;1427;.\data\pcb_defects_kaggle\Annotations\Open_circuit\04_open_circuit_01;0.15346858638743455;0.5683847402597403;58;53;3056;2464;0.018979057591623036;0.02150974025974026;.\data\pcb_defects_kaggle\images/Open_circuit/04_open_circuit_01.jpg;3
1050;open_circuit;596;1213;677;1281;.\data\pcb_defects_kaggle\Annotations\Open_circuit\04_open_circuit_01;0.2082787958115183;0.5060876623376623;81;68;3056;2464;0.02650523560209424;0.027597402597402596;.\data\pcb_defects_kaggle\images/Open_circuit/04_open_circuit_01.jpg;3
1051;open_circuit;466;2235;546;2313;.\data\pcb_defects_kaggle\Annotations\Open_circuit\04_open_circuit_02;0.1655759162303665;0.9228896103896104;80;78;3056;2464;0.02617801047120419;0.03165584415584415;.\data\pcb_defects_kaggle\images/Open_circuit/04_open_circuit_02.jpg;3
1052;open_circuit;421;1722;502;1779;.\data\pcb_defects_kaggle\Annotations\Open_circuit\04_open_circuit_02;0.15101439790575916;0.7104301948051948;81;57;3056;2464;0.02650523560209424;0.023133116883116884;.\data\pcb_defects_kaggle\images/Open_circuit/04_open_circuit_02.jpg;3
1053;open_circuit;128;1228;197;1306;.\data\pcb_defects_kaggle\Annotations\Open_circuit\04_open_circuit_02;0.05317408376963351;0.5142045454545454;69;78;3056;2464;0.022578534031413612;0.03165584415584415;.\data\pcb_defects_kaggle\images/Open_circuit/04_open_circuit_02.jpg;3
1054;open_circuit;941;850;1002;911;.\data\pcb_defects_kaggle\Annotations\Open_circuit\04_open_circuit_03;0.31789921465968585;0.3573457792207792;61;61;3056;2464;0.019960732984293194;0.024756493506493508;.\data\pcb_defects_kaggle\images/Open_circuit/04_open_circuit_03.jpg;3
1055;open_circuit;1199;1208;1262;1262;.\data\pcb_defects_kaggle\Annotations\Open_circuit\04_open_circuit_03;0.4026505235602094;0.5012175324675324;63;54;3056;2464;0.0206151832460733;0.021915584415584416;.\data\pcb_defects_kaggle\images/Open_circuit/04_open_circuit_03.jpg;3
1056;open_circuit;1879;431;1944;510;.\data\pcb_defects_kaggle\Annotations\Open_circuit\04_open_circuit_03;0.6254908376963351;0.19094967532467533;65;79;3056;2464;0.021269633507853405;0.03206168831168831;.\data\pcb_defects_kaggle\images/Open_circuit/04_open_circuit_03.jpg;3
1057;open_circuit;395;506;455;564;.\data\pcb_defects_kaggle\Annotations\Open_circuit\04_open_circuit_04;0.13907068062827224;0.2171266233766234;60;58;3056;2464;0.01963350785340314;0.02353896103896104;.\data\pcb_defects_kaggle\images/Open_circuit/04_open_circuit_04.jpg;3
1058;open_circuit;1797;815;1866;859;.\data\pcb_defects_kaggle\Annotations\Open_circuit\04_open_circuit_04;0.5993128272251309;0.33969155844155846;69;44;3056;2464;0.022578534031413612;0.017857142857142856;.\data\pcb_defects_kaggle\images/Open_circuit/04_open_circuit_04.jpg;3
1059;open_circuit;1224;301;1297;355;.\data\pcb_defects_kaggle\Annotations\Open_circuit\04_open_circuit_04;0.412467277486911;0.1331168831168831;73;54;3056;2464;0.023887434554973823;0.021915584415584416;.\data\pcb_defects_kaggle\images/Open_circuit/04_open_circuit_04.jpg;3
1060;open_circuit;126;621;197;677;.\data\pcb_defects_kaggle\Annotations\Open_circuit\04_open_circuit_05;0.05284685863874346;0.26339285714285715;71;56;3056;2464;0.023232984293193717;0.022727272727272728;.\data\pcb_defects_kaggle\images/Open_circuit/04_open_circuit_05.jpg;3
1061;open_circuit;2384;1608;2451;1668;.\data\pcb_defects_kaggle\Annotations\Open_circuit\04_open_circuit_05;0.7910667539267016;0.6647727272727273;67;60;3056;2464;0.021924083769633507;0.024350649350649352;.\data\pcb_defects_kaggle\images/Open_circuit/04_open_circuit_05.jpg;3
1062;open_circuit;1901;981;1984;1055;.\data\pcb_defects_kaggle\Annotations\Open_circuit\04_open_circuit_05;0.6356348167539267;0.41314935064935066;83;74;3056;2464;0.027159685863874346;0.030032467532467532;.\data\pcb_defects_kaggle\images/Open_circuit/04_open_circuit_05.jpg;3
1063;open_circuit;999;1531;1061;1588;.\data\pcb_defects_kaggle\Annotations\Open_circuit\04_open_circuit_06;0.3370418848167539;0.632913961038961;62;57;3056;2464;0.020287958115183247;0.023133116883116884;.\data\pcb_defects_kaggle\images/Open_circuit/04_open_circuit_06.jpg;3
1064;open_circuit;591;1842;646;1889;.\data\pcb_defects_kaggle\Annotations\Open_circuit\04_open_circuit_06;0.20238874345549737;0.7571022727272727;55;47;3056;2464;0.01799738219895288;0.019074675324675324;.\data\pcb_defects_kaggle\images/Open_circuit/04_open_circuit_06.jpg;3
1065;open_circuit;1785;1257;1841;1308;.\data\pcb_defects_kaggle\Annotations\Open_circuit\04_open_circuit_06;0.5932591623036649;0.5204951298701299;56;51;3056;2464;0.01832460732984293;0.020698051948051948;.\data\pcb_defects_kaggle\images/Open_circuit/04_open_circuit_06.jpg;3
1066;open_circuit;1002;1030;1055;1075;.\data\pcb_defects_kaggle\Annotations\Open_circuit\04_open_circuit_07;0.33655104712041883;0.427150974025974;53;45;3056;2464;0.017342931937172776;0.018262987012987012;.\data\pcb_defects_kaggle\images/Open_circuit/04_open_circuit_07.jpg;3
1067;open_circuit;386;1111;459;1170;.\data\pcb_defects_kaggle\Annotations\Open_circuit\04_open_circuit_07;0.1382526178010471;0.4628652597402597;73;59;3056;2464;0.023887434554973823;0.023944805194805196;.\data\pcb_defects_kaggle\images/Open_circuit/04_open_circuit_07.jpg;3
1068;open_circuit;1791;1255;1853;1310;.\data\pcb_defects_kaggle\Annotations\Open_circuit\04_open_circuit_07;0.5962041884816754;0.5204951298701299;62;55;3056;2464;0.020287958115183247;0.022321428571428572;.\data\pcb_defects_kaggle\images/Open_circuit/04_open_circuit_07.jpg;3
1069;open_circuit;886;1028;944;1071;.\data\pcb_defects_kaggle\Annotations\Open_circuit\04_open_circuit_08;0.2994109947643979;0.42593344155844154;58;43;3056;2464;0.018979057591623036;0.0174512987012987;.\data\pcb_defects_kaggle\images/Open_circuit/04_open_circuit_08.jpg;3
1070;open_circuit;495;1299;553;1351;.\data\pcb_defects_kaggle\Annotations\Open_circuit\04_open_circuit_08;0.17146596858638743;0.5377435064935064;58;52;3056;2464;0.018979057591623036;0.021103896103896104;.\data\pcb_defects_kaggle\images/Open_circuit/04_open_circuit_08.jpg;3
1071;open_circuit;1742;906;1797;962;.\data\pcb_defects_kaggle\Annotations\Open_circuit\04_open_circuit_08;0.5790248691099477;0.37905844155844154;55;56;3056;2464;0.01799738219895288;0.022727272727272728;.\data\pcb_defects_kaggle\images/Open_circuit/04_open_circuit_08.jpg;3
1072;open_circuit;1113;286;1173;348;.\data\pcb_defects_kaggle\Annotations\Open_circuit\04_open_circuit_09;0.37401832460732987;0.1286525974025974;60;62;3056;2464;0.01963350785340314;0.025162337662337664;.\data\pcb_defects_kaggle\images/Open_circuit/04_open_circuit_09.jpg;3
1073;open_circuit;2331;433;2401;501;.\data\pcb_defects_kaggle\Annotations\Open_circuit\04_open_circuit_09;0.7742146596858639;0.18952922077922077;70;68;3056;2464;0.022905759162303665;0.027597402597402596;.\data\pcb_defects_kaggle\images/Open_circuit/04_open_circuit_09.jpg;3
1074;open_circuit;2128;877;2208;937;.\data\pcb_defects_kaggle\Annotations\Open_circuit\04_open_circuit_09;0.7094240837696335;0.36810064935064934;80;60;3056;2464;0.02617801047120419;0.024350649350649352;.\data\pcb_defects_kaggle\images/Open_circuit/04_open_circuit_09.jpg;3
1075;open_circuit;1171;1708;1241;1753;.\data\pcb_defects_kaggle\Annotations\Open_circuit\04_open_circuit_10;0.3946335078534031;0.7023133116883117;70;45;3056;2464;0.022905759162303665;0.018262987012987012;.\data\pcb_defects_kaggle\images/Open_circuit/04_open_circuit_10.jpg;3
1076;open_circuit;2181;1466;2235;1535;.\data\pcb_defects_kaggle\Annotations\Open_circuit\04_open_circuit_10;0.7225130890052356;0.6089691558441559;54;69;3056;2464;0.01767015706806283;0.028003246753246752;.\data\pcb_defects_kaggle\images/Open_circuit/04_open_circuit_10.jpg;3
1077;open_circuit;2582;1584;2657;1659;.\data\pcb_defects_kaggle\Annotations\Open_circuit\04_open_circuit_10;0.8571662303664922;0.6580762987012987;75;75;3056;2464;0.02454188481675393;0.030438311688311688;.\data\pcb_defects_kaggle\images/Open_circuit/04_open_circuit_10.jpg;3
1078;open_circuit;2231;1601;2310;1653;.\data\pcb_defects_kaggle\Annotations\Open_circuit\04_open_circuit_11;0.7429646596858639;0.6603084415584416;79;52;3056;2464;0.025850785340314136;0.021103896103896104;.\data\pcb_defects_kaggle\images/Open_circuit/04_open_circuit_11.jpg;3
1079;open_circuit;2473;1775;2541;1850;.\data\pcb_defects_kaggle\Annotations\Open_circuit\04_open_circuit_11;0.8203534031413613;0.7355925324675324;68;75;3056;2464;0.02225130890052356;0.030438311688311688;.\data\pcb_defects_kaggle\images/Open_circuit/04_open_circuit_11.jpg;3
1080;open_circuit;2390;1155;2451;1226;.\data\pcb_defects_kaggle\Annotations\Open_circuit\04_open_circuit_11;0.7920484293193717;0.4831574675324675;61;71;3056;2464;0.019960732984293194;0.028814935064935064;.\data\pcb_defects_kaggle\images/Open_circuit/04_open_circuit_11.jpg;3
1081;open_circuit;2135;855;2202;911;.\data\pcb_defects_kaggle\Annotations\Open_circuit\04_open_circuit_12;0.7095876963350786;0.35836038961038963;67;56;3056;2464;0.021924083769633507;0.022727272727272728;.\data\pcb_defects_kaggle\images/Open_circuit/04_open_circuit_12.jpg;3
1082;open_circuit;908;1110;977;1161;.\data\pcb_defects_kaggle\Annotations\Open_circuit\04_open_circuit_12;0.30840968586387435;0.460836038961039;69;51;3056;2464;0.022578534031413612;0.020698051948051948;.\data\pcb_defects_kaggle\images/Open_circuit/04_open_circuit_12.jpg;3
1083;open_circuit;1162;1201;1228;1264;.\data\pcb_defects_kaggle\Annotations\Open_circuit\04_open_circuit_12;0.3910340314136126;0.500202922077922;66;63;3056;2464;0.021596858638743454;0.02556818181818182;.\data\pcb_defects_kaggle\images/Open_circuit/04_open_circuit_12.jpg;3
1084;open_circuit;539;1453;602;1511;.\data\pcb_defects_kaggle\Annotations\Open_circuit\04_open_circuit_13;0.18668193717277487;0.601461038961039;63;58;3056;2464;0.0206151832460733;0.02353896103896104;.\data\pcb_defects_kaggle\images/Open_circuit/04_open_circuit_13.jpg;3
1085;open_circuit;1706;279;1786;348;.\data\pcb_defects_kaggle\Annotations\Open_circuit\04_open_circuit_13;0.5713350785340314;0.12723214285714285;80;69;3056;2464;0.02617801047120419;0.028003246753246752;.\data\pcb_defects_kaggle\images/Open_circuit/04_open_circuit_13.jpg;3
1086;open_circuit;559;504;621;566;.\data\pcb_defects_kaggle\Annotations\Open_circuit\04_open_circuit_13;0.19306282722513088;0.2171266233766234;62;62;3056;2464;0.020287958115183247;0.025162337662337664;.\data\pcb_defects_kaggle\images/Open_circuit/04_open_circuit_13.jpg;3
1087;open_circuit;550;1021;611;1079;.\data\pcb_defects_kaggle\Annotations\Open_circuit\04_open_circuit_14;0.1899541884816754;0.42613636363636365;61;58;3056;2464;0.019960732984293194;0.02353896103896104;.\data\pcb_defects_kaggle\images/Open_circuit/04_open_circuit_14.jpg;3
1088;open_circuit;1777;1206;1842;1266;.\data\pcb_defects_kaggle\Annotations\Open_circuit\04_open_circuit_14;0.5921138743455497;0.5016233766233766;65;60;3056;2464;0.021269633507853405;0.024350649350649352;.\data\pcb_defects_kaggle\images/Open_circuit/04_open_circuit_14.jpg;3
1089;open_circuit;886;1021;942;1070;.\data\pcb_defects_kaggle\Annotations\Open_circuit\04_open_circuit_14;0.29908376963350786;0.42431006493506496;56;49;3056;2464;0.01832460732984293;0.019886363636363636;.\data\pcb_defects_kaggle\images/Open_circuit/04_open_circuit_14.jpg;3
1090;open_circuit;1891;1402;1955;1457;.\data\pcb_defects_kaggle\Annotations\Open_circuit\04_open_circuit_15;0.6292539267015707;0.5801542207792207;64;55;3056;2464;0.020942408376963352;0.022321428571428572;.\data\pcb_defects_kaggle\images/Open_circuit/04_open_circuit_15.jpg;3
1091;open_circuit;2382;1393;2457;1457;.\data\pcb_defects_kaggle\Annotations\Open_circuit\04_open_circuit_15;0.7917212041884817;0.578327922077922;75;64;3056;2464;0.02454188481675393;0.025974025974025976;.\data\pcb_defects_kaggle\images/Open_circuit/04_open_circuit_15.jpg;3
1092;open_circuit;1875;521;1950;582;.\data\pcb_defects_kaggle\Annotations\Open_circuit\04_open_circuit_15;0.6258180628272252;0.22382305194805194;75;61;3056;2464;0.02454188481675393;0.024756493506493508;.\data\pcb_defects_kaggle\images/Open_circuit/04_open_circuit_15.jpg;3
1093;open_circuit;1718;813;1784;871;.\data\pcb_defects_kaggle\Annotations\Open_circuit\04_open_circuit_16;0.5729712041884817;0.3417207792207792;66;58;3056;2464;0.021596858638743454;0.02353896103896104;.\data\pcb_defects_kaggle\images/Open_circuit/04_open_circuit_16.jpg;3
1094;open_circuit;1964;1239;2041;1299;.\data\pcb_defects_kaggle\Annotations\Open_circuit\04_open_circuit_16;0.6552683246073299;0.5150162337662337;77;60;3056;2464;0.02519633507853403;0.024350649350649352;.\data\pcb_defects_kaggle\images/Open_circuit/04_open_circuit_16.jpg;3
1095;open_circuit;1795;958;1849;1035;.\data\pcb_defects_kaggle\Annotations\Open_circuit\04_open_circuit_16;0.5962041884816754;0.4044237012987013;54;77;3056;2464;0.01767015706806283;0.03125;.\data\pcb_defects_kaggle\images/Open_circuit/04_open_circuit_16.jpg;3
1096;open_circuit;488;1304;551;1364;.\data\pcb_defects_kaggle\Annotations\Open_circuit\04_open_circuit_17;0.1699934554973822;0.5413961038961039;63;60;3056;2464;0.0206151832460733;0.024350649350649352;.\data\pcb_defects_kaggle\images/Open_circuit/04_open_circuit_17.jpg;3
1097;open_circuit;119;1210;204;1273;.\data\pcb_defects_kaggle\Annotations\Open_circuit\04_open_circuit_17;0.05284685863874346;0.5038555194805194;85;63;3056;2464;0.027814136125654452;0.02556818181818182;.\data\pcb_defects_kaggle\images/Open_circuit/04_open_circuit_17.jpg;3
1098;open_circuit;239;1797;291;1859;.\data\pcb_defects_kaggle\Annotations\Open_circuit\04_open_circuit_17;0.08671465968586388;0.7418831168831169;52;62;3056;2464;0.017015706806282723;0.025162337662337664;.\data\pcb_defects_kaggle\images/Open_circuit/04_open_circuit_17.jpg;3
1099;open_circuit;493;501;551;568;.\data\pcb_defects_kaggle\Annotations\Open_circuit\04_open_circuit_18;0.17081151832460734;0.2169237012987013;58;67;3056;2464;0.018979057591623036;0.02719155844155844;.\data\pcb_defects_kaggle\images/Open_circuit/04_open_circuit_18.jpg;3
1100;open_circuit;397;1077;457;1141;.\data\pcb_defects_kaggle\Annotations\Open_circuit\04_open_circuit_18;0.13972513089005237;0.45008116883116883;60;64;3056;2464;0.01963350785340314;0.025974025974025976;.\data\pcb_defects_kaggle\images/Open_circuit/04_open_circuit_18.jpg;3
1101;open_circuit;1562;1206;1624;1259;.\data\pcb_defects_kaggle\Annotations\Open_circuit\04_open_circuit_19;0.5212696335078534;0.500202922077922;62;53;3056;2464;0.020287958115183247;0.02150974025974026;.\data\pcb_defects_kaggle\images/Open_circuit/04_open_circuit_19.jpg;3
1102;open_circuit;1850;1764;1927;1821;.\data\pcb_defects_kaggle\Annotations\Open_circuit\04_open_circuit_19;0.6179646596858639;0.7274756493506493;77;57;3056;2464;0.02519633507853403;0.023133116883116884;.\data\pcb_defects_kaggle\images/Open_circuit/04_open_circuit_19.jpg;3
1103;open_circuit;908;1253;968;1302;.\data\pcb_defects_kaggle\Annotations\Open_circuit\04_open_circuit_19;0.3069371727748691;0.5184659090909091;60;49;3056;2464;0.01963350785340314;0.019886363636363636;.\data\pcb_defects_kaggle\images/Open_circuit/04_open_circuit_19.jpg;3
1104;open_circuit;842;1079;908;1133;.\data\pcb_defects_kaggle\Annotations\Open_circuit\04_open_circuit_20;0.2863219895287958;0.44886363636363635;66;54;3056;2464;0.021596858638743454;0.021915584415584416;.\data\pcb_defects_kaggle\images/Open_circuit/04_open_circuit_20.jpg;3
1105;open_circuit;1886;1377;1962;1442;.\data\pcb_defects_kaggle\Annotations\Open_circuit\04_open_circuit_20;0.6295811518324608;0.5720373376623377;76;65;3056;2464;0.024869109947643978;0.026379870129870128;.\data\pcb_defects_kaggle\images/Open_circuit/04_open_circuit_20.jpg;3
1106;open_circuit;1797;817;1866;859;.\data\pcb_defects_kaggle\Annotations\Open_circuit\04_open_circuit_20;0.5993128272251309;0.3400974025974026;69;42;3056;2464;0.022578534031413612;0.017045454545454544;.\data\pcb_defects_kaggle\images/Open_circuit/04_open_circuit_20.jpg;3
1107;open_circuit;882;849;938;910;.\data\pcb_defects_kaggle\Annotations\Open_circuit\05_open_circuit_01;0.3577044025157233;0.4079313543599258;56;61;2544;2156;0.0220125786163522;0.02829313543599258;.\data\pcb_defects_kaggle\images/Open_circuit/05_open_circuit_01.jpg;3
1108;open_circuit;454;625;514;677;.\data\pcb_defects_kaggle\Annotations\Open_circuit\05_open_circuit_01;0.19025157232704404;0.30194805194805197;60;52;2544;2156;0.02358490566037736;0.02411873840445269;.\data\pcb_defects_kaggle\images/Open_circuit/05_open_circuit_01.jpg;3
1109;open_circuit;1587;630;1634;670;.\data\pcb_defects_kaggle\Annotations\Open_circuit\05_open_circuit_01;0.633058176100629;0.3014842300556586;47;40;2544;2156;0.018474842767295597;0.01855287569573284;.\data\pcb_defects_kaggle\images/Open_circuit/05_open_circuit_01.jpg;3
1110;open_circuit;767;1668;813;1720;.\data\pcb_defects_kaggle\Annotations\Open_circuit\05_open_circuit_02;0.31053459119496857;0.7857142857142857;46;52;2544;2156;0.018081761006289308;0.02411873840445269;.\data\pcb_defects_kaggle\images/Open_circuit/05_open_circuit_02.jpg;3
1111;open_circuit;2214;1779;2266;1821;.\data\pcb_defects_kaggle\Annotations\Open_circuit\05_open_circuit_02;0.8805031446540881;0.8348794063079777;52;42;2544;2156;0.020440251572327043;0.01948051948051948;.\data\pcb_defects_kaggle\images/Open_circuit/05_open_circuit_02.jpg;3
1112;open_circuit;2035;265;2102;315;.\data\pcb_defects_kaggle\Annotations\Open_circuit\05_open_circuit_02;0.8130896226415094;0.1345083487940631;67;50;2544;2156;0.026336477987421385;0.023191094619666047;.\data\pcb_defects_kaggle\images/Open_circuit/05_open_circuit_02.jpg;3
1113;open_circuit;1596;740;1644;790;.\data\pcb_defects_kaggle\Annotations\Open_circuit\05_open_circuit_03;0.6367924528301887;0.35482374768089053;48;50;2544;2156;0.018867924528301886;0.023191094619666047;.\data\pcb_defects_kaggle\images/Open_circuit/05_open_circuit_03.jpg;3
1114;open_circuit;1402;832;1444;878;.\data\pcb_defects_kaggle\Annotations\Open_circuit\05_open_circuit_03;0.5593553459119497;0.3965677179962894;42;46;2544;2156;0.01650943396226415;0.021335807050092765;.\data\pcb_defects_kaggle\images/Open_circuit/05_open_circuit_03.jpg;3
1115;open_circuit;1610;1373;1661;1423;.\data\pcb_defects_kaggle\Annotations\Open_circuit\05_open_circuit_03;0.6428852201257862;0.6484230055658627;51;50;2544;2156;0.020047169811320754;0.023191094619666047;.\data\pcb_defects_kaggle\images/Open_circuit/05_open_circuit_03.jpg;3
1116;open_circuit;1400;829;1441;881;.\data\pcb_defects_kaggle\Annotations\Open_circuit\05_open_circuit_04;0.558372641509434;0.3965677179962894;41;52;2544;2156;0.01611635220125786;0.02411873840445269;.\data\pcb_defects_kaggle\images/Open_circuit/05_open_circuit_04.jpg;3
1117;open_circuit;1591;748;1649;787;.\data\pcb_defects_kaggle\Annotations\Open_circuit\05_open_circuit_04;0.6367924528301887;0.3559833024118738;58;39;2544;2156;0.02279874213836478;0.018089053803339517;.\data\pcb_defects_kaggle\images/Open_circuit/05_open_circuit_04.jpg;3
1118;open_circuit;1819;1546;1866;1596;.\data\pcb_defects_kaggle\Annotations\Open_circuit\05_open_circuit_04;0.7242531446540881;0.7286641929499073;47;50;2544;2156;0.018474842767295597;0.023191094619666047;.\data\pcb_defects_kaggle\images/Open_circuit/05_open_circuit_04.jpg;3
1119;open_circuit;1241;1765;1303;1821;.\data\pcb_defects_kaggle\Annotations\Open_circuit\05_open_circuit_04;0.5;0.8316326530612245;62;56;2544;2156;0.02437106918238994;0.025974025974025976;.\data\pcb_defects_kaggle\images/Open_circuit/05_open_circuit_04.jpg;3
1120;open_circuit;1611;1371;1667;1421;.\data\pcb_defects_kaggle\Annotations\Open_circuit\05_open_circuit_04;0.6442610062893082;0.647495361781076;56;50;2544;2156;0.0220125786163522;0.023191094619666047;.\data\pcb_defects_kaggle\images/Open_circuit/05_open_circuit_04.jpg;3
1121;open_circuit;217;1359;270;1412;.\data\pcb_defects_kaggle\Annotations\Open_circuit\05_open_circuit_05;0.09571540880503145;0.6426252319109462;53;53;2544;2156;0.020833333333333332;0.02458256029684601;.\data\pcb_defects_kaggle\images/Open_circuit/05_open_circuit_05.jpg;3
1122;open_circuit;1391;1398;1444;1446;.\data\pcb_defects_kaggle\Annotations\Open_circuit\05_open_circuit_05;0.5571933962264151;0.6595547309833024;53;48;2544;2156;0.020833333333333332;0.022263450834879406;.\data\pcb_defects_kaggle\images/Open_circuit/05_open_circuit_05.jpg;3
1123;open_circuit;1003;1482;1059;1534;.\data\pcb_defects_kaggle\Annotations\Open_circuit\05_open_circuit_05;0.40526729559748426;0.699443413729128;56;52;2544;2156;0.0220125786163522;0.02411873840445269;.\data\pcb_defects_kaggle\images/Open_circuit/05_open_circuit_05.jpg;3
1124;open_circuit;2360;1635;2403;1690;.\data\pcb_defects_kaggle\Annotations\Open_circuit\05_open_circuit_06;0.936124213836478;0.7711038961038961;43;55;2544;2156;0.01690251572327044;0.025510204081632654;.\data\pcb_defects_kaggle\images/Open_circuit/05_open_circuit_06.jpg;3
1125;open_circuit;2083;993;2180;1085;.\data\pcb_defects_kaggle\Annotations\Open_circuit\05_open_circuit_06;0.8378537735849056;0.4819109461966605;97;92;2544;2156;0.03812893081761006;0.04267161410018553;.\data\pcb_defects_kaggle\images/Open_circuit/05_open_circuit_06.jpg;3
1126;open_circuit;1702;709;1767;774;.\data\pcb_defects_kaggle\Annotations\Open_circuit\05_open_circuit_06;0.6818003144654088;0.3439239332096475;65;65;2544;2156;0.025550314465408806;0.030148423005565864;.\data\pcb_defects_kaggle\images/Open_circuit/05_open_circuit_06.jpg;3
1127;open_circuit;874;1088;927;1131;.\data\pcb_defects_kaggle\Annotations\Open_circuit\05_open_circuit_07;0.35397012578616355;0.5146103896103896;53;43;2544;2156;0.020833333333333332;0.019944341372912802;.\data\pcb_defects_kaggle\images/Open_circuit/05_open_circuit_07.jpg;3
1128;open_circuit;2385;1412;2455;1474;.\data\pcb_defects_kaggle\Annotations\Open_circuit\05_open_circuit_07;0.9512578616352201;0.6692949907235621;70;62;2544;2156;0.027515723270440252;0.0287569573283859;.\data\pcb_defects_kaggle\images/Open_circuit/05_open_circuit_07.jpg;3
1129;open_circuit;947;340;997;390;.\data\pcb_defects_kaggle\Annotations\Open_circuit\05_open_circuit_07;0.38207547169811323;0.16929499072356216;50;50;2544;2156;0.019654088050314465;0.023191094619666047;.\data\pcb_defects_kaggle\images/Open_circuit/05_open_circuit_07.jpg;3
1130;open_circuit;1170;1028;1217;1082;.\data\pcb_defects_kaggle\Annotations\Open_circuit\05_open_circuit_08;0.4691430817610063;0.4893320964749536;47;54;2544;2156;0.018474842767295597;0.02504638218923933;.\data\pcb_defects_kaggle\images/Open_circuit/05_open_circuit_08.jpg;3
1131;open_circuit;1563;915;1616;960;.\data\pcb_defects_kaggle\Annotations\Open_circuit\05_open_circuit_08;0.6248034591194969;0.4348330241187384;53;45;2544;2156;0.020833333333333332;0.020871985157699443;.\data\pcb_defects_kaggle\images/Open_circuit/05_open_circuit_08.jpg;3
1132;open_circuit;1035;1486;1092;1538;.\data\pcb_defects_kaggle\Annotations\Open_circuit\05_open_circuit_08;0.4180424528301887;0.7012987012987013;57;52;2544;2156;0.02240566037735849;0.02411873840445269;.\data\pcb_defects_kaggle\images/Open_circuit/05_open_circuit_08.jpg;3
1133;open_circuit;2245;1360;2308;1412;.\data\pcb_defects_kaggle\Annotations\Open_circuit\05_open_circuit_09;0.8948506289308176;0.6428571428571429;63;52;2544;2156;0.024764150943396228;0.02411873840445269;.\data\pcb_defects_kaggle\images/Open_circuit/05_open_circuit_09.jpg;3
1134;open_circuit;1616;1858;1666;1905;.\data\pcb_defects_kaggle\Annotations\Open_circuit\05_open_circuit_09;0.6450471698113207;0.8726808905380334;50;47;2544;2156;0.019654088050314465;0.021799628942486084;.\data\pcb_defects_kaggle\images/Open_circuit/05_open_circuit_09.jpg;3
1135;open_circuit;2132;1547;2193;1592;.\data\pcb_defects_kaggle\Annotations\Open_circuit\05_open_circuit_09;0.8500393081761006;0.7279684601113172;61;45;2544;2156;0.02397798742138365;0.020871985157699443;.\data\pcb_defects_kaggle\images/Open_circuit/05_open_circuit_09.jpg;3
1136;open_circuit;1203;663;1256;707;.\data\pcb_defects_kaggle\Annotations\Open_circuit\05_open_circuit_10;0.4832940251572327;0.3177179962894249;53;44;2544;2156;0.020833333333333332;0.02040816326530612;.\data\pcb_defects_kaggle\images/Open_circuit/05_open_circuit_10.jpg;3
1137;open_circuit;147;425;199;477;.\data\pcb_defects_kaggle\Annotations\Open_circuit\05_open_circuit_10;0.06800314465408805;0.20918367346938777;52;52;2544;2156;0.020440251572327043;0.02411873840445269;.\data\pcb_defects_kaggle\images/Open_circuit/05_open_circuit_10.jpg;3
1138;open_circuit;311;562;364;626;.\data\pcb_defects_kaggle\Annotations\Open_circuit\05_open_circuit_10;0.13266509433962265;0.2755102040816326;53;64;2544;2156;0.020833333333333332;0.029684601113172542;.\data\pcb_defects_kaggle\images/Open_circuit/05_open_circuit_10.jpg;3
1139;open_circuit;1493;1536;1528;1578;.\data\pcb_defects_kaggle\Annotations\Open_circuit\06_open_circuit_01;0.5266736401673641;0.6722797927461139;35;42;2868;2316;0.012203626220362623;0.018134715025906734;.\data\pcb_defects_kaggle\images/Open_circuit/06_open_circuit_01.jpg;3
1140;open_circuit;1033;512;1079;556;.\data\pcb_defects_kaggle\Annotations\Open_circuit\06_open_circuit_01;0.3682008368200837;0.23056994818652848;46;44;2868;2316;0.01603905160390516;0.018998272884283247;.\data\pcb_defects_kaggle\images/Open_circuit/06_open_circuit_01.jpg;3
1141;open_circuit;1679;788;1716;829;.\data\pcb_defects_kaggle\Annotations\Open_circuit\06_open_circuit_01;0.5918758716875872;0.3490932642487047;37;41;2868;2316;0.01290097629009763;0.01770293609671848;.\data\pcb_defects_kaggle\images/Open_circuit/06_open_circuit_01.jpg;3
1142;open_circuit;977;1332;1020;1376;.\data\pcb_defects_kaggle\Annotations\Open_circuit\06_open_circuit_01;0.34815202231520226;0.5846286701208981;43;44;2868;2316;0.01499302649930265;0.018998272884283247;.\data\pcb_defects_kaggle\images/Open_circuit/06_open_circuit_01.jpg;3
1143;open_circuit;1381;1081;1423;1115;.\data\pcb_defects_kaggle\Annotations\Open_circuit\06_open_circuit_01;0.4888423988842399;0.4740932642487047;42;34;2868;2316;0.014644351464435146;0.01468048359240069;.\data\pcb_defects_kaggle\images/Open_circuit/06_open_circuit_01.jpg;3
1144;open_circuit;2043;959;2081;998;.\data\pcb_defects_kaggle\Annotations\Open_circuit\06_open_circuit_02;0.7189679218967922;0.4224956822107081;38;39;2868;2316;0.013249651324965132;0.01683937823834197;.\data\pcb_defects_kaggle\images/Open_circuit/06_open_circuit_02.jpg;3
1145;open_circuit;1930;1119;1962;1153;.\data\pcb_defects_kaggle\Annotations\Open_circuit\06_open_circuit_02;0.6785216178521618;0.4905008635578584;32;34;2868;2316;0.011157601115760111;0.01468048359240069;.\data\pcb_defects_kaggle\images/Open_circuit/06_open_circuit_02.jpg;3
1146;open_circuit;451;1586;486;1628;.\data\pcb_defects_kaggle\Annotations\Open_circuit\06_open_circuit_02;0.16335425383542537;0.6938687392055267;35;42;2868;2316;0.012203626220362623;0.018134715025906734;.\data\pcb_defects_kaggle\images/Open_circuit/06_open_circuit_02.jpg;3
1147;open_circuit;969;2171;1038;2239;.\data\pcb_defects_kaggle\Annotations\Open_circuit\06_open_circuit_02;0.34989539748953974;0.9520725388601037;69;68;2868;2316;0.02405857740585774;0.02936096718480138;.\data\pcb_defects_kaggle\images/Open_circuit/06_open_circuit_02.jpg;3
1148;open_circuit;527;1919;566;1966;.\data\pcb_defects_kaggle\Annotations\Open_circuit\06_open_circuit_02;0.19055090655509066;0.8387305699481865;39;47;2868;2316;0.013598326359832637;0.020293609671848015;.\data\pcb_defects_kaggle\images/Open_circuit/06_open_circuit_02.jpg;3
1149;open_circuit;2243;624;2281;664;.\data\pcb_defects_kaggle\Annotations\Open_circuit\06_open_circuit_03;0.7887029288702929;0.27806563039723664;38;40;2868;2316;0.013249651324965132;0.017271157167530225;.\data\pcb_defects_kaggle\images/Open_circuit/06_open_circuit_03.jpg;3
1150;open_circuit;2075;1373;2105;1407;.\data\pcb_defects_kaggle\Annotations\Open_circuit\06_open_circuit_03;0.7287308228730823;0.6001727115716753;30;34;2868;2316;0.010460251046025104;0.01468048359240069;.\data\pcb_defects_kaggle\images/Open_circuit/06_open_circuit_03.jpg;3
1151;open_circuit;1281;1685;1317;1726;.\data\pcb_defects_kaggle\Annotations\Open_circuit\06_open_circuit_03;0.45292887029288703;0.7363989637305699;36;41;2868;2316;0.012552301255230125;0.01770293609671848;.\data\pcb_defects_kaggle\images/Open_circuit/06_open_circuit_03.jpg;3
1152;open_circuit;1138;917;1186;956;.\data\pcb_defects_kaggle\Annotations\Open_circuit\06_open_circuit_03;0.405160390516039;0.40436096718480136;48;39;2868;2316;0.016736401673640166;0.01683937823834197;.\data\pcb_defects_kaggle\images/Open_circuit/06_open_circuit_03.jpg;3
1153;open_circuit;1020;1297;1049;1334;.\data\pcb_defects_kaggle\Annotations\Open_circuit\06_open_circuit_03;0.36070432357043236;0.5680051813471503;29;37;2868;2316;0.010111576011157601;0.015975820379965457;.\data\pcb_defects_kaggle\images/Open_circuit/06_open_circuit_03.jpg;3
1154;open_circuit;1411;692;1450;734;.\data\pcb_defects_kaggle\Annotations\Open_circuit\06_open_circuit_04;0.4987796373779637;0.3078583765112263;39;42;2868;2316;0.013598326359832637;0.018134715025906734;.\data\pcb_defects_kaggle\images/Open_circuit/06_open_circuit_04.jpg;3
1155;open_circuit;682;954;718;997;.\data\pcb_defects_kaggle\Annotations\Open_circuit\06_open_circuit_04;0.24407252440725244;0.42120034542314333;36;43;2868;2316;0.012552301255230125;0.018566493955094993;.\data\pcb_defects_kaggle\images/Open_circuit/06_open_circuit_04.jpg;3
1156;open_circuit;469;1302;511;1341;.\data\pcb_defects_kaggle\Annotations\Open_circuit\06_open_circuit_04;0.1708507670850767;0.5705958549222798;42;39;2868;2316;0.014644351464435146;0.01683937823834197;.\data\pcb_defects_kaggle\images/Open_circuit/06_open_circuit_04.jpg;3
1157;open_circuit;1321;1208;1357;1241;.\data\pcb_defects_kaggle\Annotations\Open_circuit\06_open_circuit_04;0.46687587168758715;0.528713298791019;36;33;2868;2316;0.012552301255230125;0.014248704663212436;.\data\pcb_defects_kaggle\images/Open_circuit/06_open_circuit_04.jpg;3
1158;open_circuit;441;910;485;954;.\data\pcb_defects_kaggle\Annotations\Open_circuit\06_open_circuit_04;0.1614365411436541;0.40241796200345425;44;44;2868;2316;0.015341701534170154;0.018998272884283247;.\data\pcb_defects_kaggle\images/Open_circuit/06_open_circuit_04.jpg;3
1159;open_circuit;1930;1345;1965;1380;.\data\pcb_defects_kaggle\Annotations\Open_circuit\06_open_circuit_05;0.6790446304044631;0.5882987910189983;35;35;2868;2316;0.012203626220362623;0.015112262521588947;.\data\pcb_defects_kaggle\images/Open_circuit/06_open_circuit_05.jpg;3
1160;open_circuit;1444;660;1488;696;.\data\pcb_defects_kaggle\Annotations\Open_circuit\06_open_circuit_05;0.5111576011157601;0.2927461139896373;44;36;2868;2316;0.015341701534170154;0.015544041450777202;.\data\pcb_defects_kaggle\images/Open_circuit/06_open_circuit_05.jpg;3
1161;open_circuit;1850;1701;1891;1734;.\data\pcb_defects_kaggle\Annotations\Open_circuit\06_open_circuit_05;0.6521966527196653;0.741580310880829;41;33;2868;2316;0.014295676429567642;0.014248704663212436;.\data\pcb_defects_kaggle\images/Open_circuit/06_open_circuit_05.jpg;3
1162;open_circuit;1426;1648;1465;1684;.\data\pcb_defects_kaggle\Annotations\Open_circuit\06_open_circuit_05;0.5040097629009763;0.7193436960276338;39;36;2868;2316;0.013598326359832637;0.015544041450777202;.\data\pcb_defects_kaggle\images/Open_circuit/06_open_circuit_05.jpg;3
1163;open_circuit;865;364;910;405;.\data\pcb_defects_kaggle\Annotations\Open_circuit\06_open_circuit_05;0.30944909344490934;0.16601899827288427;45;41;2868;2316;0.015690376569037656;0.01770293609671848;.\data\pcb_defects_kaggle\images/Open_circuit/06_open_circuit_05.jpg;3
1164;open_circuit;1811;791;1845;826;.\data\pcb_defects_kaggle\Annotations\Open_circuit\06_open_circuit_06;0.6373779637377964;0.3490932642487047;34;35;2868;2316;0.011854951185495118;0.015112262521588947;.\data\pcb_defects_kaggle\images/Open_circuit/06_open_circuit_06.jpg;3
1165;open_circuit;1586;822;1625;857;.\data\pcb_defects_kaggle\Annotations\Open_circuit\06_open_circuit_06;0.5597977684797768;0.36247841105354056;39;35;2868;2316;0.013598326359832637;0.015112262521588947;.\data\pcb_defects_kaggle\images/Open_circuit/06_open_circuit_06.jpg;3
1166;open_circuit;1162;682;1205;726;.\data\pcb_defects_kaggle\Annotations\Open_circuit\06_open_circuit_06;0.41265690376569036;0.30397236614853196;43;44;2868;2316;0.01499302649930265;0.018998272884283247;.\data\pcb_defects_kaggle\images/Open_circuit/06_open_circuit_06.jpg;3
1167;open_circuit;431;724;491;768;.\data\pcb_defects_kaggle\Annotations\Open_circuit\06_open_circuit_06;0.1607391910739191;0.3221070811744387;60;44;2868;2316;0.02092050209205021;0.018998272884283247;.\data\pcb_defects_kaggle\images/Open_circuit/06_open_circuit_06.jpg;3
1168;open_circuit;807;737;843;772;.\data\pcb_defects_kaggle\Annotations\Open_circuit\06_open_circuit_06;0.28765690376569036;0.32577720207253885;36;35;2868;2316;0.012552301255230125;0.015112262521588947;.\data\pcb_defects_kaggle\images/Open_circuit/06_open_circuit_06.jpg;3
1169;open_circuit;1193;395;1252;453;.\data\pcb_defects_kaggle\Annotations\Open_circuit\06_open_circuit_07;0.426255230125523;0.18307426597582038;59;58;2868;2316;0.020571827057182707;0.025043177892918825;.\data\pcb_defects_kaggle\images/Open_circuit/06_open_circuit_07.jpg;3
1170;open_circuit;1928;1022;1964;1103;.\data\pcb_defects_kaggle\Annotations\Open_circuit\06_open_circuit_07;0.6785216178521618;0.4587651122625216;36;81;2868;2316;0.012552301255230125;0.034974093264248704;.\data\pcb_defects_kaggle\images/Open_circuit/06_open_circuit_07.jpg;3
1171;open_circuit;1760;1665;1848;1703;.\data\pcb_defects_kaggle\Annotations\Open_circuit\06_open_circuit_07;0.6290097629009763;0.7271157167530224;88;38;2868;2316;0.030683403068340307;0.016407599309153715;.\data\pcb_defects_kaggle\images/Open_circuit/06_open_circuit_07.jpg;3
1172;open_circuit;1195;1061;1227;1109;.\data\pcb_defects_kaggle\Annotations\Open_circuit\06_open_circuit_07;0.4222454672245467;0.4684801381692573;32;48;2868;2316;0.011157601115760111;0.02072538860103627;.\data\pcb_defects_kaggle\images/Open_circuit/06_open_circuit_07.jpg;3
1173;open_circuit;1674;1015;1730;1054;.\data\pcb_defects_kaggle\Annotations\Open_circuit\06_open_circuit_07;0.5934449093444909;0.4466753022452504;56;39;2868;2316;0.019525801952580194;0.01683937823834197;.\data\pcb_defects_kaggle\images/Open_circuit/06_open_circuit_07.jpg;3
1174;open_circuit;1188;402;1271;442;.\data\pcb_defects_kaggle\Annotations\Open_circuit\06_open_circuit_08;0.42869595536959554;0.18221070811744386;83;40;2868;2316;0.02894002789400279;0.017271157167530225;.\data\pcb_defects_kaggle\images/Open_circuit/06_open_circuit_08.jpg;3
1175;open_circuit;684;1044;716;1122;.\data\pcb_defects_kaggle\Annotations\Open_circuit\06_open_circuit_08;0.24407252440725244;0.4676165803108808;32;78;2868;2316;0.011157601115760111;0.03367875647668394;.\data\pcb_defects_kaggle\images/Open_circuit/06_open_circuit_08.jpg;3
1176;open_circuit;159;1036;204;1119;.\data\pcb_defects_kaggle\Annotations\Open_circuit\06_open_circuit_08;0.06328451882845189;0.46524179620034545;45;83;2868;2316;0.015690376569037656;0.035837651122625214;.\data\pcb_defects_kaggle\images/Open_circuit/06_open_circuit_08.jpg;3
1177;open_circuit;879;1368;913;1422;.\data\pcb_defects_kaggle\Annotations\Open_circuit\06_open_circuit_08;0.3124128312412831;0.6023316062176166;34;54;2868;2316;0.011854951185495118;0.023316062176165803;.\data\pcb_defects_kaggle\images/Open_circuit/06_open_circuit_08.jpg;3
1178;open_circuit;1789;1093;1826;1152;.\data\pcb_defects_kaggle\Annotations\Open_circuit\06_open_circuit_08;0.6302301255230126;0.4846718480138169;37;59;2868;2316;0.01290097629009763;0.02547495682210708;.\data\pcb_defects_kaggle\images/Open_circuit/06_open_circuit_08.jpg;3
1179;open_circuit;2099;983;2142;1053;.\data\pcb_defects_kaggle\Annotations\Open_circuit\06_open_circuit_09;0.7393654114365411;0.43955094991364424;43;70;2868;2316;0.01499302649930265;0.030224525043177894;.\data\pcb_defects_kaggle\images/Open_circuit/06_open_circuit_09.jpg;3
1180;open_circuit;1793;1666;1865;1698;.\data\pcb_defects_kaggle\Annotations\Open_circuit\06_open_circuit_09;0.6377266387726639;0.7262521588946459;72;32;2868;2316;0.02510460251046025;0.013816925734024179;.\data\pcb_defects_kaggle\images/Open_circuit/06_open_circuit_09.jpg;3
1181;open_circuit;1491;1132;1594;1155;.\data\pcb_defects_kaggle\Annotations\Open_circuit\06_open_circuit_09;0.5378312412831241;0.4937392055267703;103;23;2868;2316;0.035913528591352856;0.009930915371329879;.\data\pcb_defects_kaggle\images/Open_circuit/06_open_circuit_09.jpg;3
1182;open_circuit;1200;1063;1226;1132;.\data\pcb_defects_kaggle\Annotations\Open_circuit\06_open_circuit_09;0.42294281729428174;0.4738773747841105;26;69;2868;2316;0.00906555090655509;0.029792746113989636;.\data\pcb_defects_kaggle\images/Open_circuit/06_open_circuit_09.jpg;3
1183;open_circuit;1896;1890;1961;1922;.\data\pcb_defects_kaggle\Annotations\Open_circuit\06_open_circuit_09;0.6724198047419805;0.8229706390328152;65;32;2868;2316;0.022663877266387727;0.013816925734024179;.\data\pcb_defects_kaggle\images/Open_circuit/06_open_circuit_09.jpg;3
1184;open_circuit;1988;995;2020;1050;.\data\pcb_defects_kaggle\Annotations\Open_circuit\06_open_circuit_10;0.698744769874477;0.44149395509499134;32;55;2868;2316;0.011157601115760111;0.023747841105354058;.\data\pcb_defects_kaggle\images/Open_circuit/06_open_circuit_10.jpg;3
1185;open_circuit;1299;1036;1351;1080;.\data\pcb_defects_kaggle\Annotations\Open_circuit\06_open_circuit_10;0.4619944211994421;0.45682210708117443;52;44;2868;2316;0.01813110181311018;0.018998272884283247;.\data\pcb_defects_kaggle\images/Open_circuit/06_open_circuit_10.jpg;3
1186;open_circuit;938;1319;977;1378;.\data\pcb_defects_kaggle\Annotations\Open_circuit\06_open_circuit_10;0.33385634588563456;0.5822538860103627;39;59;2868;2316;0.013598326359832637;0.02547495682210708;.\data\pcb_defects_kaggle\images/Open_circuit/06_open_circuit_10.jpg;3
1187;open_circuit;632;302;683;341;.\data\pcb_defects_kaggle\Annotations\Open_circuit\06_open_circuit_10;0.22925383542538355;0.13881692573402418;51;39;2868;2316;0.01778242677824268;0.01683937823834197;.\data\pcb_defects_kaggle\images/Open_circuit/06_open_circuit_10.jpg;3
1188;open_circuit;1368;325;1458;367;.\data\pcb_defects_kaggle\Annotations\Open_circuit\06_open_circuit_10;0.49267782426778245;0.14939550949913644;90;42;2868;2316;0.03138075313807531;0.018134715025906734;.\data\pcb_defects_kaggle\images/Open_circuit/06_open_circuit_10.jpg;3
1189;open_circuit;1725;182;1779;233;.\data\pcb_defects_kaggle\Annotations\Open_circuit\07_open_circuit_01;0.6033057851239669;0.10801665799062989;54;51;2904;1921;0.01859504132231405;0.02654867256637168;.\data\pcb_defects_kaggle\images/Open_circuit/07_open_circuit_01.jpg;3
1190;open_circuit;950;375;1027;457;.\data\pcb_defects_kaggle\Annotations\Open_circuit\07_open_circuit_01;0.34039256198347106;0.21655387818844352;77;82;2904;1921;0.026515151515151516;0.04268610098906819;.\data\pcb_defects_kaggle\images/Open_circuit/07_open_circuit_01.jpg;3
1191;open_circuit;1691;883;1756;936;.\data\pcb_defects_kaggle\Annotations\Open_circuit\07_open_circuit_01;0.59349173553719;0.47345132743362833;65;53;2904;1921;0.022382920110192838;0.027589796980739198;.\data\pcb_defects_kaggle\images/Open_circuit/07_open_circuit_01.jpg;3
1192;open_circuit;972;883;1038;931;.\data\pcb_defects_kaggle\Annotations\Open_circuit\07_open_circuit_01;0.34607438016528924;0.4721499219156689;66;48;2904;1921;0.022727272727272728;0.024986985944820406;.\data\pcb_defects_kaggle\images/Open_circuit/07_open_circuit_01.jpg;3
1193;open_circuit;2122;886;2176;938;.\data\pcb_defects_kaggle\Annotations\Open_circuit\07_open_circuit_01;0.7400137741046832;0.4747527329515877;54;52;2904;1921;0.01859504132231405;0.02706923477355544;.\data\pcb_defects_kaggle\images/Open_circuit/07_open_circuit_01.jpg;3
1194;open_circuit;2022;244;2068;288;.\data\pcb_defects_kaggle\Annotations\Open_circuit\07_open_circuit_02;0.7042011019283747;0.13846954711087975;46;44;2904;1921;0.01584022038567493;0.022904737116085372;.\data\pcb_defects_kaggle\images/Open_circuit/07_open_circuit_02.jpg;3
1195;open_circuit;1772;867;1820;919;.\data\pcb_defects_kaggle\Annotations\Open_circuit\07_open_circuit_02;0.6184573002754821;0.4648620510150963;48;52;2904;1921;0.01652892561983471;0.02706923477355544;.\data\pcb_defects_kaggle\images/Open_circuit/07_open_circuit_02.jpg;3
1196;open_circuit;2184;827;2234;884;.\data\pcb_defects_kaggle\Annotations\Open_circuit\07_open_circuit_02;0.7606749311294766;0.44534096824570535;50;57;2904;1921;0.01721763085399449;0.029672045809474232;.\data\pcb_defects_kaggle\images/Open_circuit/07_open_circuit_02.jpg;3
1197;open_circuit;799;951;851;1003;.\data\pcb_defects_kaggle\Annotations\Open_circuit\07_open_circuit_02;0.2840909090909091;0.508589276418532;52;52;2904;1921;0.01790633608815427;0.02706923477355544;.\data\pcb_defects_kaggle\images/Open_circuit/07_open_circuit_02.jpg;3
1198;open_circuit;689;403;742;476;.\data\pcb_defects_kaggle\Annotations\Open_circuit\07_open_circuit_02;0.24638429752066116;0.22878709005726183;53;73;2904;1921;0.01825068870523416;0.03800104112441437;.\data\pcb_defects_kaggle\images/Open_circuit/07_open_circuit_02.jpg;3
1199;open_circuit;1103;526;1148;579;.\data\pcb_defects_kaggle\Annotations\Open_circuit\07_open_circuit_03;0.387568870523416;0.28761061946902655;45;53;2904;1921;0.015495867768595042;0.027589796980739198;.\data\pcb_defects_kaggle\images/Open_circuit/07_open_circuit_03.jpg;3
1200;open_circuit;1344;870;1389;920;.\data\pcb_defects_kaggle\Annotations\Open_circuit\07_open_circuit_03;0.4705578512396694;0.4659031754294638;45;50;2904;1921;0.015495867768595042;0.026028110359187923;.\data\pcb_defects_kaggle\images/Open_circuit/07_open_circuit_03.jpg;3
1201;open_circuit;987;960;1039;1005;.\data\pcb_defects_kaggle\Annotations\Open_circuit\07_open_circuit_03;0.3488292011019284;0.5114523685580427;52;45;2904;1921;0.01790633608815427;0.02342529932326913;.\data\pcb_defects_kaggle\images/Open_circuit/07_open_circuit_03.jpg;3
1202;open_circuit;2056;832;2108;877;.\data\pcb_defects_kaggle\Annotations\Open_circuit\07_open_circuit_03;0.7169421487603306;0.4448204060385216;52;45;2904;1921;0.01790633608815427;0.02342529932326913;.\data\pcb_defects_kaggle\images/Open_circuit/07_open_circuit_03.jpg;3
1203;open_circuit;2333;449;2380;511;.\data\pcb_defects_kaggle\Annotations\Open_circuit\07_open_circuit_03;0.8114669421487604;0.24986985944820406;47;62;2904;1921;0.01618457300275482;0.032274856845393024;.\data\pcb_defects_kaggle\images/Open_circuit/07_open_circuit_03.jpg;3
1204;open_circuit;642;227;717;298;.\data\pcb_defects_kaggle\Annotations\Open_circuit\07_open_circuit_04;0.23398760330578514;0.1366475793857366;75;71;2904;1921;0.025826446280991736;0.03695991671004685;.\data\pcb_defects_kaggle\images/Open_circuit/07_open_circuit_04.jpg;3
1205;open_circuit;862;507;914;579;.\data\pcb_defects_kaggle\Annotations\Open_circuit\07_open_circuit_04;0.30578512396694213;0.2826652785007808;52;72;2904;1921;0.01790633608815427;0.03748047891723061;.\data\pcb_defects_kaggle\images/Open_circuit/07_open_circuit_04.jpg;3
1206;open_circuit;1987;243;2051;291;.\data\pcb_defects_kaggle\Annotations\Open_circuit\07_open_circuit_04;0.6952479338842975;0.13899010931806352;64;48;2904;1921;0.02203856749311295;0.024986985944820406;.\data\pcb_defects_kaggle\images/Open_circuit/07_open_circuit_04.jpg;3
1207;open_circuit;2689;572;2736;619;.\data\pcb_defects_kaggle\Annotations\Open_circuit\07_open_circuit_04;0.9340564738292011;0.30999479437792815;47;47;2904;1921;0.01618457300275482;0.024466423737636647;.\data\pcb_defects_kaggle\images/Open_circuit/07_open_circuit_04.jpg;3
1208;open_circuit;2355;660;2418;715;.\data\pcb_defects_kaggle\Annotations\Open_circuit\07_open_circuit_04;0.8217975206611571;0.35788651743883393;63;55;2904;1921;0.02169421487603306;0.028630921395106715;.\data\pcb_defects_kaggle\images/Open_circuit/07_open_circuit_04.jpg;3
1209;open_circuit;1630;872;1679;919;.\data\pcb_defects_kaggle\Annotations\Open_circuit\07_open_circuit_05;0.5697314049586777;0.4661634565330557;49;47;2904;1921;0.0168732782369146;0.024466423737636647;.\data\pcb_defects_kaggle\images/Open_circuit/07_open_circuit_05.jpg;3
1210;open_circuit;886;862;941;913;.\data\pcb_defects_kaggle\Annotations\Open_circuit\07_open_circuit_05;0.31456611570247933;0.4619989588755856;55;51;2904;1921;0.01893939393939394;0.02654867256637168;.\data\pcb_defects_kaggle\images/Open_circuit/07_open_circuit_05.jpg;3
1211;open_circuit;1932;633;1996;676;.\data\pcb_defects_kaggle\Annotations\Open_circuit\07_open_circuit_05;0.6763085399449036;0.3407079646017699;64;43;2904;1921;0.02203856749311295;0.022384174908901613;.\data\pcb_defects_kaggle\images/Open_circuit/07_open_circuit_05.jpg;3
1212;open_circuit;1520;526;1567;570;.\data\pcb_defects_kaggle\Annotations\Open_circuit\07_open_circuit_05;0.53150826446281;0.28526808953669963;47;44;2904;1921;0.01618457300275482;0.022904737116085372;.\data\pcb_defects_kaggle\images/Open_circuit/07_open_circuit_05.jpg;3
1213;open_circuit;2089;951;2155;994;.\data\pcb_defects_kaggle\Annotations\Open_circuit\07_open_circuit_05;0.7307162534435262;0.5062467464862052;66;43;2904;1921;0.022727272727272728;0.022384174908901613;.\data\pcb_defects_kaggle\images/Open_circuit/07_open_circuit_05.jpg;3
1214;open_circuit;1097;598;1151;655;.\data\pcb_defects_kaggle\Annotations\Open_circuit\07_open_circuit_06;0.38705234159779617;0.32613222280062465;54;57;2904;1921;0.01859504132231405;0.029672045809474232;.\data\pcb_defects_kaggle\images/Open_circuit/07_open_circuit_06.jpg;3
1215;open_circuit;1313;415;1358;458;.\data\pcb_defects_kaggle\Annotations\Open_circuit\07_open_circuit_06;0.4598829201101928;0.22722540343571057;45;43;2904;1921;0.015495867768595042;0.022384174908901613;.\data\pcb_defects_kaggle\images/Open_circuit/07_open_circuit_06.jpg;3
1216;open_circuit;1842;813;1886;862;.\data\pcb_defects_kaggle\Annotations\Open_circuit\07_open_circuit_06;0.6418732782369146;0.4359708485163977;44;49;2904;1921;0.015151515151515152;0.025507548152004164;.\data\pcb_defects_kaggle\images/Open_circuit/07_open_circuit_06.jpg;3
1217;open_circuit;1805;688;1856;732;.\data\pcb_defects_kaggle\Annotations\Open_circuit\07_open_circuit_06;0.6303374655647382;0.36959916710046853;51;44;2904;1921;0.01756198347107438;0.022904737116085372;.\data\pcb_defects_kaggle\images/Open_circuit/07_open_circuit_06.jpg;3
1218;open_circuit;2206;829;2255;877;.\data\pcb_defects_kaggle\Annotations\Open_circuit\07_open_circuit_06;0.7680785123966942;0.444039562727746;49;48;2904;1921;0.0168732782369146;0.024986985944820406;.\data\pcb_defects_kaggle\images/Open_circuit/07_open_circuit_06.jpg;3
1219;open_circuit;1529;626;1591;674;.\data\pcb_defects_kaggle\Annotations\Open_circuit\07_open_circuit_07;0.5371900826446281;0.338365434669443;62;48;2904;1921;0.02134986225895317;0.024986985944820406;.\data\pcb_defects_kaggle\images/Open_circuit/07_open_circuit_07.jpg;3
1220;open_circuit;798;903;848;960;.\data\pcb_defects_kaggle\Annotations\Open_circuit\07_open_circuit_07;0.2834022038567493;0.484903695991671;50;57;2904;1921;0.01721763085399449;0.029672045809474232;.\data\pcb_defects_kaggle\images/Open_circuit/07_open_circuit_07.jpg;3
1221;open_circuit;641;757;717;810;.\data\pcb_defects_kaggle\Annotations\Open_circuit\07_open_circuit_07;0.23381542699724517;0.40786048932847474;76;53;2904;1921;0.026170798898071626;0.027589796980739198;.\data\pcb_defects_kaggle\images/Open_circuit/07_open_circuit_07.jpg;3
1222;open_circuit;1873;210;1941;265;.\data\pcb_defects_kaggle\Annotations\Open_circuit\07_open_circuit_07;0.6566804407713499;0.12363352420614264;68;55;2904;1921;0.023415977961432508;0.028630921395106715;.\data\pcb_defects_kaggle\images/Open_circuit/07_open_circuit_07.jpg;3
1223;open_circuit;2329;443;2389;496;.\data\pcb_defects_kaggle\Annotations\Open_circuit\07_open_circuit_07;0.8123278236914601;0.2444039562727746;60;53;2904;1921;0.02066115702479339;0.027589796980739198;.\data\pcb_defects_kaggle\images/Open_circuit/07_open_circuit_07.jpg;3
1224;open_circuit;1810;681;1861;736;.\data\pcb_defects_kaggle\Annotations\Open_circuit\07_open_circuit_08;0.6320592286501377;0.36881832378969287;51;55;2904;1921;0.01756198347107438;0.028630921395106715;.\data\pcb_defects_kaggle\images/Open_circuit/07_open_circuit_08.jpg;3
1225;open_circuit;2227;824;2272;872;.\data\pcb_defects_kaggle\Annotations\Open_circuit\07_open_circuit_08;0.7746212121212122;0.44143675169182717;45;48;2904;1921;0.015495867768595042;0.024986985944820406;.\data\pcb_defects_kaggle\images/Open_circuit/07_open_circuit_08.jpg;3
1226;open_circuit;1417;641;1473;693;.\data\pcb_defects_kaggle\Annotations\Open_circuit\07_open_circuit_08;0.4975895316804408;0.3472149921915669;56;52;2904;1921;0.01928374655647383;0.02706923477355544;.\data\pcb_defects_kaggle\images/Open_circuit/07_open_circuit_08.jpg;3
1227;open_circuit;710;844;765;915;.\data\pcb_defects_kaggle\Annotations\Open_circuit\07_open_circuit_08;0.2539600550964187;0.45783446121811555;55;71;2904;1921;0.01893939393939394;0.03695991671004685;.\data\pcb_defects_kaggle\images/Open_circuit/07_open_circuit_08.jpg;3
1228;open_circuit;1261;815;1317;862;.\data\pcb_defects_kaggle\Annotations\Open_circuit\07_open_circuit_08;0.44387052341597794;0.43649141072358144;56;47;2904;1921;0.01928374655647383;0.024466423737636647;.\data\pcb_defects_kaggle\images/Open_circuit/07_open_circuit_08.jpg;3
1229;open_circuit;1722;596;1773;639;.\data\pcb_defects_kaggle\Annotations\Open_circuit\07_open_circuit_09;0.6017561983471075;0.32144716293597086;51;43;2904;1921;0.01756198347107438;0.022384174908901613;.\data\pcb_defects_kaggle\images/Open_circuit/07_open_circuit_09.jpg;3
1230;open_circuit;2051;663;2101;713;.\data\pcb_defects_kaggle\Annotations\Open_circuit\07_open_circuit_09;0.7148760330578512;0.3581467985424258;50;50;2904;1921;0.01721763085399449;0.026028110359187923;.\data\pcb_defects_kaggle\images/Open_circuit/07_open_circuit_09.jpg;3
1231;open_circuit;1537;1313;1589;1363;.\data\pcb_defects_kaggle\Annotations\Open_circuit\07_open_circuit_09;0.5382231404958677;0.6965122332118688;52;50;2904;1921;0.01790633608815427;0.026028110359187923;.\data\pcb_defects_kaggle\images/Open_circuit/07_open_circuit_09.jpg;3
1232;open_circuit;1190;405;1248;453;.\data\pcb_defects_kaggle\Annotations\Open_circuit\07_open_circuit_09;0.41976584022038566;0.2233211868818324;58;48;2904;1921;0.01997245179063361;0.024986985944820406;.\data\pcb_defects_kaggle\images/Open_circuit/07_open_circuit_09.jpg;3
1233;open_circuit;355;484;423;538;.\data\pcb_defects_kaggle\Annotations\Open_circuit\07_open_circuit_09;0.13395316804407714;0.26600728787090056;68;54;2904;1921;0.023415977961432508;0.028110359187922956;.\data\pcb_defects_kaggle\images/Open_circuit/07_open_circuit_09.jpg;3
1234;open_circuit;1558;884;1611;929;.\data\pcb_defects_kaggle\Annotations\Open_circuit\07_open_circuit_10;0.5456267217630854;0.471889640812077;53;45;2904;1921;0.01825068870523416;0.02342529932326913;.\data\pcb_defects_kaggle\images/Open_circuit/07_open_circuit_10.jpg;3
1235;open_circuit;2333;1050;2377;1093;.\data\pcb_defects_kaggle\Annotations\Open_circuit\07_open_circuit_10;0.8109504132231405;0.5577824049973972;44;43;2904;1921;0.015151515151515152;0.022384174908901613;.\data\pcb_defects_kaggle\images/Open_circuit/07_open_circuit_10.jpg;3
1236;open_circuit;2339;662;2386;713;.\data\pcb_defects_kaggle\Annotations\Open_circuit\07_open_circuit_10;0.8135330578512396;0.35788651743883393;47;51;2904;1921;0.01618457300275482;0.02654867256637168;.\data\pcb_defects_kaggle\images/Open_circuit/07_open_circuit_10.jpg;3
1237;open_circuit;1066;910;1115;955;.\data\pcb_defects_kaggle\Annotations\Open_circuit\07_open_circuit_10;0.3755165289256198;0.48542425819885476;49;45;2904;1921;0.0168732782369146;0.02342529932326913;.\data\pcb_defects_kaggle\images/Open_circuit/07_open_circuit_10.jpg;3
1238;open_circuit;1317;181;1375;238;.\data\pcb_defects_kaggle\Annotations\Open_circuit\07_open_circuit_10;0.4634986225895317;0.1090577824049974;58;57;2904;1921;0.01997245179063361;0.029672045809474232;.\data\pcb_defects_kaggle\images/Open_circuit/07_open_circuit_10.jpg;3
1239;open_circuit;1571;1188;1614;1241;.\data\pcb_defects_kaggle\Annotations\Open_circuit\08_open_circuit_01;0.5772018847408481;0.5638347260909935;43;53;2759;2154;0.015585357013410656;0.02460538532961931;.\data\pcb_defects_kaggle\images/Open_circuit/08_open_circuit_01.jpg;3
1240;open_circuit;843;926;877;961;.\data\pcb_defects_kaggle\Annotations\Open_circuit\08_open_circuit_01;0.3117071402682131;0.43802228412256267;34;35;2759;2154;0.012323305545487495;0.016248839368616527;.\data\pcb_defects_kaggle\images/Open_circuit/08_open_circuit_01.jpg;3
1241;open_circuit;1541;1821;1593;1868;.\data\pcb_defects_kaggle\Annotations\Open_circuit\08_open_circuit_01;0.5679594055817325;0.856313834726091;52;47;2759;2154;0.018847408481333816;0.02181987000928505;.\data\pcb_defects_kaggle\images/Open_circuit/08_open_circuit_01.jpg;3
1242;open_circuit;1843;996;1890;1037;.\data\pcb_defects_kaggle\Annotations\Open_circuit\08_open_circuit_01;0.6765132294309533;0.47191272051996286;47;41;2759;2154;0.01703515766582095;0.01903435468895079;.\data\pcb_defects_kaggle\images/Open_circuit/08_open_circuit_01.jpg;3
1243;open_circuit;283;1824;313;1871;.\data\pcb_defects_kaggle\Annotations\Open_circuit\08_open_circuit_01;0.10801014860456687;0.8577065923862581;30;47;2759;2154;0.010873504893077202;0.02181987000928505;.\data\pcb_defects_kaggle\images/Open_circuit/08_open_circuit_01.jpg;3
1244;open_circuit;972;929;1027;977;.\data\pcb_defects_kaggle\Annotations\Open_circuit\08_open_circuit_02;0.3622689380210221;0.4424326833797586;55;48;2759;2154;0.019934758970641536;0.022284122562674095;.\data\pcb_defects_kaggle\images/Open_circuit/08_open_circuit_02.jpg;3
1245;open_circuit;884;1243;933;1284;.\data\pcb_defects_kaggle\Annotations\Open_circuit\08_open_circuit_02;0.3292859731786879;0.5865831012070566;49;41;2759;2154;0.017760057992026096;0.01903435468895079;.\data\pcb_defects_kaggle\images/Open_circuit/08_open_circuit_02.jpg;3
1246;open_circuit;281;1816;314;1862;.\data\pcb_defects_kaggle\Annotations\Open_circuit\08_open_circuit_02;0.10782892352301558;0.8537604456824512;33;46;2759;2154;0.011960855382384922;0.02135561745589601;.\data\pcb_defects_kaggle\images/Open_circuit/08_open_circuit_02.jpg;3
1247;open_circuit;2412;1011;2443;1052;.\data\pcb_defects_kaggle\Annotations\Open_circuit\08_open_circuit_02;0.8798477709314969;0.4788765088207985;31;41;2759;2154;0.011235955056179775;0.01903435468895079;.\data\pcb_defects_kaggle\images/Open_circuit/08_open_circuit_02.jpg;3
1248;open_circuit;2019;1322;2054;1369;.\data\pcb_defects_kaggle\Annotations\Open_circuit\08_open_circuit_02;0.7381297571583907;0.6246518105849582;35;47;2759;2154;0.012685755708590069;0.02181987000928505;.\data\pcb_defects_kaggle\images/Open_circuit/08_open_circuit_02.jpg;3
1249;open_circuit;1669;923;1733;964;.\data\pcb_defects_kaggle\Annotations\Open_circuit\08_open_circuit_03;0.6165277274374773;0.43802228412256267;64;41;2759;2154;0.023196810438564697;0.01903435468895079;.\data\pcb_defects_kaggle\images/Open_circuit/08_open_circuit_03.jpg;3
1250;open_circuit;2291;1238;2330;1284;.\data\pcb_defects_kaggle\Annotations\Open_circuit\08_open_circuit_03;0.8374411018484959;0.585422469823584;39;46;2759;2154;0.014135556361000362;0.02135561745589601;.\data\pcb_defects_kaggle\images/Open_circuit/08_open_circuit_03.jpg;3
1251;open_circuit;448;1443;504;1480;.\data\pcb_defects_kaggle\Annotations\Open_circuit\08_open_circuit_03;0.17252627763682493;0.6785051067780873;56;37;2759;2154;0.02029720913374411;0.017177344475394613;.\data\pcb_defects_kaggle\images/Open_circuit/08_open_circuit_03.jpg;3
1252;open_circuit;2548;1647;2605;1702;.\data\pcb_defects_kaggle\Annotations\Open_circuit\08_open_circuit_03;0.9338528452337803;0.7773909006499535;57;55;2759;2154;0.020659659296846683;0.0255338904363974;.\data\pcb_defects_kaggle\images/Open_circuit/08_open_circuit_03.jpg;3
1253;open_circuit;2116;607;2158;642;.\data\pcb_defects_kaggle\Annotations\Open_circuit\08_open_circuit_03;0.7745559985501993;0.28992571959145774;42;35;2759;2154;0.015222906850308082;0.016248839368616527;.\data\pcb_defects_kaggle\images/Open_circuit/08_open_circuit_03.jpg;3
1254;open_circuit;696;1207;745;1243;.\data\pcb_defects_kaggle\Annotations\Open_circuit\08_open_circuit_04;0.2611453425154041;0.5687093779015785;49;36;2759;2154;0.017760057992026096;0.016713091922005572;.\data\pcb_defects_kaggle\images/Open_circuit/08_open_circuit_04.jpg;3
1255;open_circuit;379;987;425;1027;.\data\pcb_defects_kaggle\Annotations\Open_circuit\08_open_circuit_04;0.1457049655672345;0.4675023212627669;46;40;2759;2154;0.016672707502718376;0.018570102135561744;.\data\pcb_defects_kaggle\images/Open_circuit/08_open_circuit_04.jpg;3
1256;open_circuit;1671;936;1730;977;.\data\pcb_defects_kaggle\Annotations\Open_circuit\08_open_circuit_04;0.616346502355926;0.4440575673166202;59;41;2759;2154;0.02138455962305183;0.01903435468895079;.\data\pcb_defects_kaggle\images/Open_circuit/08_open_circuit_04.jpg;3
1257;open_circuit;698;917;750;948;.\data\pcb_defects_kaggle\Annotations\Open_circuit\08_open_circuit_04;0.26241391808626313;0.43291550603528317;52;31;2759;2154;0.018847408481333816;0.014391829155060354;.\data\pcb_defects_kaggle\images/Open_circuit/08_open_circuit_04.jpg;3
1258;open_circuit;2090;1203;2125;1256;.\data\pcb_defects_kaggle\Annotations\Open_circuit\08_open_circuit_04;0.7638637187386734;0.5707985143918292;35;53;2759;2154;0.012685755708590069;0.02460538532961931;.\data\pcb_defects_kaggle\images/Open_circuit/08_open_circuit_04.jpg;3
1259;open_circuit;1262;1340;1290;1390;.\data\pcb_defects_kaggle\Annotations\Open_circuit\08_open_circuit_05;0.46248640811888364;0.6337047353760445;28;50;2759;2154;0.010148604566872055;0.02321262766945218;.\data\pcb_defects_kaggle\images/Open_circuit/08_open_circuit_05.jpg;3
1260;open_circuit;2390;1368;2419;1421;.\data\pcb_defects_kaggle\Annotations\Open_circuit\08_open_circuit_05;0.8715114171801377;0.6474001857010213;29;53;2759;2154;0.010511054729974628;0.02460538532961931;.\data\pcb_defects_kaggle\images/Open_circuit/08_open_circuit_05.jpg;3
1261;open_circuit;2250;1056;2298;1111;.\data\pcb_defects_kaggle\Annotations\Open_circuit\08_open_circuit_05;0.8242116708952519;0.5030176415970288;48;55;2759;2154;0.017397607828923523;0.0255338904363974;.\data\pcb_defects_kaggle\images/Open_circuit/08_open_circuit_05.jpg;3
1262;open_circuit;2167;704;2196;741;.\data\pcb_defects_kaggle\Annotations\Open_circuit\08_open_circuit_05;0.7906850308082639;0.33542246982358404;29;37;2759;2154;0.010511054729974628;0.017177344475394613;.\data\pcb_defects_kaggle\images/Open_circuit/08_open_circuit_05.jpg;3
1263;open_circuit;599;1981;651;2022;.\data\pcb_defects_kaggle\Annotations\Open_circuit\08_open_circuit_05;0.22653135193910837;0.9292014856081708;52;41;2759;2154;0.018847408481333816;0.01903435468895079;.\data\pcb_defects_kaggle\images/Open_circuit/08_open_circuit_05.jpg;3
1264;open_circuit;1940;658;1985;684;.\data\pcb_defects_kaggle\Annotations\Open_circuit\08_open_circuit_06;0.7113084450888003;0.3115134633240483;45;26;2759;2154;0.016310257339615802;0.012070566388115135;.\data\pcb_defects_kaggle\images/Open_circuit/08_open_circuit_06.jpg;3
1265;open_circuit;907;906;951;954;.\data\pcb_defects_kaggle\Annotations\Open_circuit\08_open_circuit_06;0.3367162015222907;0.43175487465181056;44;48;2759;2154;0.01594780717651323;0.022284122562674095;.\data\pcb_defects_kaggle\images/Open_circuit/08_open_circuit_06.jpg;3
1266;open_circuit;379;993;423;1049;.\data\pcb_defects_kaggle\Annotations\Open_circuit\08_open_circuit_06;0.14534251540413193;0.4740018570102136;44;56;2759;2154;0.01594780717651323;0.025998142989786442;.\data\pcb_defects_kaggle\images/Open_circuit/08_open_circuit_06.jpg;3
1267;open_circuit;1838;1302;1885;1338;.\data\pcb_defects_kaggle\Annotations\Open_circuit\08_open_circuit_06;0.6747009786154404;0.6128133704735376;47;36;2759;2154;0.01703515766582095;0.016713091922005572;.\data\pcb_defects_kaggle\images/Open_circuit/08_open_circuit_06.jpg;3
1268;open_circuit;1467;1825;1520;1864;.\data\pcb_defects_kaggle\Annotations\Open_circuit\08_open_circuit_06;0.5413193185936934;0.856313834726091;53;39;2759;2154;0.01920985864443639;0.018105849582172703;.\data\pcb_defects_kaggle\images/Open_circuit/08_open_circuit_06.jpg;3
1269;open_circuit;1959;1179;1990;1225;.\data\pcb_defects_kaggle\Annotations\Open_circuit\08_open_circuit_07;0.7156578470460312;0.5580315691736305;31;46;2759;2154;0.011235955056179775;0.02135561745589601;.\data\pcb_defects_kaggle\images/Open_circuit/08_open_circuit_07.jpg;3
1270;open_circuit;2250;1050;2290;1107;.\data\pcb_defects_kaggle\Annotations\Open_circuit\08_open_circuit_07;0.8227618702428416;0.5006963788300836;40;57;2759;2154;0.014498006524102935;0.026462395543175487;.\data\pcb_defects_kaggle\images/Open_circuit/08_open_circuit_07.jpg;3
1271;open_circuit;2556;1644;2596;1695;.\data\pcb_defects_kaggle\Annotations\Open_circuit\08_open_circuit_07;0.933671620152229;0.7750696378830083;40;51;2759;2154;0.014498006524102935;0.023676880222841225;.\data\pcb_defects_kaggle\images/Open_circuit/08_open_circuit_07.jpg;3
1272;open_circuit;870;1211;914;1243;.\data\pcb_defects_kaggle\Annotations\Open_circuit\08_open_circuit_07;0.32330554548749546;0.5696378830083565;44;32;2759;2154;0.01594780717651323;0.014856081708449397;.\data\pcb_defects_kaggle\images/Open_circuit/08_open_circuit_07.jpg;3
1273;open_circuit;1117;993;1155;1034;.\data\pcb_defects_kaggle\Annotations\Open_circuit\08_open_circuit_07;0.41174338528452337;0.47051996285979575;38;41;2759;2154;0.013773106197897789;0.01903435468895079;.\data\pcb_defects_kaggle\images/Open_circuit/08_open_circuit_07.jpg;3
1274;open_circuit;1545;674;1597;720;.\data\pcb_defects_kaggle\Annotations\Open_circuit\08_open_circuit_08;0.5694092062341428;0.32358402971216343;52;46;2759;2154;0.018847408481333816;0.02135561745589601;.\data\pcb_defects_kaggle\images/Open_circuit/08_open_circuit_08.jpg;3
1275;open_circuit;2234;680;2266;732;.\data\pcb_defects_kaggle\Annotations\Open_circuit\08_open_circuit_08;0.8155128669807902;0.3277623026926648;32;52;2759;2154;0.011598405219282348;0.02414113277623027;.\data\pcb_defects_kaggle\images/Open_circuit/08_open_circuit_08.jpg;3
1276;open_circuit;2409;999;2442;1054;.\data\pcb_defects_kaggle\Annotations\Open_circuit\08_open_circuit_08;0.8791228706052918;0.4765552460538533;33;55;2759;2154;0.011960855382384922;0.0255338904363974;.\data\pcb_defects_kaggle\images/Open_circuit/08_open_circuit_08.jpg;3
1277;open_circuit;1192;1295;1222;1346;.\data\pcb_defects_kaggle\Annotations\Open_circuit\08_open_circuit_08;0.4374773468648061;0.6130454967502321;30;51;2759;2154;0.010873504893077202;0.023676880222841225;.\data\pcb_defects_kaggle\images/Open_circuit/08_open_circuit_08.jpg;3
1278;open_circuit;379;916;424;968;.\data\pcb_defects_kaggle\Annotations\Open_circuit\08_open_circuit_08;0.14552374048568323;0.4373259052924791;45;52;2759;2154;0.016310257339615802;0.02414113277623027;.\data\pcb_defects_kaggle\images/Open_circuit/08_open_circuit_08.jpg;3
1279;open_circuit;1832;632;1876;661;.\data\pcb_defects_kaggle\Annotations\Open_circuit\08_open_circuit_09;0.6719826023921711;0.30013927576601673;44;29;2759;2154;0.01594780717651323;0.013463324048282266;.\data\pcb_defects_kaggle\images/Open_circuit/08_open_circuit_09.jpg;3
1280;open_circuit;2015;781;2060;823;.\data\pcb_defects_kaggle\Annotations\Open_circuit\08_open_circuit_09;0.7384922073214933;0.372330547818013;45;42;2759;2154;0.016310257339615802;0.019498607242339833;.\data\pcb_defects_kaggle\images/Open_circuit/08_open_circuit_09.jpg;3
1281;open_circuit;1336;1197;1397;1261;.\data\pcb_defects_kaggle\Annotations\Open_circuit\08_open_circuit_09;0.4952881478796665;0.5705663881151346;61;64;2759;2154;0.022109459949256977;0.029712163416898793;.\data\pcb_defects_kaggle\images/Open_circuit/08_open_circuit_09.jpg;3
1282;open_circuit;1563;1184;1618;1235;.\data\pcb_defects_kaggle\Annotations\Open_circuit\08_open_circuit_09;0.576476984414643;0.5615134633240483;55;51;2759;2154;0.019934758970641536;0.023676880222841225;.\data\pcb_defects_kaggle\images/Open_circuit/08_open_circuit_09.jpg;3
1283;open_circuit;250;1759;275;1807;.\data\pcb_defects_kaggle\Annotations\Open_circuit\08_open_circuit_09;0.09514316781442551;0.8277623026926648;25;48;2759;2154;0.009061254077564335;0.022284122562674095;.\data\pcb_defects_kaggle\images/Open_circuit/08_open_circuit_09.jpg;3
1284;open_circuit;462;1706;506;1733;.\data\pcb_defects_kaggle\Annotations\Open_circuit\08_open_circuit_10;0.17542587894164552;0.7982822655524605;44;27;2759;2154;0.01594780717651323;0.012534818941504178;.\data\pcb_defects_kaggle\images/Open_circuit/08_open_circuit_10.jpg;3
1285;open_circuit;2368;1644;2446;1693;.\data\pcb_defects_kaggle\Annotations\Open_circuit\08_open_circuit_10;0.8724175425878942;0.7746053853296193;78;49;2759;2154;0.028271112722000724;0.02274837511606314;.\data\pcb_defects_kaggle\images/Open_circuit/08_open_circuit_10.jpg;3
1286;open_circuit;2422;1398;2458;1446;.\data\pcb_defects_kaggle\Annotations\Open_circuit\08_open_circuit_10;0.8843783979702791;0.6601671309192201;36;48;2759;2154;0.013048205871692642;0.022284122562674095;.\data\pcb_defects_kaggle\images/Open_circuit/08_open_circuit_10.jpg;3
1287;open_circuit;1982;1703;2036;1739;.\data\pcb_defects_kaggle\Annotations\Open_circuit\08_open_circuit_10;0.7281623776730699;0.7989786443825441;54;36;2759;2154;0.019572308807538963;0.016713091922005572;.\data\pcb_defects_kaggle\images/Open_circuit/08_open_circuit_10.jpg;3
1288;open_circuit;1952;1176;1994;1224;.\data\pcb_defects_kaggle\Annotations\Open_circuit\08_open_circuit_10;0.7151141718013773;0.5571030640668524;42;48;2759;2154;0.015222906850308082;0.022284122562674095;.\data\pcb_defects_kaggle\images/Open_circuit/08_open_circuit_10.jpg;3
1289;open_circuit;1207;456;1245;500;.\data\pcb_defects_kaggle\Annotations\Open_circuit\09_open_circuit_01;0.4418018018018018;0.22139879573876795;38;44;2775;2159;0.013693693693693694;0.020379805465493284;.\data\pcb_defects_kaggle\images/Open_circuit/09_open_circuit_01.jpg;3
1290;open_circuit;830;953;871;990;.\data\pcb_defects_kaggle\Annotations\Open_circuit\09_open_circuit_01;0.30648648648648646;0.44997684113015285;41;37;2775;2159;0.014774774774774775;0.01713756368689208;.\data\pcb_defects_kaggle\images/Open_circuit/09_open_circuit_01.jpg;3
1291;open_circuit;2210;1048;2253;1090;.\data\pcb_defects_kaggle\Annotations\Open_circuit\09_open_circuit_01;0.8041441441441441;0.4951366373320982;43;42;2775;2159;0.015495495495495495;0.019453450671607225;.\data\pcb_defects_kaggle\images/Open_circuit/09_open_circuit_01.jpg;3
1292;open_circuit;1263;1628;1320;1681;.\data\pcb_defects_kaggle\Annotations\Open_circuit\09_open_circuit_01;0.4654054054054054;0.7663270032422418;57;53;2775;2159;0.02054054054054054;0.024548402037980546;.\data\pcb_defects_kaggle\images/Open_circuit/09_open_circuit_01.jpg;3
1293;open_circuit;1833;1440;1865;1483;.\data\pcb_defects_kaggle\Annotations\Open_circuit\09_open_circuit_01;0.6663063063063063;0.6769337656322372;32;43;2775;2159;0.011531531531531532;0.019916628068550254;.\data\pcb_defects_kaggle\images/Open_circuit/09_open_circuit_01.jpg;3
1294;open_circuit;1726;287;1761;316;.\data\pcb_defects_kaggle\Annotations\Open_circuit\09_open_circuit_02;0.6282882882882883;0.1396479851783233;35;29;2775;2159;0.012612612612612612;0.013432144511347846;.\data\pcb_defects_kaggle\images/Open_circuit/09_open_circuit_02.jpg;3
1295;open_circuit;995;428;1040;468;.\data\pcb_defects_kaggle\Annotations\Open_circuit\09_open_circuit_02;0.36666666666666664;0.20750347383047707;45;40;2775;2159;0.016216216216216217;0.018527095877721167;.\data\pcb_defects_kaggle\images/Open_circuit/09_open_circuit_02.jpg;3
1296;open_circuit;982;906;1036;951;.\data\pcb_defects_kaggle\Annotations\Open_circuit\09_open_circuit_02;0.3636036036036036;0.4300602130616026;54;45;2775;2159;0.01945945945945946;0.020842982862436313;.\data\pcb_defects_kaggle\images/Open_circuit/09_open_circuit_02.jpg;3
1297;open_circuit;1663;1018;1700;1056;.\data\pcb_defects_kaggle\Annotations\Open_circuit\09_open_circuit_02;0.605945945945946;0.48031496062992124;37;38;2775;2159;0.013333333333333334;0.01760074108383511;.\data\pcb_defects_kaggle\images/Open_circuit/09_open_circuit_02.jpg;3
1298;open_circuit;1832;1183;1868;1225;.\data\pcb_defects_kaggle\Annotations\Open_circuit\09_open_circuit_02;0.6666666666666666;0.5576655859194072;36;42;2775;2159;0.012972972972972972;0.019453450671607225;.\data\pcb_defects_kaggle\images/Open_circuit/09_open_circuit_02.jpg;3
1299;open_circuit;2587;976;2633;1056;.\data\pcb_defects_kaggle\Annotations\Open_circuit\09_open_circuit_02;0.9405405405405406;0.47058823529411764;46;80;2775;2159;0.016576576576576577;0.037054191755442334;.\data\pcb_defects_kaggle\images/Open_circuit/09_open_circuit_02.jpg;3
1300;open_circuit;527;810;569;877;.\data\pcb_defects_kaggle\Annotations\Open_circuit\09_open_circuit_03;0.1974774774774775;0.3906901343214451;42;67;2775;2159;0.015135135135135135;0.031032885595182955;.\data\pcb_defects_kaggle\images/Open_circuit/09_open_circuit_03.jpg;3
1301;open_circuit;2212;1040;2252;1083;.\data\pcb_defects_kaggle\Annotations\Open_circuit\09_open_circuit_03;0.8043243243243243;0.49166280685502545;40;43;2775;2159;0.014414414414414415;0.019916628068550254;.\data\pcb_defects_kaggle\images/Open_circuit/09_open_circuit_03.jpg;3
1302;open_circuit;1986;1141;2025;1183;.\data\pcb_defects_kaggle\Annotations\Open_circuit\09_open_circuit_03;0.7227027027027026;0.5382121352477999;39;42;2775;2159;0.014054054054054054;0.019453450671607225;.\data\pcb_defects_kaggle\images/Open_circuit/09_open_circuit_03.jpg;3
1303;open_circuit;2108;1479;2160;1516;.\data\pcb_defects_kaggle\Annotations\Open_circuit\09_open_circuit_03;0.769009009009009;0.6936081519221862;52;37;2775;2159;0.018738738738738738;0.01713756368689208;.\data\pcb_defects_kaggle\images/Open_circuit/09_open_circuit_03.jpg;3
1304;open_circuit;648;1628;689;1681;.\data\pcb_defects_kaggle\Annotations\Open_circuit\09_open_circuit_03;0.2409009009009009;0.7663270032422418;41;53;2775;2159;0.014774774774774775;0.024548402037980546;.\data\pcb_defects_kaggle\images/Open_circuit/09_open_circuit_03.jpg;3
1305;open_circuit;1137;731;1172;772;.\data\pcb_defects_kaggle\Annotations\Open_circuit\09_open_circuit_04;0.41603603603603606;0.34807781380268643;35;41;2775;2159;0.012612612612612612;0.018990273274664196;.\data\pcb_defects_kaggle\images/Open_circuit/09_open_circuit_04.jpg;3
1306;open_circuit;1412;1127;1455;1172;.\data\pcb_defects_kaggle\Annotations\Open_circuit\09_open_circuit_04;0.5165765765765766;0.5324224177860121;43;45;2775;2159;0.015495495495495495;0.020842982862436313;.\data\pcb_defects_kaggle\images/Open_circuit/09_open_circuit_04.jpg;3
1307;open_circuit;784;1124;826;1163;.\data\pcb_defects_kaggle\Annotations\Open_circuit\09_open_circuit_04;0.29009009009009007;0.5296433534043539;42;39;2775;2159;0.015135135135135135;0.018063918480778138;.\data\pcb_defects_kaggle\images/Open_circuit/09_open_circuit_04.jpg;3
1308;open_circuit;2077;776;2149;830;.\data\pcb_defects_kaggle\Annotations\Open_circuit\09_open_circuit_04;0.7614414414414414;0.37193144974525244;72;54;2775;2159;0.025945945945945945;0.025011579434923575;.\data\pcb_defects_kaggle\images/Open_circuit/09_open_circuit_04.jpg;3
1309;open_circuit;1863;599;1897;643;.\data\pcb_defects_kaggle\Annotations\Open_circuit\09_open_circuit_04;0.6774774774774774;0.2876331635016211;34;44;2775;2159;0.012252252252252252;0.020379805465493284;.\data\pcb_defects_kaggle\images/Open_circuit/09_open_circuit_04.jpg;3
1310;open_circuit;1197;431;1256;492;.\data\pcb_defects_kaggle\Annotations\Open_circuit\09_open_circuit_05;0.44198198198198196;0.21375636868920797;59;61;2775;2159;0.021261261261261263;0.02825382121352478;.\data\pcb_defects_kaggle\images/Open_circuit/09_open_circuit_05.jpg;3
1311;open_circuit;2007;304;2054;346;.\data\pcb_defects_kaggle\Annotations\Open_circuit\09_open_circuit_05;0.7317117117117117;0.1505326540064845;47;42;2775;2159;0.016936936936936937;0.019453450671607225;.\data\pcb_defects_kaggle\images/Open_circuit/09_open_circuit_05.jpg;3
1312;open_circuit;2210;1030;2254;1076;.\data\pcb_defects_kaggle\Annotations\Open_circuit\09_open_circuit_05;0.8043243243243243;0.4877257989810097;44;46;2775;2159;0.015855855855855857;0.021306160259379342;.\data\pcb_defects_kaggle\images/Open_circuit/09_open_circuit_05.jpg;3
1313;open_circuit;1671;1019;1711;1058;.\data\pcb_defects_kaggle\Annotations\Open_circuit\09_open_circuit_05;0.6093693693693694;0.4810097267253358;40;39;2775;2159;0.014414414414414415;0.018063918480778138;.\data\pcb_defects_kaggle\images/Open_circuit/09_open_circuit_05.jpg;3
1314;open_circuit;1627;1125;1663;1163;.\data\pcb_defects_kaggle\Annotations\Open_circuit\09_open_circuit_05;0.5927927927927928;0.5298749421028254;36;38;2775;2159;0.012972972972972972;0.01760074108383511;.\data\pcb_defects_kaggle\images/Open_circuit/09_open_circuit_05.jpg;3
1315;open_circuit;1395;735;1446;769;.\data\pcb_defects_kaggle\Annotations\Open_circuit\09_open_circuit_06;0.5118918918918919;0.34830940250115794;51;34;2775;2159;0.018378378378378378;0.015748031496062992;.\data\pcb_defects_kaggle\images/Open_circuit/09_open_circuit_06.jpg;3
1316;open_circuit;1196;866;1254;909;.\data\pcb_defects_kaggle\Annotations\Open_circuit\09_open_circuit_06;0.44144144144144143;0.4110699397869384;58;43;2775;2159;0.020900900900900903;0.019916628068550254;.\data\pcb_defects_kaggle\images/Open_circuit/09_open_circuit_06.jpg;3
1317;open_circuit;1061;1127;1103;1162;.\data\pcb_defects_kaggle\Annotations\Open_circuit\09_open_circuit_06;0.3899099099099099;0.5301065308012969;42;35;2775;2159;0.015135135135135135;0.01621120889300602;.\data\pcb_defects_kaggle\images/Open_circuit/09_open_circuit_06.jpg;3
1318;open_circuit;2320;570;2365;620;.\data\pcb_defects_kaggle\Annotations\Open_circuit\09_open_circuit_06;0.8441441441441442;0.2755905511811024;45;50;2775;2159;0.016216216216216217;0.02315886984715146;.\data\pcb_defects_kaggle\images/Open_circuit/09_open_circuit_06.jpg;3
1319;open_circuit;1619;1289;1655;1328;.\data\pcb_defects_kaggle\Annotations\Open_circuit\09_open_circuit_06;0.5899099099099099;0.6060676238999537;36;39;2775;2159;0.012972972972972972;0.018063918480778138;.\data\pcb_defects_kaggle\images/Open_circuit/09_open_circuit_06.jpg;3
1320;open_circuit;1827;1477;1877;1521;.\data\pcb_defects_kaggle\Annotations\Open_circuit\09_open_circuit_07;0.6673873873873873;0.6943029180176007;50;44;2775;2159;0.018018018018018018;0.020379805465493284;.\data\pcb_defects_kaggle\images/Open_circuit/09_open_circuit_07.jpg;3
1321;open_circuit;2216;1033;2252;1078;.\data\pcb_defects_kaggle\Annotations\Open_circuit\09_open_circuit_07;0.805045045045045;0.4888837424733673;36;45;2775;2159;0.012972972972972972;0.020842982862436313;.\data\pcb_defects_kaggle\images/Open_circuit/09_open_circuit_07.jpg;3
1322;open_circuit;2292;1808;2338;1848;.\data\pcb_defects_kaggle\Annotations\Open_circuit\09_open_circuit_07;0.8342342342342343;0.8466882816118574;46;40;2775;2159;0.016576576576576577;0.018527095877721167;.\data\pcb_defects_kaggle\images/Open_circuit/09_open_circuit_07.jpg;3
1323;open_circuit;349;1681;416;1736;.\data\pcb_defects_kaggle\Annotations\Open_circuit\09_open_circuit_07;0.13783783783783785;0.7913385826771654;67;55;2775;2159;0.024144144144144144;0.025474756831866605;.\data\pcb_defects_kaggle\images/Open_circuit/09_open_circuit_07.jpg;3
1324;open_circuit;2412;1566;2455;1601;.\data\pcb_defects_kaggle\Annotations\Open_circuit\09_open_circuit_07;0.876936936936937;0.7334414080592867;43;35;2775;2159;0.015495495495495495;0.01621120889300602;.\data\pcb_defects_kaggle\images/Open_circuit/09_open_circuit_07.jpg;3
1325;open_circuit;868;567;911;604;.\data\pcb_defects_kaggle\Annotations\Open_circuit\09_open_circuit_08;0.32054054054054054;0.27119036591014356;43;37;2775;2159;0.015495495495495495;0.01713756368689208;.\data\pcb_defects_kaggle\images/Open_circuit/09_open_circuit_08.jpg;3
1326;open_circuit;1629;1127;1674;1163;.\data\pcb_defects_kaggle\Annotations\Open_circuit\09_open_circuit_08;0.5951351351351352;0.5303381194997684;45;36;2775;2159;0.016216216216216217;0.01667438628994905;.\data\pcb_defects_kaggle\images/Open_circuit/09_open_circuit_08.jpg;3
1327;open_circuit;2246;1188;2281;1226;.\data\pcb_defects_kaggle\Annotations\Open_circuit\09_open_circuit_08;0.8156756756756757;0.5590551181102362;35;38;2775;2159;0.012612612612612612;0.01760074108383511;.\data\pcb_defects_kaggle\images/Open_circuit/09_open_circuit_08.jpg;3
1328;open_circuit;1669;555;1710;597;.\data\pcb_defects_kaggle\Annotations\Open_circuit\09_open_circuit_08;0.6088288288288288;0.2667901806391848;41;42;2775;2159;0.014774774774774775;0.019453450671607225;.\data\pcb_defects_kaggle\images/Open_circuit/09_open_circuit_08.jpg;3
1329;open_circuit;1980;185;2024;241;.\data\pcb_defects_kaggle\Annotations\Open_circuit\09_open_circuit_08;0.7214414414414414;0.09865678554886521;44;56;2775;2159;0.015855855855855857;0.025937934228809634;.\data\pcb_defects_kaggle\images/Open_circuit/09_open_circuit_08.jpg;3
1330;open_circuit;1622;262;1674;293;.\data\pcb_defects_kaggle\Annotations\Open_circuit\09_open_circuit_09;0.5938738738738739;0.1285317276516906;52;31;2775;2159;0.018738738738738738;0.014358499305233904;.\data\pcb_defects_kaggle\images/Open_circuit/09_open_circuit_09.jpg;3
1331;open_circuit;1344;487;1387;530;.\data\pcb_defects_kaggle\Annotations\Open_circuit\09_open_circuit_09;0.4920720720720721;0.23552570634553033;43;43;2775;2159;0.015495495495495495;0.019916628068550254;.\data\pcb_defects_kaggle\images/Open_circuit/09_open_circuit_09.jpg;3
1332;open_circuit;773;903;836;939;.\data\pcb_defects_kaggle\Annotations\Open_circuit\09_open_circuit_09;0.2899099099099099;0.42658638258452986;63;36;2775;2159;0.022702702702702703;0.01667438628994905;.\data\pcb_defects_kaggle\images/Open_circuit/09_open_circuit_09.jpg;3
1333;open_circuit;2285;1068;2332;1104;.\data\pcb_defects_kaggle\Annotations\Open_circuit\09_open_circuit_09;0.8318918918918919;0.5030106530801297;47;36;2775;2159;0.016936936936936937;0.01667438628994905;.\data\pcb_defects_kaggle\images/Open_circuit/09_open_circuit_09.jpg;3
1334;open_circuit;1135;1125;1176;1161;.\data\pcb_defects_kaggle\Annotations\Open_circuit\09_open_circuit_09;0.4163963963963964;0.5294117647058824;41;36;2775;2159;0.014774774774774775;0.01667438628994905;.\data\pcb_defects_kaggle\images/Open_circuit/09_open_circuit_09.jpg;3
1335;open_circuit;1276;464;1317;515;.\data\pcb_defects_kaggle\Annotations\Open_circuit\09_open_circuit_10;0.4672072072072072;0.2267253358036128;41;51;2775;2159;0.014774774774774775;0.023622047244094488;.\data\pcb_defects_kaggle\images/Open_circuit/09_open_circuit_10.jpg;3
1336;open_circuit;1625;541;1664;586;.\data\pcb_defects_kaggle\Annotations\Open_circuit\09_open_circuit_10;0.5926126126126127;0.26100046317739695;39;45;2775;2159;0.014054054054054054;0.020842982862436313;.\data\pcb_defects_kaggle\images/Open_circuit/09_open_circuit_10.jpg;3
1337;open_circuit;1131;576;1179;628;.\data\pcb_defects_kaggle\Annotations\Open_circuit\09_open_circuit_10;0.41621621621621624;0.2788327929597036;48;52;2775;2159;0.017297297297297298;0.024085224641037517;.\data\pcb_defects_kaggle\images/Open_circuit/09_open_circuit_10.jpg;3
1338;open_circuit;1310;1494;1367;1535;.\data\pcb_defects_kaggle\Annotations\Open_circuit\09_open_circuit_10;0.48234234234234236;0.7014821676702176;57;41;2775;2159;0.02054054054054054;0.018990273274664196;.\data\pcb_defects_kaggle\images/Open_circuit/09_open_circuit_10.jpg;3
1339;open_circuit;2094;777;2158;829;.\data\pcb_defects_kaggle\Annotations\Open_circuit\09_open_circuit_10;0.7661261261261261;0.37193144974525244;64;52;2775;2159;0.023063063063063063;0.024085224641037517;.\data\pcb_defects_kaggle\images/Open_circuit/09_open_circuit_10.jpg;3
1340;open_circuit;972;470;1033;522;.\data\pcb_defects_kaggle\Annotations\Open_circuit\10_open_circuit_01;0.44754464285714285;0.24603174603174602;61;52;2240;2016;0.027232142857142858;0.025793650793650792;.\data\pcb_defects_kaggle\images/Open_circuit/10_open_circuit_01.jpg;3
1341;open_circuit;1663;571;1752;637;.\data\pcb_defects_kaggle\Annotations\Open_circuit\10_open_circuit_01;0.7622767857142857;0.2996031746031746;89;66;2240;2016;0.039732142857142855;0.03273809523809524;.\data\pcb_defects_kaggle\images/Open_circuit/10_open_circuit_01.jpg;3
1342;open_circuit;1221;1083;1274;1164;.\data\pcb_defects_kaggle\Annotations\Open_circuit\10_open_circuit_01;0.5569196428571429;0.5572916666666666;53;81;2240;2016;0.023660714285714285;0.04017857142857143;.\data\pcb_defects_kaggle\images/Open_circuit/10_open_circuit_01.jpg;3
1343;open_circuit;1490;1341;1581;1399;.\data\pcb_defects_kaggle\Annotations\Open_circuit\10_open_circuit_01;0.6854910714285715;0.6795634920634921;91;58;2240;2016;0.040625;0.028769841269841268;.\data\pcb_defects_kaggle\images/Open_circuit/10_open_circuit_01.jpg;3
1344;open_circuit;1781;1642;1845;1711;.\data\pcb_defects_kaggle\Annotations\Open_circuit\10_open_circuit_01;0.809375;0.8315972222222222;64;69;2240;2016;0.02857142857142857;0.03422619047619048;.\data\pcb_defects_kaggle\images/Open_circuit/10_open_circuit_01.jpg;3
1345;open_circuit;1291;573;1372;629;.\data\pcb_defects_kaggle\Annotations\Open_circuit\10_open_circuit_02;0.5944196428571429;0.29811507936507936;81;56;2240;2016;0.03616071428571429;0.027777777777777776;.\data\pcb_defects_kaggle\images/Open_circuit/10_open_circuit_02.jpg;3
1346;open_circuit;1537;187;1591;253;.\data\pcb_defects_kaggle\Annotations\Open_circuit\10_open_circuit_02;0.6982142857142857;0.10912698412698413;54;66;2240;2016;0.024107142857142858;0.03273809523809524;.\data\pcb_defects_kaggle\images/Open_circuit/10_open_circuit_02.jpg;3
1347;open_circuit;1978;537;2040;587;.\data\pcb_defects_kaggle\Annotations\Open_circuit\10_open_circuit_02;0.896875;0.2787698412698413;62;50;2240;2016;0.027678571428571427;0.0248015873015873;.\data\pcb_defects_kaggle\images/Open_circuit/10_open_circuit_02.jpg;3
1348;open_circuit;2005;1321;2108;1373;.\data\pcb_defects_kaggle\Annotations\Open_circuit\10_open_circuit_02;0.9180803571428572;0.6681547619047619;103;52;2240;2016;0.04598214285714286;0.025793650793650792;.\data\pcb_defects_kaggle\images/Open_circuit/10_open_circuit_02.jpg;3
1349;open_circuit;1805;1111;1885;1164;.\data\pcb_defects_kaggle\Annotations\Open_circuit\10_open_circuit_02;0.8236607142857143;0.5642361111111112;80;53;2240;2016;0.03571428571428571;0.02628968253968254;.\data\pcb_defects_kaggle\images/Open_circuit/10_open_circuit_02.jpg;3
1350;open_circuit;969;434;1037;483;.\data\pcb_defects_kaggle\Annotations\Open_circuit\10_open_circuit_03;0.44776785714285716;0.22743055555555555;68;49;2240;2016;0.030357142857142857;0.024305555555555556;.\data\pcb_defects_kaggle\images/Open_circuit/10_open_circuit_03.jpg;3
1351;open_circuit;1116;683;1195;738;.\data\pcb_defects_kaggle\Annotations\Open_circuit\10_open_circuit_03;0.5158482142857143;0.3524305555555556;79;55;2240;2016;0.03526785714285714;0.027281746031746032;.\data\pcb_defects_kaggle\images/Open_circuit/10_open_circuit_03.jpg;3
1352;open_circuit;1521;593;1630;651;.\data\pcb_defects_kaggle\Annotations\Open_circuit\10_open_circuit_03;0.7033482142857143;0.30853174603174605;109;58;2240;2016;0.048660714285714286;0.028769841269841268;.\data\pcb_defects_kaggle\images/Open_circuit/10_open_circuit_03.jpg;3
1353;open_circuit;1865;735;1956;796;.\data\pcb_defects_kaggle\Annotations\Open_circuit\10_open_circuit_03;0.8529017857142858;0.37971230158730157;91;61;2240;2016;0.040625;0.030257936507936508;.\data\pcb_defects_kaggle\images/Open_circuit/10_open_circuit_03.jpg;3
1354;open_circuit;1245;445;1325;519;.\data\pcb_defects_kaggle\Annotations\Open_circuit\10_open_circuit_03;0.5736607142857143;0.2390873015873016;80;74;2240;2016;0.03571428571428571;0.03670634920634921;.\data\pcb_defects_kaggle\images/Open_circuit/10_open_circuit_03.jpg;3
1355;open_circuit;1291;573;1375;631;.\data\pcb_defects_kaggle\Annotations\Open_circuit\10_open_circuit_04;0.5950892857142858;0.2986111111111111;84;58;2240;2016;0.0375;0.028769841269841268;.\data\pcb_defects_kaggle\images/Open_circuit/10_open_circuit_04.jpg;3
1356;open_circuit;1839;600;1932;669;.\data\pcb_defects_kaggle\Annotations\Open_circuit\10_open_circuit_04;0.8417410714285715;0.31473214285714285;93;69;2240;2016;0.04151785714285714;0.03422619047619048;.\data\pcb_defects_kaggle\images/Open_circuit/10_open_circuit_04.jpg;3
1357;open_circuit;1016;1045;1110;1102;.\data\pcb_defects_kaggle\Annotations\Open_circuit\10_open_circuit_04;0.4745535714285714;0.5324900793650794;94;57;2240;2016;0.04196428571428571;0.028273809523809524;.\data\pcb_defects_kaggle\images/Open_circuit/10_open_circuit_04.jpg;3
1358;open_circuit;755;847;839;924;.\data\pcb_defects_kaggle\Annotations\Open_circuit\10_open_circuit_04;0.35580357142857144;0.4392361111111111;84;77;2240;2016;0.0375;0.03819444444444445;.\data\pcb_defects_kaggle\images/Open_circuit/10_open_circuit_04.jpg;3
1359;open_circuit;1510;947;1603;1022;.\data\pcb_defects_kaggle\Annotations\Open_circuit\10_open_circuit_04;0.6948660714285714;0.48834325396825395;93;75;2240;2016;0.04151785714285714;0.03720238095238095;.\data\pcb_defects_kaggle\images/Open_circuit/10_open_circuit_04.jpg;3
1360;open_circuit;1148;409;1201;486;.\data\pcb_defects_kaggle\Annotations\Open_circuit\10_open_circuit_05;0.5243303571428571;0.22197420634920634;53;77;2240;2016;0.023660714285714285;0.03819444444444445;.\data\pcb_defects_kaggle\images/Open_circuit/10_open_circuit_05.jpg;3
1361;open_circuit;1277;587;1374;647;.\data\pcb_defects_kaggle\Annotations\Open_circuit\10_open_circuit_05;0.5917410714285715;0.3060515873015873;97;60;2240;2016;0.04330357142857143;0.02976190476190476;.\data\pcb_defects_kaggle\images/Open_circuit/10_open_circuit_05.jpg;3
1362;open_circuit;1827;408;1890;486;.\data\pcb_defects_kaggle\Annotations\Open_circuit\10_open_circuit_05;0.8296875;0.22172619047619047;63;78;2240;2016;0.028125;0.03869047619047619;.\data\pcb_defects_kaggle\images/Open_circuit/10_open_circuit_05.jpg;3
1363;open_circuit;1255;879;1353;944;.\data\pcb_defects_kaggle\Annotations\Open_circuit\10_open_circuit_05;0.5821428571428572;0.4521329365079365;98;65;2240;2016;0.04375;0.032242063492063495;.\data\pcb_defects_kaggle\images/Open_circuit/10_open_circuit_05.jpg;3
1364;open_circuit;1737;754;1794;837;.\data\pcb_defects_kaggle\Annotations\Open_circuit\10_open_circuit_05;0.7881696428571429;0.39459325396825395;57;83;2240;2016;0.02544642857142857;0.04117063492063492;.\data\pcb_defects_kaggle\images/Open_circuit/10_open_circuit_05.jpg;3
1365;open_circuit;1346;938;1398;1022;.\data\pcb_defects_kaggle\Annotations\Open_circuit\10_open_circuit_06;0.6125;0.4861111111111111;52;84;2240;2016;0.023214285714285715;0.041666666666666664;.\data\pcb_defects_kaggle\images/Open_circuit/10_open_circuit_06.jpg;3
1366;open_circuit;1014;1166;1113;1224;.\data\pcb_defects_kaggle\Annotations\Open_circuit\10_open_circuit_06;0.4747767857142857;0.5927579365079365;99;58;2240;2016;0.044196428571428574;0.028769841269841268;.\data\pcb_defects_kaggle\images/Open_circuit/10_open_circuit_06.jpg;3
1367;open_circuit;858;1534;930;1618;.\data\pcb_defects_kaggle\Annotations\Open_circuit\10_open_circuit_06;0.3991071428571429;0.7817460317460317;72;84;2240;2016;0.03214285714285714;0.041666666666666664;.\data\pcb_defects_kaggle\images/Open_circuit/10_open_circuit_06.jpg;3
1368;open_circuit;1670;1570;1776;1644;.\data\pcb_defects_kaggle\Annotations\Open_circuit\10_open_circuit_06;0.7691964285714286;0.7971230158730159;106;74;2240;2016;0.04732142857142857;0.03670634920634921;.\data\pcb_defects_kaggle\images/Open_circuit/10_open_circuit_06.jpg;3
1369;open_circuit;1962;1685;2049;1777;.\data\pcb_defects_kaggle\Annotations\Open_circuit\10_open_circuit_06;0.8953125;0.8586309523809523;87;92;2240;2016;0.038839285714285715;0.04563492063492063;.\data\pcb_defects_kaggle\images/Open_circuit/10_open_circuit_06.jpg;3
1370;open_circuit;857;349;925;394;.\data\pcb_defects_kaggle\Annotations\Open_circuit\11_open_circuit_01;0.3904469763365469;0.1652580071174377;68;45;2282;2248;0.029798422436459245;0.02001779359430605;.\data\pcb_defects_kaggle\images/Open_circuit/11_open_circuit_01.jpg;3
1371;open_circuit;1037;540;1104;603;.\data\pcb_defects_kaggle\Annotations\Open_circuit\11_open_circuit_01;0.46910604732690625;0.2542259786476868;67;63;2282;2248;0.029360210341805432;0.02802491103202847;.\data\pcb_defects_kaggle\images/Open_circuit/11_open_circuit_01.jpg;3
1372;open_circuit;598;856;659;912;.\data\pcb_defects_kaggle\Annotations\Open_circuit\11_open_circuit_01;0.27541630148992113;0.3932384341637011;61;56;2282;2248;0.02673093777388256;0.02491103202846975;.\data\pcb_defects_kaggle\images/Open_circuit/11_open_circuit_01.jpg;3
1373;open_circuit;1230;901;1296;957;.\data\pcb_defects_kaggle\Annotations\Open_circuit\11_open_circuit_01;0.5534618755477652;0.41325622775800713;66;56;2282;2248;0.028921998247151623;0.02491103202846975;.\data\pcb_defects_kaggle\images/Open_circuit/11_open_circuit_01.jpg;3
1374;open_circuit;1137;1509;1178;1560;.\data\pcb_defects_kaggle\Annotations\Open_circuit\11_open_circuit_01;0.5072304995617879;0.6826067615658363;41;51;2282;2248;0.01796669588080631;0.022686832740213523;.\data\pcb_defects_kaggle\images/Open_circuit/11_open_circuit_01.jpg;3
1375;open_circuit;1306;339;1396;411;.\data\pcb_defects_kaggle\Annotations\Open_circuit\11_open_circuit_02;0.5920245398773006;0.16681494661921709;90;72;2282;2248;0.03943908851884312;0.03202846975088968;.\data\pcb_defects_kaggle\images/Open_circuit/11_open_circuit_02.jpg;3
1376;open_circuit;671;891;732;953;.\data\pcb_defects_kaggle\Annotations\Open_circuit\11_open_circuit_02;0.30740578439964944;0.4101423487544484;61;62;2282;2248;0.02673093777388256;0.027580071174377226;.\data\pcb_defects_kaggle\images/Open_circuit/11_open_circuit_02.jpg;3
1377;open_circuit;1529;763;1604;837;.\data\pcb_defects_kaggle\Annotations\Open_circuit\11_open_circuit_02;0.6864592462751972;0.35587188612099646;75;74;2282;2248;0.03286590709903593;0.03291814946619217;.\data\pcb_defects_kaggle\images/Open_circuit/11_open_circuit_02.jpg;3
1378;open_circuit;1075;1508;1135;1580;.\data\pcb_defects_kaggle\Annotations\Open_circuit\11_open_circuit_02;0.48422436459246276;0.6868327402135231;60;72;2282;2248;0.026292725679228746;0.03202846975088968;.\data\pcb_defects_kaggle\images/Open_circuit/11_open_circuit_02.jpg;3
1379;open_circuit;1643;1624;1702;1696;.\data\pcb_defects_kaggle\Annotations\Open_circuit\11_open_circuit_02;0.7329097283085013;0.7384341637010676;59;72;2282;2248;0.025854513584574933;0.03202846975088968;.\data\pcb_defects_kaggle\images/Open_circuit/11_open_circuit_02.jpg;3
1380;open_circuit;1788;1926;1852;1996;.\data\pcb_defects_kaggle\Annotations\Open_circuit\11_open_circuit_02;0.7975460122699386;0.8723309608540926;64;70;2282;2248;0.028045574057843997;0.03113879003558719;.\data\pcb_defects_kaggle\images/Open_circuit/11_open_circuit_02.jpg;3
1381;open_circuit;866;376;922;422;.\data\pcb_defects_kaggle\Annotations\Open_circuit\11_open_circuit_03;0.39176161262050835;0.17749110320284697;56;46;2282;2248;0.024539877300613498;0.020462633451957295;.\data\pcb_defects_kaggle\images/Open_circuit/11_open_circuit_03.jpg;3
1382;open_circuit;1504;1075;1583;1137;.\data\pcb_defects_kaggle\Annotations\Open_circuit\11_open_circuit_03;0.6763803680981595;0.4919928825622776;79;62;2282;2248;0.034618755477651184;0.027580071174377226;.\data\pcb_defects_kaggle\images/Open_circuit/11_open_circuit_03.jpg;3
1383;open_circuit;963;1113;1024;1163;.\data\pcb_defects_kaggle\Annotations\Open_circuit\11_open_circuit_03;0.43536371603856266;0.5062277580071174;61;50;2282;2248;0.02673093777388256;0.02224199288256228;.\data\pcb_defects_kaggle\images/Open_circuit/11_open_circuit_03.jpg;3
1384;open_circuit;1076;1476;1135;1534;.\data\pcb_defects_kaggle\Annotations\Open_circuit\11_open_circuit_03;0.48444347063978965;0.6694839857651246;59;58;2282;2248;0.025854513584574933;0.025800711743772242;.\data\pcb_defects_kaggle\images/Open_circuit/11_open_circuit_03.jpg;3
1385;open_circuit;1319;1673;1371;1722;.\data\pcb_defects_kaggle\Annotations\Open_circuit\11_open_circuit_03;0.5893952673093777;0.7551156583629893;52;49;2282;2248;0.022787028921998246;0.02179715302491103;.\data\pcb_defects_kaggle\images/Open_circuit/11_open_circuit_03.jpg;3
1386;open_circuit;1258;386;1329;449;.\data\pcb_defects_kaggle\Annotations\Open_circuit\11_open_circuit_04;0.5668273444347064;0.18572064056939502;71;63;2282;2248;0.031113058720420684;0.02802491103202847;.\data\pcb_defects_kaggle\images/Open_circuit/11_open_circuit_04.jpg;3
1387;open_circuit;1061;93;1157;172;.\data\pcb_defects_kaggle\Annotations\Open_circuit\11_open_circuit_04;0.485977212971078;0.05894128113879003;96;79;2282;2248;0.042068361086765996;0.035142348754448396;.\data\pcb_defects_kaggle\images/Open_circuit/11_open_circuit_04.jpg;3
1388;open_circuit;1196;839;1266;893;.\data\pcb_defects_kaggle\Annotations\Open_circuit\11_open_circuit_04;0.5394390885188431;0.38523131672597866;70;54;2282;2248;0.03067484662576687;0.02402135231316726;.\data\pcb_defects_kaggle\images/Open_circuit/11_open_circuit_04.jpg;3
1389;open_circuit;1512;1085;1576;1131;.\data\pcb_defects_kaggle\Annotations\Open_circuit\11_open_circuit_04;0.6765994741454864;0.4928825622775801;64;46;2282;2248;0.028045574057843997;0.020462633451957295;.\data\pcb_defects_kaggle\images/Open_circuit/11_open_circuit_04.jpg;3
1390;open_circuit;1435;888;1501;940;.\data\pcb_defects_kaggle\Annotations\Open_circuit\11_open_circuit_04;0.6432953549517967;0.40658362989323843;66;52;2282;2248;0.028921998247151623;0.023131672597864767;.\data\pcb_defects_kaggle\images/Open_circuit/11_open_circuit_04.jpg;3
1391;open_circuit;752;124;809;186;.\data\pcb_defects_kaggle\Annotations\Open_circuit\11_open_circuit_05;0.34202453987730064;0.06895017793594306;57;62;2282;2248;0.02497808939526731;0.027580071174377226;.\data\pcb_defects_kaggle\images/Open_circuit/11_open_circuit_05.jpg;3
1392;open_circuit;970;383;1025;435;.\data\pcb_defects_kaggle\Annotations\Open_circuit\11_open_circuit_05;0.4371165644171779;0.18193950177935944;55;52;2282;2248;0.024101665205959685;0.023131672597864767;.\data\pcb_defects_kaggle\images/Open_circuit/11_open_circuit_05.jpg;3
1393;open_circuit;1509;970;1573;1053;.\data\pcb_defects_kaggle\Annotations\Open_circuit\11_open_circuit_05;0.6752848378615249;0.4499555160142349;64;83;2282;2248;0.028045574057843997;0.03692170818505338;.\data\pcb_defects_kaggle\images/Open_circuit/11_open_circuit_05.jpg;3
1394;open_circuit;624;1160;683;1229;.\data\pcb_defects_kaggle\Annotations\Open_circuit\11_open_circuit_05;0.2863716038562664;0.5313612099644128;59;69;2282;2248;0.025854513584574933;0.03069395017793594;.\data\pcb_defects_kaggle\images/Open_circuit/11_open_circuit_05.jpg;3
1395;open_circuit;1080;1467;1137;1526;.\data\pcb_defects_kaggle\Annotations\Open_circuit\11_open_circuit_05;0.4857581069237511;0.665702846975089;57;59;2282;2248;0.02497808939526731;0.026245551601423486;.\data\pcb_defects_kaggle\images/Open_circuit/11_open_circuit_05.jpg;3
1396;open_circuit;488;740;540;816;.\data\pcb_defects_kaggle\Annotations\Open_circuit\11_open_circuit_06;0.2252410166520596;0.34608540925266906;52;76;2282;2248;0.022787028921998246;0.033807829181494664;.\data\pcb_defects_kaggle\images/Open_circuit/11_open_circuit_06.jpg;3
1397;open_circuit;920;1201;971;1252;.\data\pcb_defects_kaggle\Annotations\Open_circuit\11_open_circuit_06;0.41432953549517965;0.5455960854092526;51;51;2282;2248;0.022348816827344433;0.022686832740213523;.\data\pcb_defects_kaggle\images/Open_circuit/11_open_circuit_06.jpg;3
1398;open_circuit;1876;1804;1939;1873;.\data\pcb_defects_kaggle\Annotations\Open_circuit\11_open_circuit_06;0.8358895705521472;0.817838078291815;63;69;2282;2248;0.027607361963190184;0.03069395017793594;.\data\pcb_defects_kaggle\images/Open_circuit/11_open_circuit_06.jpg;3
1399;open_circuit;543;1862;596;1914;.\data\pcb_defects_kaggle\Annotations\Open_circuit\11_open_circuit_06;0.2495617879053462;0.8398576512455516;53;52;2282;2248;0.02322524101665206;0.023131672597864767;.\data\pcb_defects_kaggle\images/Open_circuit/11_open_circuit_06.jpg;3
1400;open_circuit;740;1845;793;1901;.\data\pcb_defects_kaggle\Annotations\Open_circuit\11_open_circuit_06;0.33588957055214724;0.833185053380783;53;56;2282;2248;0.02322524101665206;0.02491103202846975;.\data\pcb_defects_kaggle\images/Open_circuit/11_open_circuit_06.jpg;3
1401;open_circuit;1029;534;1098;586;.\data\pcb_defects_kaggle\Annotations\Open_circuit\11_open_circuit_07;0.4660385626643295;0.2491103202846975;69;52;2282;2248;0.030236634531113058;0.023131672597864767;.\data\pcb_defects_kaggle\images/Open_circuit/11_open_circuit_07.jpg;3
1402;open_circuit;955;690;1035;735;.\data\pcb_defects_kaggle\Annotations\Open_circuit\11_open_circuit_07;0.4360210341805434;0.31694839857651247;80;45;2282;2248;0.035056967572304996;0.02001779359430605;.\data\pcb_defects_kaggle\images/Open_circuit/11_open_circuit_07.jpg;3
1403;open_circuit;758;860;799;919;.\data\pcb_defects_kaggle\Annotations\Open_circuit\11_open_circuit_07;0.34114811568799297;0.3956850533807829;41;59;2282;2248;0.01796669588080631;0.026245551601423486;.\data\pcb_defects_kaggle\images/Open_circuit/11_open_circuit_07.jpg;3
1404;open_circuit;1190;1198;1239;1247;.\data\pcb_defects_kaggle\Annotations\Open_circuit\11_open_circuit_07;0.5322085889570553;0.5438167259786477;49;49;2282;2248;0.02147239263803681;0.02179715302491103;.\data\pcb_defects_kaggle\images/Open_circuit/11_open_circuit_07.jpg;3
1405;open_circuit;1325;1392;1381;1460;.\data\pcb_defects_kaggle\Annotations\Open_circuit\11_open_circuit_07;0.5929009640666082;0.6343416370106761;56;68;2282;2248;0.024539877300613498;0.030249110320284697;.\data\pcb_defects_kaggle\images/Open_circuit/11_open_circuit_07.jpg;3
1406;open_circuit;1076;735;1140;798;.\data\pcb_defects_kaggle\Annotations\Open_circuit\11_open_circuit_08;0.4855390008764242;0.34096975088967973;64;63;2282;2248;0.028045574057843997;0.02802491103202847;.\data\pcb_defects_kaggle\images/Open_circuit/11_open_circuit_08.jpg;3
1407;open_circuit;1286;658;1352;722;.\data\pcb_defects_kaggle\Annotations\Open_circuit\11_open_circuit_08;0.5780017528483786;0.3069395017793594;66;64;2282;2248;0.028921998247151623;0.028469750889679714;.\data\pcb_defects_kaggle\images/Open_circuit/11_open_circuit_08.jpg;3
1408;open_circuit;763;1106;809;1165;.\data\pcb_defects_kaggle\Annotations\Open_circuit\11_open_circuit_08;0.3444347063978966;0.5051156583629893;46;59;2282;2248;0.020157756354075372;0.026245551601423486;.\data\pcb_defects_kaggle\images/Open_circuit/11_open_circuit_08.jpg;3
1409;open_circuit;1507;1150;1575;1203;.\data\pcb_defects_kaggle\Annotations\Open_circuit\11_open_circuit_08;0.6752848378615249;0.5233540925266904;68;53;2282;2248;0.029798422436459245;0.023576512455516015;.\data\pcb_defects_kaggle\images/Open_circuit/11_open_circuit_08.jpg;3
1410;open_circuit;1089;1365;1134;1419;.\data\pcb_defects_kaggle\Annotations\Open_circuit\11_open_circuit_08;0.48707274320771254;0.6192170818505338;45;54;2282;2248;0.01971954425942156;0.02402135231316726;.\data\pcb_defects_kaggle\images/Open_circuit/11_open_circuit_08.jpg;3
1411;open_circuit;766;355;827;411;.\data\pcb_defects_kaggle\Annotations\Open_circuit\11_open_circuit_09;0.3490359333917616;0.17037366548042704;61;56;2282;2248;0.02673093777388256;0.02491103202846975;.\data\pcb_defects_kaggle\images/Open_circuit/11_open_circuit_09.jpg;3
1412;open_circuit;301;590;393;637;.\data\pcb_defects_kaggle\Annotations\Open_circuit\11_open_circuit_09;0.1520595968448729;0.27290925266903915;92;47;2282;2248;0.040315512708150744;0.02090747330960854;.\data\pcb_defects_kaggle\images/Open_circuit/11_open_circuit_09.jpg;3
1413;open_circuit;429;1288;496;1347;.\data\pcb_defects_kaggle\Annotations\Open_circuit\11_open_circuit_09;0.20267309377738826;0.5860765124555161;67;59;2282;2248;0.029360210341805432;0.026245551601423486;.\data\pcb_defects_kaggle\images/Open_circuit/11_open_circuit_09.jpg;3
1414;open_circuit;575;1360;629;1403;.\data\pcb_defects_kaggle\Annotations\Open_circuit\11_open_circuit_09;0.26380368098159507;0.6145462633451957;54;43;2282;2248;0.02366345311130587;0.01912811387900356;.\data\pcb_defects_kaggle\images/Open_circuit/11_open_circuit_09.jpg;3
1415;open_circuit;1347;1394;1404;1457;.\data\pcb_defects_kaggle\Annotations\Open_circuit\11_open_circuit_09;0.602760736196319;0.6341192170818505;57;63;2282;2248;0.02497808939526731;0.02802491103202847;.\data\pcb_defects_kaggle\images/Open_circuit/11_open_circuit_09.jpg;3
1416;open_circuit;1075;675;1132;731;.\data\pcb_defects_kaggle\Annotations\Open_circuit\11_open_circuit_10;0.48356704645048204;0.3127224199288256;57;56;2282;2248;0.02497808939526731;0.02491103202846975;.\data\pcb_defects_kaggle\images/Open_circuit/11_open_circuit_10.jpg;3
1417;open_circuit;1501;970;1571;1021;.\data\pcb_defects_kaggle\Annotations\Open_circuit\11_open_circuit_10;0.6730937773882559;0.44283807829181493;70;51;2282;2248;0.03067484662576687;0.022686832740213523;.\data\pcb_defects_kaggle\images/Open_circuit/11_open_circuit_10.jpg;3
1418;open_circuit;930;1108;986;1162;.\data\pcb_defects_kaggle\Annotations\Open_circuit\11_open_circuit_10;0.4198071866783523;0.5048932384341637;56;54;2282;2248;0.024539877300613498;0.02402135231316726;.\data\pcb_defects_kaggle\images/Open_circuit/11_open_circuit_10.jpg;3
1419;open_circuit;570;1621;619;1676;.\data\pcb_defects_kaggle\Annotations\Open_circuit\11_open_circuit_10;0.2605170902716915;0.7333185053380783;49;55;2282;2248;0.02147239263803681;0.024466192170818506;.\data\pcb_defects_kaggle\images/Open_circuit/11_open_circuit_10.jpg;3
1420;open_circuit;1314;1867;1375;1947;.\data\pcb_defects_kaggle\Annotations\Open_circuit\11_open_circuit_10;0.5891761612620509;0.8483096085409253;61;80;2282;2248;0.02673093777388256;0.03558718861209965;.\data\pcb_defects_kaggle\images/Open_circuit/11_open_circuit_10.jpg;3
1421;open_circuit;1709;510;1753;554;.\data\pcb_defects_kaggle\Annotations\Open_circuit\12_open_circuit_01;0.6844602609727165;0.21027667984189724;44;44;2529;2530;0.017398181099248716;0.017391304347826087;.\data\pcb_defects_kaggle\images/Open_circuit/12_open_circuit_01.jpg;3
1422;open_circuit;1698;1444;1757;1484;.\data\pcb_defects_kaggle\Annotations\Open_circuit\12_open_circuit_01;0.6830763147489126;0.5786561264822134;59;40;2529;2530;0.02332937920126532;0.015810276679841896;.\data\pcb_defects_kaggle\images/Open_circuit/12_open_circuit_01.jpg;3
1423;open_circuit;2187;1583;2240;1628;.\data\pcb_defects_kaggle\Annotations\Open_circuit\12_open_circuit_01;0.8752471332542507;0.6345849802371542;53;45;2529;2530;0.02095689996045868;0.017786561264822136;.\data\pcb_defects_kaggle\images/Open_circuit/12_open_circuit_01.jpg;3
1424;open_circuit;1238;1826;1291;1872;.\data\pcb_defects_kaggle\Annotations\Open_circuit\12_open_circuit_01;0.5;0.7308300395256917;53;46;2529;2530;0.02095689996045868;0.01818181818181818;.\data\pcb_defects_kaggle\images/Open_circuit/12_open_circuit_01.jpg;3
1425;open_circuit;71;1763;124;1817;.\data\pcb_defects_kaggle\Annotations\Open_circuit\12_open_circuit_01;0.03855278766310795;0.7075098814229249;53;54;2529;2530;0.02095689996045868;0.021343873517786563;.\data\pcb_defects_kaggle\images/Open_circuit/12_open_circuit_01.jpg;3
1426;open_circuit;1914;681;1964;735;.\data\pcb_defects_kaggle\Annotations\Open_circuit\12_open_circuit_02;0.7667062079873468;0.2798418972332016;50;54;2529;2530;0.019770660340055358;0.021343873517786563;.\data\pcb_defects_kaggle\images/Open_circuit/12_open_circuit_02.jpg;3
1427;open_circuit;2220;564;2271;623;.\data\pcb_defects_kaggle\Annotations\Open_circuit\12_open_circuit_02;0.8879003558718861;0.23458498023715416;51;59;2529;2530;0.020166073546856466;0.0233201581027668;.\data\pcb_defects_kaggle\images/Open_circuit/12_open_circuit_02.jpg;3
1428;open_circuit;918;1017;971;1066;.\data\pcb_defects_kaggle\Annotations\Open_circuit\12_open_circuit_02;0.3734677738236457;0.4116600790513834;53;49;2529;2530;0.02095689996045868;0.019367588932806323;.\data\pcb_defects_kaggle\images/Open_circuit/12_open_circuit_02.jpg;3
1429;open_circuit;1535;1784;1602;1830;.\data\pcb_defects_kaggle\Annotations\Open_circuit\12_open_circuit_02;0.6202056148675366;0.7142292490118577;67;46;2529;2530;0.02649268485567418;0.01818181818181818;.\data\pcb_defects_kaggle\images/Open_circuit/12_open_circuit_02.jpg;3
1430;open_circuit;317;1161;366;1235;.\data\pcb_defects_kaggle\Annotations\Open_circuit\12_open_circuit_02;0.13503361012257808;0.4735177865612648;49;74;2529;2530;0.01937524713325425;0.02924901185770751;.\data\pcb_defects_kaggle\images/Open_circuit/12_open_circuit_02.jpg;3
1431;open_circuit;1726;1830;1782;1879;.\data\pcb_defects_kaggle\Annotations\Open_circuit\12_open_circuit_03;0.6935547647291419;0.73300395256917;56;49;2529;2530;0.022143139580862;0.019367588932806323;.\data\pcb_defects_kaggle\images/Open_circuit/12_open_circuit_03.jpg;3
1432;open_circuit;2304;1712;2340;1775;.\data\pcb_defects_kaggle\Annotations\Open_circuit\12_open_circuit_03;0.9181494661921709;0.6891304347826087;36;63;2529;2530;0.014234875444839857;0.024901185770750987;.\data\pcb_defects_kaggle\images/Open_circuit/12_open_circuit_03.jpg;3
1433;open_circuit;1318;1923;1371;1963;.\data\pcb_defects_kaggle\Annotations\Open_circuit\12_open_circuit_03;0.5316330565440885;0.7679841897233202;53;40;2529;2530;0.02095689996045868;0.015810276679841896;.\data\pcb_defects_kaggle\images/Open_circuit/12_open_circuit_03.jpg;3
1434;open_circuit;113;2032;162;2092;.\data\pcb_defects_kaggle\Annotations\Open_circuit\12_open_circuit_03;0.054369315935152235;0.8150197628458498;49;60;2529;2530;0.01937524713325425;0.023715415019762844;.\data\pcb_defects_kaggle\images/Open_circuit/12_open_circuit_03.jpg;3
1435;open_circuit;2344;2128;2393;2172;.\data\pcb_defects_kaggle\Annotations\Open_circuit\12_open_circuit_03;0.9365361803084223;0.849802371541502;49;44;2529;2530;0.01937524713325425;0.017391304347826087;.\data\pcb_defects_kaggle\images/Open_circuit/12_open_circuit_03.jpg;3
1436;open_circuit;1373;361;1417;410;.\data\pcb_defects_kaggle\Annotations\Open_circuit\12_open_circuit_04;0.5516014234875445;0.1523715415019763;44;49;2529;2530;0.017398181099248716;0.019367588932806323;.\data\pcb_defects_kaggle\images/Open_circuit/12_open_circuit_04.jpg;3
1437;open_circuit;1497;372;1546;419;.\data\pcb_defects_kaggle\Annotations\Open_circuit\12_open_circuit_04;0.6016211941478845;0.15632411067193677;49;47;2529;2530;0.01937524713325425;0.01857707509881423;.\data\pcb_defects_kaggle\images/Open_circuit/12_open_circuit_04.jpg;3
1438;open_circuit;900;734;951;784;.\data\pcb_defects_kaggle\Annotations\Open_circuit\12_open_circuit_04;0.36595492289442466;0.3;51;50;2529;2530;0.020166073546856466;0.019762845849802372;.\data\pcb_defects_kaggle\images/Open_circuit/12_open_circuit_04.jpg;3
1439;open_circuit;633;1235;678;1279;.\data\pcb_defects_kaggle\Annotations\Open_circuit\12_open_circuit_04;0.25919335705812574;0.49683794466403164;45;44;2529;2530;0.017793594306049824;0.017391304347826087;.\data\pcb_defects_kaggle\images/Open_circuit/12_open_circuit_04.jpg;3
1440;open_circuit;1380;924;1427;966;.\data\pcb_defects_kaggle\Annotations\Open_circuit\12_open_circuit_04;0.5549624357453539;0.37351778656126483;47;42;2529;2530;0.018584420719652037;0.016600790513833993;.\data\pcb_defects_kaggle\images/Open_circuit/12_open_circuit_04.jpg;3
1441;open_circuit;1864;754;1906;803;.\data\pcb_defects_kaggle\Annotations\Open_circuit\12_open_circuit_05;0.745353894820087;0.3077075098814229;42;49;2529;2530;0.0166073546856465;0.019367588932806323;.\data\pcb_defects_kaggle\images/Open_circuit/12_open_circuit_05.jpg;3
1442;open_circuit;1695;1083;1742;1128;.\data\pcb_defects_kaggle\Annotations\Open_circuit\12_open_circuit_05;0.6795175958877027;0.4369565217391304;47;45;2529;2530;0.018584420719652037;0.017786561264822136;.\data\pcb_defects_kaggle\images/Open_circuit/12_open_circuit_05.jpg;3
1443;open_circuit;1864;1437;1900;1484;.\data\pcb_defects_kaggle\Annotations\Open_circuit\12_open_circuit_05;0.7441676551996836;0.5772727272727273;36;47;2529;2530;0.014234875444839857;0.01857707509881423;.\data\pcb_defects_kaggle\images/Open_circuit/12_open_circuit_05.jpg;3
1444;open_circuit;1413;1570;1449;1610;.\data\pcb_defects_kaggle\Annotations\Open_circuit\12_open_circuit_05;0.5658362989323843;0.6284584980237155;36;40;2529;2530;0.014234875444839857;0.015810276679841896;.\data\pcb_defects_kaggle\images/Open_circuit/12_open_circuit_05.jpg;3
1445;open_circuit;835;1825;884;1870;.\data\pcb_defects_kaggle\Annotations\Open_circuit\12_open_circuit_05;0.3398576512455516;0.7302371541501976;49;45;2529;2530;0.01937524713325425;0.017786561264822136;.\data\pcb_defects_kaggle\images/Open_circuit/12_open_circuit_05.jpg;3
1446;open_circuit;1420;370;1458;437;.\data\pcb_defects_kaggle\Annotations\Open_circuit\12_open_circuit_06;0.5689996045867932;0.15948616600790513;38;67;2529;2530;0.015025701858442072;0.026482213438735178;.\data\pcb_defects_kaggle\images/Open_circuit/12_open_circuit_06.jpg;3
1447;open_circuit;531;919;584;966;.\data\pcb_defects_kaggle\Annotations\Open_circuit\12_open_circuit_06;0.22044286279161723;0.3725296442687747;53;47;2529;2530;0.02095689996045868;0.01857707509881423;.\data\pcb_defects_kaggle\images/Open_circuit/12_open_circuit_06.jpg;3
1448;open_circuit;2220;683;2269;739;.\data\pcb_defects_kaggle\Annotations\Open_circuit\12_open_circuit_06;0.8875049426650851;0.2810276679841897;49;56;2529;2530;0.01937524713325425;0.022134387351778657;.\data\pcb_defects_kaggle\images/Open_circuit/12_open_circuit_06.jpg;3
1449;open_circuit;678;1615;737;1663;.\data\pcb_defects_kaggle\Annotations\Open_circuit\12_open_circuit_06;0.27975484381178334;0.6478260869565218;59;48;2529;2530;0.02332937920126532;0.018972332015810278;.\data\pcb_defects_kaggle\images/Open_circuit/12_open_circuit_06.jpg;3
1450;open_circuit;2289;1090;2338;1146;.\data\pcb_defects_kaggle\Annotations\Open_circuit\12_open_circuit_06;0.9147884539343614;0.44189723320158103;49;56;2529;2530;0.01937524713325425;0.022134387351778657;.\data\pcb_defects_kaggle\images/Open_circuit/12_open_circuit_06.jpg;3
1451;open_circuit;1857;690;1909;741;.\data\pcb_defects_kaggle\Annotations\Open_circuit\12_open_circuit_07;0.7445630684064848;0.2828063241106719;52;51;2529;2530;0.02056148675365757;0.02015810276679842;.\data\pcb_defects_kaggle\images/Open_circuit/12_open_circuit_07.jpg;3
1452;open_circuit;1806;1488;1855;1539;.\data\pcb_defects_kaggle\Annotations\Open_circuit\12_open_circuit_07;0.7238038750494267;0.5982213438735178;49;51;2529;2530;0.01937524713325425;0.02015810276679842;.\data\pcb_defects_kaggle\images/Open_circuit/12_open_circuit_07.jpg;3
1453;open_circuit;2264;1599;2306;1654;.\data\pcb_defects_kaggle\Annotations\Open_circuit\12_open_circuit_07;0.9035191775405299;0.6428853754940711;42;55;2529;2530;0.0166073546856465;0.021739130434782608;.\data\pcb_defects_kaggle\images/Open_circuit/12_open_circuit_07.jpg;3
1454;open_circuit;2377;1966;2417;2039;.\data\pcb_defects_kaggle\Annotations\Open_circuit\12_open_circuit_07;0.9478054567022538;0.791501976284585;40;73;2529;2530;0.015816528272044286;0.028853754940711462;.\data\pcb_defects_kaggle\images/Open_circuit/12_open_circuit_07.jpg;3
1455;open_circuit;1095;2154;1152;2191;.\data\pcb_defects_kaggle\Annotations\Open_circuit\12_open_circuit_07;0.4442467378410439;0.8586956521739131;57;37;2529;2530;0.022538552787663108;0.014624505928853756;.\data\pcb_defects_kaggle\images/Open_circuit/12_open_circuit_07.jpg;3
1456;open_circuit;1551;397;1600;450;.\data\pcb_defects_kaggle\Annotations\Open_circuit\12_open_circuit_08;0.6229735073151443;0.1673913043478261;49;53;2529;2530;0.01937524713325425;0.020948616600790514;.\data\pcb_defects_kaggle\images/Open_circuit/12_open_circuit_08.jpg;3
1457;open_circuit;1967;846;2007;903;.\data\pcb_defects_kaggle\Annotations\Open_circuit\12_open_circuit_08;0.7856860419137999;0.3456521739130435;40;57;2529;2530;0.015816528272044286;0.022529644268774702;.\data\pcb_defects_kaggle\images/Open_circuit/12_open_circuit_08.jpg;3
1458;open_circuit;1911;139;1973;184;.\data\pcb_defects_kaggle\Annotations\Open_circuit\12_open_circuit_08;0.7678924476077501;0.06383399209486167;62;45;2529;2530;0.024515618821668642;0.017786561264822136;.\data\pcb_defects_kaggle\images/Open_circuit/12_open_circuit_08.jpg;3
1459;open_circuit;1397;1564;1449;1619;.\data\pcb_defects_kaggle\Annotations\Open_circuit\12_open_circuit_08;0.5626729932779755;0.6290513833992095;52;55;2529;2530;0.02056148675365757;0.021739130434782608;.\data\pcb_defects_kaggle\images/Open_circuit/12_open_circuit_08.jpg;3
1460;open_circuit;1323;1118;1375;1163;.\data\pcb_defects_kaggle\Annotations\Open_circuit\12_open_circuit_08;0.5334124159746936;0.4507905138339921;52;45;2529;2530;0.02056148675365757;0.017786561264822136;.\data\pcb_defects_kaggle\images/Open_circuit/12_open_circuit_08.jpg;3
1461;open_circuit;1453;419;1498;477;.\data\pcb_defects_kaggle\Annotations\Open_circuit\12_open_circuit_09;0.5834321866350336;0.17707509881422925;45;58;2529;2530;0.017793594306049824;0.02292490118577075;.\data\pcb_defects_kaggle\images/Open_circuit/12_open_circuit_09.jpg;3
1462;open_circuit;1969;1444;2013;1494;.\data\pcb_defects_kaggle\Annotations\Open_circuit\12_open_circuit_09;0.7872676947410043;0.5806324110671937;44;50;2529;2530;0.017398181099248716;0.019762845849802372;.\data\pcb_defects_kaggle\images/Open_circuit/12_open_circuit_09.jpg;3
1463;open_circuit;584;1537;642;1581;.\data\pcb_defects_kaggle\Annotations\Open_circuit\12_open_circuit_09;0.2423882957690787;0.6162055335968379;58;44;2529;2530;0.022933965994464216;0.017391304347826087;.\data\pcb_defects_kaggle\images/Open_circuit/12_open_circuit_09.jpg;3
1464;open_circuit;640;686;695;732;.\data\pcb_defects_kaggle\Annotations\Open_circuit\12_open_circuit_09;0.263938315539739;0.2802371541501976;55;46;2529;2530;0.021747726374060895;0.01818181818181818;.\data\pcb_defects_kaggle\images/Open_circuit/12_open_circuit_09.jpg;3
1465;open_circuit;856;2014;905;2054;.\data\pcb_defects_kaggle\Annotations\Open_circuit\12_open_circuit_09;0.34816132858837484;0.8039525691699605;49;40;2529;2530;0.01937524713325425;0.015810276679841896;.\data\pcb_defects_kaggle\images/Open_circuit/12_open_circuit_09.jpg;3
1466;open_circuit;1709;819;1747;866;.\data\pcb_defects_kaggle\Annotations\Open_circuit\12_open_circuit_10;0.6832740213523132;0.33300395256917;38;47;2529;2530;0.015025701858442072;0.01857707509881423;.\data\pcb_defects_kaggle\images/Open_circuit/12_open_circuit_10.jpg;3
1467;open_circuit;2077;1241;2135;1286;.\data\pcb_defects_kaggle\Annotations\Open_circuit\12_open_circuit_10;0.8327402135231317;0.49940711462450593;58;45;2529;2530;0.022933965994464216;0.017786561264822136;.\data\pcb_defects_kaggle\images/Open_circuit/12_open_circuit_10.jpg;3
1468;open_circuit;661;1615;704;1661;.\data\pcb_defects_kaggle\Annotations\Open_circuit\12_open_circuit_10;0.26986951364175565;0.6474308300395257;43;46;2529;2530;0.017002767892447607;0.01818181818181818;.\data\pcb_defects_kaggle\images/Open_circuit/12_open_circuit_10.jpg;3
1469;open_circuit;119;1858;155;1918;.\data\pcb_defects_kaggle\Annotations\Open_circuit\12_open_circuit_10;0.05417160933175168;0.7462450592885376;36;60;2529;2530;0.014234875444839857;0.023715415019762844;.\data\pcb_defects_kaggle\images/Open_circuit/12_open_circuit_10.jpg;3
1470;open_circuit;516;1347;574;1391;.\data\pcb_defects_kaggle\Annotations\Open_circuit\12_open_circuit_10;0.2155001977066034;0.5411067193675889;58;44;2529;2530;0.022933965994464216;0.017391304347826087;.\data\pcb_defects_kaggle\images/Open_circuit/12_open_circuit_10.jpg;3
1471;short;763;1136;828;1201;.\data\pcb_defects_kaggle\Annotations\Short\01_short_01;0.2621951219512195;0.7367591424968474;65;65;3034;1586;0.02142386288727752;0.040983606557377046;.\data\pcb_defects_kaggle\images/Short/01_short_01.jpg;4
1472;short;538;936;608;998;.\data\pcb_defects_kaggle\Annotations\Short\01_short_01;0.18885959129861568;0.6097099621689785;70;62;3034;1586;0.023071852340145024;0.03909205548549811;.\data\pcb_defects_kaggle\images/Short/01_short_01.jpg;4
1473;short;2300;1101;2355;1143;.\data\pcb_defects_kaggle\Annotations\Short\01_short_01;0.767139090309822;0.7074401008827238;55;42;3034;1586;0.01812788398154252;0.02648171500630517;.\data\pcb_defects_kaggle\images/Short/01_short_01.jpg;4
1474;short;1010;1371;1065;1418;.\data\pcb_defects_kaggle\Annotations\Short\01_short_02;0.3419578114700066;0.8792559899117276;55;47;3034;1586;0.01812788398154252;0.029634300126103404;.\data\pcb_defects_kaggle\images/Short/01_short_02.jpg;4
1475;short;2560;556;2618;596;.\data\pcb_defects_kaggle\Annotations\Short\01_short_02;0.8533289386947923;0.36317780580075665;58;40;3034;1586;0.01911667765326302;0.025220680958385876;.\data\pcb_defects_kaggle\images/Short/01_short_02.jpg;4
1476;short;1500;1326;1558;1373;.\data\pcb_defects_kaggle\Annotations\Short\01_short_02;0.503955174686882;0.8508827238335435;58;47;3034;1586;0.01911667765326302;0.029634300126103404;.\data\pcb_defects_kaggle\images/Short/01_short_02.jpg;4
1477;short;787;1206;841;1263;.\data\pcb_defects_kaggle\Annotations\Short\01_short_03;0.2682926829268293;0.7783732660781841;54;57;3034;1586;0.017798286090969017;0.035939470365699874;.\data\pcb_defects_kaggle\images/Short/01_short_03.jpg;4
1478;short;1003;1318;1063;1369;.\data\pcb_defects_kaggle\Annotations\Short\01_short_03;0.34047462096242587;0.8470996216897856;60;51;3034;1586;0.01977587343441002;0.03215636822194199;.\data\pcb_defects_kaggle\images/Short/01_short_03.jpg;4
1479;short;1318;1263;1379;1318;.\data\pcb_defects_kaggle\Annotations\Short\01_short_03;0.4444627554383652;0.8136822194199244;61;55;3034;1586;0.02010547132498352;0.03467843631778058;.\data\pcb_defects_kaggle\images/Short/01_short_03.jpg;4
1480;short;1984;1227;2057;1287;.\data\pcb_defects_kaggle\Annotations\Short\01_short_04;0.6659525379037574;0.7925598991172762;73;60;3034;1586;0.024060646011865524;0.03783102143757881;.\data\pcb_defects_kaggle\images/Short/01_short_04.jpg;4
1481;short;2205;1135;2281;1218;.\data\pcb_defects_kaggle\Annotations\Short\01_short_04;0.7392880685563612;0.7418032786885246;76;83;3034;1586;0.025049439683586024;0.05233291298865069;.\data\pcb_defects_kaggle\images/Short/01_short_04.jpg;4
1482;short;2342;1161;2411;1226;.\data\pcb_defects_kaggle\Annotations\Short\01_short_04;0.7832893869479235;0.7525220680958385;69;65;3034;1586;0.022742254449571522;0.040983606557377046;.\data\pcb_defects_kaggle\images/Short/01_short_04.jpg;4
1483;short;1726;1376;1794;1436;.\data\pcb_defects_kaggle\Annotations\Short\01_short_05;0.5800922874093606;0.8865069356872636;68;60;3034;1586;0.02241265655899802;0.03783102143757881;.\data\pcb_defects_kaggle\images/Short/01_short_05.jpg;4
1484;short;942;890;999;938;.\data\pcb_defects_kaggle\Annotations\Short\01_short_05;0.31987475280158206;0.5762925598991173;57;48;3034;1586;0.018787079762689517;0.03026481715006305;.\data\pcb_defects_kaggle\images/Short/01_short_05.jpg;4
1485;short;559;1053;620;1112;.\data\pcb_defects_kaggle\Annotations\Short\01_short_05;0.19429795649307843;0.6825346784363178;61;59;3034;1586;0.02010547132498352;0.03720050441361917;.\data\pcb_defects_kaggle\images/Short/01_short_05.jpg;4
1486;short;754;1336;823;1402;.\data\pcb_defects_kaggle\Annotations\Short\01_short_06;0.259887936717205;0.8631778058007566;69;66;3034;1586;0.022742254449571522;0.0416141235813367;.\data\pcb_defects_kaggle\images/Short/01_short_06.jpg;4
1487;short;2065;1376;2136;1445;.\data\pcb_defects_kaggle\Annotations\Short\01_short_06;0.6923203691496375;0.889344262295082;71;69;3034;1586;0.023401450230718525;0.043505674653215635;.\data\pcb_defects_kaggle\images/Short/01_short_06.jpg;4
1488;short;445;923;517;991;.\data\pcb_defects_kaggle\Annotations\Short\01_short_06;0.15853658536585366;0.6034047919293821;72;68;3034;1586;0.023731048121292023;0.04287515762925599;.\data\pcb_defects_kaggle\images/Short/01_short_06.jpg;4
1489;short;705;1114;771;1169;.\data\pcb_defects_kaggle\Annotations\Short\01_short_07;0.24324324324324326;0.719735182849937;66;55;3034;1586;0.021753460777851022;0.03467843631778058;.\data\pcb_defects_kaggle\images/Short/01_short_07.jpg;4
1490;short;1645;524;1744;617;.\data\pcb_defects_kaggle\Annotations\Short\01_short_07;0.5585036255767963;0.35970996216897855;99;93;3034;1586;0.03263019116677653;0.058638083228247165;.\data\pcb_defects_kaggle\images/Short/01_short_07.jpg;4
1491;short;1599;1227;1688;1312;.\data\pcb_defects_kaggle\Annotations\Short\01_short_07;0.5416941331575478;0.8004413619167717;89;85;3034;1586;0.02933421226104153;0.053593947036569986;.\data\pcb_defects_kaggle\images/Short/01_short_07.jpg;4
1492;short;935;1251;994;1315;.\data\pcb_defects_kaggle\Annotations\Short\01_short_08;0.31789716545814106;0.808953341740227;59;64;3034;1586;0.01944627554383652;0.0403530895334174;.\data\pcb_defects_kaggle\images/Short/01_short_08.jpg;4
1493;short;2353;1166;2421;1233;.\data\pcb_defects_kaggle\Annotations\Short\01_short_08;0.7867501647989453;0.7563051702395964;68;67;3034;1586;0.02241265655899802;0.04224464060529634;.\data\pcb_defects_kaggle\images/Short/01_short_08.jpg;4
1494;short;2666;1111;2771;1209;.\data\pcb_defects_kaggle\Annotations\Short\01_short_08;0.8960118655240606;0.7313997477931904;105;98;3034;1586;0.034607778510217534;0.0617906683480454;.\data\pcb_defects_kaggle\images/Short/01_short_08.jpg;4
1495;short;921;1254;997;1318;.\data\pcb_defects_kaggle\Annotations\Short\01_short_09;0.3160843770599868;0.8108448928121059;76;64;3034;1586;0.025049439683586024;0.0403530895334174;.\data\pcb_defects_kaggle\images/Short/01_short_09.jpg;4
1496;short;803;1373;865;1432;.\data\pcb_defects_kaggle\Annotations\Short\01_short_09;0.27488464073829927;0.8843001261034048;62;59;3034;1586;0.02043506921555702;0.03720050441361917;.\data\pcb_defects_kaggle\images/Short/01_short_09.jpg;4
1497;short;2348;1158;2414;1227;.\data\pcb_defects_kaggle\Annotations\Short\01_short_09;0.7847725774555043;0.751891551071879;66;69;3034;1586;0.021753460777851022;0.043505674653215635;.\data\pcb_defects_kaggle\images/Short/01_short_09.jpg;4
1498;short;2675;1109;2765;1209;.\data\pcb_defects_kaggle\Annotations\Short\01_short_09;0.8965062623599209;0.7307692307692307;90;100;3034;1586;0.02966381015161503;0.06305170239596469;.\data\pcb_defects_kaggle\images/Short/01_short_09.jpg;4
1499;short;488;944;553;1003;.\data\pcb_defects_kaggle\Annotations\Short\01_short_09;0.17155570204350692;0.6138083228247163;65;59;3034;1586;0.02142386288727752;0.03720050441361917;.\data\pcb_defects_kaggle\images/Short/01_short_09.jpg;4
1500;short;594;912;644;964;.\data\pcb_defects_kaggle\Annotations\Short\01_short_09;0.2040210942649967;0.5914249684741488;50;52;3034;1586;0.016479894528675015;0.03278688524590164;.\data\pcb_defects_kaggle\images/Short/01_short_09.jpg;4
1501;short;542;914;600;966;.\data\pcb_defects_kaggle\Annotations\Short\01_short_10;0.1882003955174687;0.592686002522068;58;52;3034;1586;0.01911667765326302;0.03278688524590164;.\data\pcb_defects_kaggle\images/Short/01_short_10.jpg;4
1502;short;784;1200;841;1260;.\data\pcb_defects_kaggle\Annotations\Short\01_short_10;0.267798286090969;0.7755359394703657;57;60;3034;1586;0.018787079762689517;0.03783102143757881;.\data\pcb_defects_kaggle\images/Short/01_short_10.jpg;4
1503;short;620;885;656;932;.\data\pcb_defects_kaggle\Annotations\Short\01_short_10;0.2102834541858932;0.5728247162673392;36;47;3034;1586;0.011865524060646011;0.029634300126103404;.\data\pcb_defects_kaggle\images/Short/01_short_10.jpg;4
1504;short;1105;1253;1166;1321;.\data\pcb_defects_kaggle\Annotations\Short\01_short_11;0.37425840474620964;0.8114754098360656;61;68;3034;1586;0.02010547132498352;0.04287515762925599;.\data\pcb_defects_kaggle\images/Short/01_short_11.jpg;4
1505;short;2121;927;2206;1026;.\data\pcb_defects_kaggle\Annotations\Short\01_short_11;0.7130850362557679;0.6156998738965952;85;99;3034;1586;0.02801582069874753;0.06242118537200504;.\data\pcb_defects_kaggle\images/Short/01_short_11.jpg;4
1506;short;2678;1064;2762;1148;.\data\pcb_defects_kaggle\Annotations\Short\01_short_11;0.8965062623599209;0.6973518284993695;84;84;3034;1586;0.027686222808174028;0.05296343001261034;.\data\pcb_defects_kaggle\images/Short/01_short_11.jpg;4
1507;short;615;882;659;930;.\data\pcb_defects_kaggle\Annotations\Short\01_short_11;0.2099538562953197;0.5712484237074401;44;48;3034;1586;0.014502307185234015;0.03026481715006305;.\data\pcb_defects_kaggle\images/Short/01_short_11.jpg;4
1508;short;747;1370;802;1433;.\data\pcb_defects_kaggle\Annotations\Short\01_short_12;0.255273566249176;0.8836696090794451;55;63;3034;1586;0.01812788398154252;0.03972257250945776;.\data\pcb_defects_kaggle\images/Short/01_short_12.jpg;4
1509;short;1496;1321;1547;1382;.\data\pcb_defects_kaggle\Annotations\Short\01_short_12;0.5014831905075807;0.8521437578814628;51;61;3034;1586;0.016809492419248517;0.038461538461538464;.\data\pcb_defects_kaggle\images/Short/01_short_12.jpg;4
1510;short;603;879;656;933;.\data\pcb_defects_kaggle\Annotations\Short\01_short_12;0.20748187211601846;0.5712484237074401;53;54;3034;1586;0.01746868820039552;0.034047919293820936;.\data\pcb_defects_kaggle\images/Short/01_short_12.jpg;4
1511;short;1979;1170;2048;1227;.\data\pcb_defects_kaggle\Annotations\Short\01_short_12;0.6636453526697429;0.7556746532156369;69;57;3034;1586;0.022742254449571522;0.035939470365699874;.\data\pcb_defects_kaggle\images/Short/01_short_12.jpg;4
1512;short;2062;1373;2136;1442;.\data\pcb_defects_kaggle\Annotations\Short\01_short_13;0.6918259723137772;0.887452711223203;74;69;3034;1586;0.024390243902439025;0.043505674653215635;.\data\pcb_defects_kaggle\images/Short/01_short_13.jpg;4
1513;short;2681;1160;2765;1273;.\data\pcb_defects_kaggle\Annotations\Short\01_short_13;0.8974950560316414;0.7670239596469105;84;113;3034;1586;0.027686222808174028;0.0712484237074401;.\data\pcb_defects_kaggle\images/Short/01_short_13.jpg;4
1514;short;609;878;657;932;.\data\pcb_defects_kaggle\Annotations\Short\01_short_13;0.20863546473302572;0.5706179066834804;48;54;3034;1586;0.015820698747528016;0.034047919293820936;.\data\pcb_defects_kaggle\images/Short/01_short_13.jpg;4
1515;short;541;936;593;999;.\data\pcb_defects_kaggle\Annotations\Short\01_short_14;0.18688200395517468;0.6100252206809584;52;63;3034;1586;0.017139090309822018;0.03972257250945776;.\data\pcb_defects_kaggle\images/Short/01_short_14.jpg;4
1516;short;612;873;659;932;.\data\pcb_defects_kaggle\Annotations\Short\01_short_14;0.20945945945945946;0.5690416141235813;47;59;3034;1586;0.015491100856954515;0.03720050441361917;.\data\pcb_defects_kaggle\images/Short/01_short_14.jpg;4
1517;short;2253;1281;2327;1348;.\data\pcb_defects_kaggle\Annotations\Short\01_short_14;0.7547791694133158;0.8288146279949559;74;67;3034;1586;0.024390243902439025;0.04224464060529634;.\data\pcb_defects_kaggle\images/Short/01_short_14.jpg;4
1518;short;2406;1173;2491;1258;.\data\pcb_defects_kaggle\Annotations\Short\01_short_14;0.8070204350692155;0.7663934426229508;85;85;3034;1586;0.02801582069874753;0.053593947036569986;.\data\pcb_defects_kaggle\images/Short/01_short_14.jpg;4
1519;short;697;1112;738;1166;.\data\pcb_defects_kaggle\Annotations\Short\01_short_15;0.23648648648648649;0.7181588902900379;41;54;3034;1586;0.013513513513513514;0.034047919293820936;.\data\pcb_defects_kaggle\images/Short/01_short_15.jpg;4
1520;short;1627;1227;1696;1296;.\data\pcb_defects_kaggle\Annotations\Short\01_short_15;0.5476268951878708;0.7953972257250945;69;69;3034;1586;0.022742254449571522;0.043505674653215635;.\data\pcb_defects_kaggle\images/Short/01_short_15.jpg;4
1521;short;608;879;659;932;.\data\pcb_defects_kaggle\Annotations\Short\01_short_15;0.20880026367831245;0.5709331651954602;51;53;3034;1586;0.016809492419248517;0.033417402269861285;.\data\pcb_defects_kaggle\images/Short/01_short_15.jpg;4
1522;short;445;938;500;985;.\data\pcb_defects_kaggle\Annotations\Short\01_short_15;0.15573500329597892;0.6062421185372006;55;47;3034;1586;0.01812788398154252;0.029634300126103404;.\data\pcb_defects_kaggle\images/Short/01_short_15.jpg;4
1523;short;1633;463;1724;564;.\data\pcb_defects_kaggle\Annotations\Short\01_short_16;0.5532300593276203;0.3237704918032787;91;101;3034;1586;0.02999340804218853;0.06368221941992434;.\data\pcb_defects_kaggle\images/Short/01_short_16.jpg;4
1524;short;2675;1057;2744;1151;.\data\pcb_defects_kaggle\Annotations\Short\01_short_16;0.8930454845088991;0.6960907944514502;69;94;3034;1586;0.022742254449571522;0.05926860025220681;.\data\pcb_defects_kaggle\images/Short/01_short_16.jpg;4
1525;short;2144;693;2200;775;.\data\pcb_defects_kaggle\Annotations\Short\01_short_16;0.7158866183256427;0.46279949558638084;56;82;3034;1586;0.01845748187211602;0.05170239596469105;.\data\pcb_defects_kaggle\images/Short/01_short_16.jpg;4
1526;short;617;884;659;933;.\data\pcb_defects_kaggle\Annotations\Short\01_short_16;0.2102834541858932;0.5728247162673392;42;49;3034;1586;0.013843111404087014;0.0308953341740227;.\data\pcb_defects_kaggle\images/Short/01_short_16.jpg;4
1527;short;541;903;597;966;.\data\pcb_defects_kaggle\Annotations\Short\01_short_17;0.1875411997363217;0.5892181588902901;56;63;3034;1586;0.01845748187211602;0.03972257250945776;.\data\pcb_defects_kaggle\images/Short/01_short_17.jpg;4
1528;short;559;1051;602;1109;.\data\pcb_defects_kaggle\Annotations\Short\01_short_17;0.19133157547791693;0.6809583858764187;43;58;3034;1586;0.014172709294660513;0.03656998738965952;.\data\pcb_defects_kaggle\images/Short/01_short_17.jpg;4
1529;short;1138;1347;1191;1409;.\data\pcb_defects_kaggle\Annotations\Short\01_short_17;0.3838167435728411;0.8688524590163934;53;62;3034;1586;0.01746868820039552;0.03909205548549811;.\data\pcb_defects_kaggle\images/Short/01_short_17.jpg;4
1530;short;615;887;657;929;.\data\pcb_defects_kaggle\Annotations\Short\01_short_17;0.20962425840474622;0.5725094577553594;42;42;3034;1586;0.013843111404087014;0.02648171500630517;.\data\pcb_defects_kaggle\images/Short/01_short_17.jpg;4
1531;short;805;1166;871;1223;.\data\pcb_defects_kaggle\Annotations\Short\01_short_18;0.2762030323005933;0.7531525851197982;66;57;3034;1586;0.021753460777851022;0.035939470365699874;.\data\pcb_defects_kaggle\images/Short/01_short_18.jpg;4
1532;short;817;1318;875;1372;.\data\pcb_defects_kaggle\Annotations\Short\01_short_18;0.27883981542518127;0.8480453972257251;58;54;3034;1586;0.01911667765326302;0.034047919293820936;.\data\pcb_defects_kaggle\images/Short/01_short_18.jpg;4
1533;short;1987;1205;2059;1263;.\data\pcb_defects_kaggle\Annotations\Short\01_short_18;0.6667765326301912;0.7780580075662042;72;58;3034;1586;0.023731048121292023;0.03656998738965952;.\data\pcb_defects_kaggle\images/Short/01_short_18.jpg;4
1534;short;620;888;653;926;.\data\pcb_defects_kaggle\Annotations\Short\01_short_18;0.20978905735003295;0.5718789407313998;33;38;3034;1586;0.010876730388925511;0.02395964691046658;.\data\pcb_defects_kaggle\images/Short/01_short_18.jpg;4
1535;short;979;1294;1030;1341;.\data\pcb_defects_kaggle\Annotations\Short\01_short_19;0.3310810810810811;0.8307061790668349;51;47;3034;1586;0.016809492419248517;0.029634300126103404;.\data\pcb_defects_kaggle\images/Short/01_short_19.jpg;4
1536;short;1336;1345;1390;1400;.\data\pcb_defects_kaggle\Annotations\Short\01_short_19;0.44924192485168096;0.8653846153846154;54;55;3034;1586;0.017798286090969017;0.03467843631778058;.\data\pcb_defects_kaggle\images/Short/01_short_19.jpg;4
1537;short;2712;1111;2791;1209;.\data\pcb_defects_kaggle\Annotations\Short\01_short_19;0.9068885959129862;0.7313997477931904;79;98;3034;1586;0.026038233355306525;0.0617906683480454;.\data\pcb_defects_kaggle\images/Short/01_short_19.jpg;4
1538;short;615;878;656;930;.\data\pcb_defects_kaggle\Annotations\Short\01_short_19;0.20945945945945946;0.5699873896595208;41;52;3034;1586;0.013513513513513514;0.03278688524590164;.\data\pcb_defects_kaggle\images/Short/01_short_19.jpg;4
1539;short;721;1115;774;1173;.\data\pcb_defects_kaggle\Annotations\Short\01_short_20;0.2463744232036915;0.7213114754098361;53;58;3034;1586;0.01746868820039552;0.03656998738965952;.\data\pcb_defects_kaggle\images/Short/01_short_20.jpg;4
1540;short;609;881;662;939;.\data\pcb_defects_kaggle\Annotations\Short\01_short_20;0.20945945945945946;0.5737704918032787;53;58;3034;1586;0.01746868820039552;0.03656998738965952;.\data\pcb_defects_kaggle\images/Short/01_short_20.jpg;4
1541;short;1236;1375;1296;1427;.\data\pcb_defects_kaggle\Annotations\Short\01_short_20;0.41727092946605143;0.8833543505674654;60;52;3034;1586;0.01977587343441002;0.03278688524590164;.\data\pcb_defects_kaggle\images/Short/01_short_20.jpg;4
1542;short;1671;297;1738;379;.\data\pcb_defects_kaggle\Annotations\Short\01_short_20;0.5617996044825313;0.21311475409836064;67;82;3034;1586;0.022083058668424523;0.05170239596469105;.\data\pcb_defects_kaggle\images/Short/01_short_20.jpg;4
1543;short;857;1171;944;1250;.\data\pcb_defects_kaggle\Annotations\Short\04_short_01;0.29466623036649214;0.49127435064935066;87;79;3056;2464;0.028468586387434554;0.03206168831168831;.\data\pcb_defects_kaggle\images/Short/04_short_01.jpg;4
1544;short;1364;473;1448;561;.\data\pcb_defects_kaggle\Annotations\Short\04_short_01;0.46007853403141363;0.20982142857142858;84;88;3056;2464;0.0274869109947644;0.03571428571428571;.\data\pcb_defects_kaggle\images/Short/04_short_01.jpg;4
1545;short;1357;1519;1446;1613;.\data\pcb_defects_kaggle\Annotations\Short\04_short_01;0.4586060209424084;0.635551948051948;89;94;3056;2464;0.02912303664921466;0.03814935064935065;.\data\pcb_defects_kaggle\images/Short/04_short_01.jpg;4
1546;short;1579;1161;1677;1261;.\data\pcb_defects_kaggle\Annotations\Short\04_short_02;0.5327225130890052;0.4914772727272727;98;100;3056;2464;0.03206806282722513;0.040584415584415584;.\data\pcb_defects_kaggle\images/Short/04_short_02.jpg;4
1547;short;2021;1597;2110;1695;.\data\pcb_defects_kaggle\Annotations\Short\04_short_02;0.6758835078534031;0.6680194805194806;89;98;3056;2464;0.02912303664921466;0.03977272727272727;.\data\pcb_defects_kaggle\images/Short/04_short_02.jpg;4
1548;short;2571;1684;2686;1804;.\data\pcb_defects_kaggle\Annotations\Short\04_short_02;0.8601112565445026;0.7077922077922078;115;120;3056;2464;0.03763089005235602;0.048701298701298704;.\data\pcb_defects_kaggle\images/Short/04_short_02.jpg;4
1549;short;2255;1562;2362;1702;.\data\pcb_defects_kaggle\Annotations\Short\04_short_03;0.7553992146596858;0.6623376623376623;107;140;3056;2464;0.0350130890052356;0.056818181818181816;.\data\pcb_defects_kaggle\images/Short/04_short_03.jpg;4
1550;short;1404;1148;1526;1264;.\data\pcb_defects_kaggle\Annotations\Short\04_short_03;0.4793848167539267;0.48944805194805197;122;116;3056;2464;0.03992146596858639;0.04707792207792208;.\data\pcb_defects_kaggle\images/Short/04_short_03.jpg;4
1551;short;975;2024;1126;2197;.\data\pcb_defects_kaggle\Annotations\Short\04_short_03;0.34375;0.8565340909090909;151;173;3056;2464;0.049410994764397906;0.07021103896103896;.\data\pcb_defects_kaggle\images/Short/04_short_03.jpg;4
1552;short;704;1824;828;1924;.\data\pcb_defects_kaggle\Annotations\Short\04_short_04;0.2506544502617801;0.760551948051948;124;100;3056;2464;0.04057591623036649;0.040584415584415584;.\data\pcb_defects_kaggle\images/Short/04_short_04.jpg;4
1553;short;2046;1655;2119;1748;.\data\pcb_defects_kaggle\Annotations\Short\04_short_04;0.681446335078534;0.6905438311688312;73;93;3056;2464;0.023887434554973823;0.037743506493506496;.\data\pcb_defects_kaggle\images/Short/04_short_04.jpg;4
1554;short;241;2111;335;2199;.\data\pcb_defects_kaggle\Annotations\Short\04_short_04;0.09424083769633508;0.8745941558441559;94;88;3056;2464;0.030759162303664923;0.03571428571428571;.\data\pcb_defects_kaggle\images/Short/04_short_04.jpg;4
1555;short;1742;782;1839;882;.\data\pcb_defects_kaggle\Annotations\Short\04_short_05;0.5858965968586387;0.33766233766233766;97;100;3056;2464;0.03174083769633508;0.040584415584415584;.\data\pcb_defects_kaggle\images/Short/04_short_05.jpg;4
1556;short;2097;1026;2226;1155;.\data\pcb_defects_kaggle\Annotations\Short\04_short_05;0.7072971204188482;0.44257305194805197;129;129;3056;2464;0.04221204188481675;0.052353896103896104;.\data\pcb_defects_kaggle\images/Short/04_short_05.jpg;4
1557;short;1886;375;1988;477;.\data\pcb_defects_kaggle\Annotations\Short\04_short_05;0.6338350785340314;0.1728896103896104;102;102;3056;2464;0.03337696335078534;0.041396103896103896;.\data\pcb_defects_kaggle\images/Short/04_short_05.jpg;4
1558;short;1190;550;1271;626;.\data\pcb_defects_kaggle\Annotations\Short\04_short_06;0.4026505235602094;0.23863636363636365;81;76;3056;2464;0.02650523560209424;0.030844155844155844;.\data\pcb_defects_kaggle\images/Short/04_short_06.jpg;4
1559;short;1248;237;1330;322;.\data\pcb_defects_kaggle\Annotations\Short\04_short_06;0.42179319371727747;0.11343344155844155;82;85;3056;2464;0.026832460732984294;0.03449675324675325;.\data\pcb_defects_kaggle\images/Short/04_short_06.jpg;4
1560;short;835;873;930;957;.\data\pcb_defects_kaggle\Annotations\Short\04_short_06;0.28877617801047123;0.3713474025974026;95;84;3056;2464;0.031086387434554975;0.03409090909090909;.\data\pcb_defects_kaggle\images/Short/04_short_06.jpg;4
1561;short;893;1508;990;1610;.\data\pcb_defects_kaggle\Annotations\Short\04_short_07;0.3080824607329843;0.632711038961039;97;102;3056;2464;0.03174083769633508;0.041396103896103896;.\data\pcb_defects_kaggle\images/Short/04_short_07.jpg;4
1562;short;1902;1344;2039;1457;.\data\pcb_defects_kaggle\Annotations\Short\04_short_07;0.6447971204188482;0.5683847402597403;137;113;3056;2464;0.044829842931937175;0.04586038961038961;.\data\pcb_defects_kaggle\images/Short/04_short_07.jpg;4
1563;short;2019;1641;2124;1768;.\data\pcb_defects_kaggle\Annotations\Short\04_short_07;0.6778468586387435;0.6917613636363636;105;127;3056;2464;0.034358638743455495;0.05154220779220779;.\data\pcb_defects_kaggle\images/Short/04_short_07.jpg;4
1564;short;402;1177;486;1273;.\data\pcb_defects_kaggle\Annotations\Short\04_short_08;0.14528795811518325;0.4971590909090909;84;96;3056;2464;0.0274869109947644;0.03896103896103896;.\data\pcb_defects_kaggle\images/Short/04_short_08.jpg;4
1565;short;901;1002;988;1091;.\data\pcb_defects_kaggle\Annotations\Short\04_short_08;0.3090641361256545;0.4247159090909091;87;89;3056;2464;0.028468586387434554;0.03612012987012987;.\data\pcb_defects_kaggle\images/Short/04_short_08.jpg;4
1566;short;499;1593;595;1711;.\data\pcb_defects_kaggle\Annotations\Short\04_short_08;0.17899214659685864;0.6704545454545454;96;118;3056;2464;0.031413612565445025;0.04788961038961039;.\data\pcb_defects_kaggle\images/Short/04_short_08.jpg;4
1567;short;1906;1590;1997;1690;.\data\pcb_defects_kaggle\Annotations\Short\04_short_09;0.6385798429319371;0.6655844155844156;91;100;3056;2464;0.029777486910994765;0.040584415584415584;.\data\pcb_defects_kaggle\images/Short/04_short_09.jpg;4
1568;short;2499;1597;2604;1704;.\data\pcb_defects_kaggle\Annotations\Short\04_short_09;0.8349149214659686;0.6698457792207793;105;107;3056;2464;0.034358638743455495;0.04342532467532467;.\data\pcb_defects_kaggle\images/Short/04_short_09.jpg;4
1569;short;1533;1371;1622;1455;.\data\pcb_defects_kaggle\Annotations\Short\04_short_09;0.5161976439790575;0.5734577922077922;89;84;3056;2464;0.02912303664921466;0.03409090909090909;.\data\pcb_defects_kaggle\images/Short/04_short_09.jpg;4
1570;short;2006;1537;2091;1635;.\data\pcb_defects_kaggle\Annotations\Short\04_short_10;0.6703206806282722;0.6436688311688312;85;98;3056;2464;0.027814136125654452;0.03977272727272727;.\data\pcb_defects_kaggle\images/Short/04_short_10.jpg;4
1571;short;1390;1090;1490;1197;.\data\pcb_defects_kaggle\Annotations\Short\04_short_10;0.4712041884816754;0.4640827922077922;100;107;3056;2464;0.032722513089005235;0.04342532467532467;.\data\pcb_defects_kaggle\images/Short/04_short_10.jpg;4
1572;short;2488;884;2586;1001;.\data\pcb_defects_kaggle\Annotations\Short\04_short_10;0.8301701570680629;0.38250811688311687;98;117;3056;2464;0.03206806282722513;0.04748376623376623;.\data\pcb_defects_kaggle\images/Short/04_short_10.jpg;4
1573;short;444;1324;550;1422;.\data\pcb_defects_kaggle\Annotations\Short\04_short_11;0.162630890052356;0.557224025974026;106;98;3056;2464;0.03468586387434555;0.03977272727272727;.\data\pcb_defects_kaggle\images/Short/04_short_11.jpg;4
1574;short;830;1130;906;1210;.\data\pcb_defects_kaggle\Annotations\Short\04_short_11;0.28403141361256545;0.47483766233766234;76;80;3056;2464;0.024869109947643978;0.032467532467532464;.\data\pcb_defects_kaggle\images/Short/04_short_11.jpg;4
1575;short;2050;655;2197;766;.\data\pcb_defects_kaggle\Annotations\Short\04_short_11;0.6948625654450262;0.2883522727272727;147;111;3056;2464;0.048102094240837695;0.045048701298701296;.\data\pcb_defects_kaggle\images/Short/04_short_11.jpg;4
1576;short;391;1193;493;1290;.\data\pcb_defects_kaggle\Annotations\Short\04_short_12;0.14463350785340315;0.5038555194805194;102;97;3056;2464;0.03337696335078534;0.03936688311688312;.\data\pcb_defects_kaggle\images/Short/04_short_12.jpg;4
1577;short;499;1606;597;1715;.\data\pcb_defects_kaggle\Annotations\Short\04_short_12;0.1793193717277487;0.6739042207792207;98;109;3056;2464;0.03206806282722513;0.044237012987012984;.\data\pcb_defects_kaggle\images/Short/04_short_12.jpg;4
1578;short;1130;1862;1241;1977;.\data\pcb_defects_kaggle\Annotations\Short\04_short_12;0.3879253926701571;0.7790178571428571;111;115;3056;2464;0.03632198952879581;0.04667207792207792;.\data\pcb_defects_kaggle\images/Short/04_short_12.jpg;4
1579;short;1899;1299;2033;1410;.\data\pcb_defects_kaggle\Annotations\Short\04_short_13;0.643324607329843;0.5497159090909091;134;111;3056;2464;0.04384816753926701;0.045048701298701296;.\data\pcb_defects_kaggle\images/Short/04_short_13.jpg;4
1580;short;446;2235;559;2362;.\data\pcb_defects_kaggle\Annotations\Short\04_short_13;0.1644306282722513;0.9328327922077922;113;127;3056;2464;0.03697643979057592;0.05154220779220779;.\data\pcb_defects_kaggle\images/Short/04_short_13.jpg;4
1581;short;237;1971;337;2075;.\data\pcb_defects_kaggle\Annotations\Short\04_short_13;0.09391361256544503;0.8210227272727273;100;104;3056;2464;0.032722513089005235;0.04220779220779221;.\data\pcb_defects_kaggle\images/Short/04_short_13.jpg;4
1582;short;1486;657;1559;737;.\data\pcb_defects_kaggle\Annotations\Short\04_short_14;0.49820026178010474;0.28287337662337664;73;80;3056;2464;0.023887434554973823;0.032467532467532464;.\data\pcb_defects_kaggle\images/Short/04_short_14.jpg;4
1583;short;730;1802;821;1897;.\data\pcb_defects_kaggle\Annotations\Short\04_short_14;0.2537630890052356;0.7506087662337663;91;95;3056;2464;0.029777486910994765;0.03855519480519481;.\data\pcb_defects_kaggle\images/Short/04_short_14.jpg;4
1584;short;1750;768;1844;881;.\data\pcb_defects_kaggle\Annotations\Short\04_short_14;0.588023560209424;0.3346185064935065;94;113;3056;2464;0.030759162303664923;0.04586038961038961;.\data\pcb_defects_kaggle\images/Short/04_short_14.jpg;4
1585;short;2070;599;2188;721;.\data\pcb_defects_kaggle\Annotations\Short\04_short_15;0.6966623036649214;0.26785714285714285;118;122;3056;2464;0.03861256544502618;0.049512987012987016;.\data\pcb_defects_kaggle\images/Short/04_short_15.jpg;4
1586;short;2581;982;2699;1102;.\data\pcb_defects_kaggle\Annotations\Short\04_short_15;0.8638743455497382;0.42288961038961037;118;120;3056;2464;0.03861256544502618;0.048701298701298704;.\data\pcb_defects_kaggle\images/Short/04_short_15.jpg;4
1587;short;2244;1155;2364;1277;.\data\pcb_defects_kaggle\Annotations\Short\04_short_15;0.7539267015706806;0.4935064935064935;120;122;3056;2464;0.03926701570680628;0.049512987012987016;.\data\pcb_defects_kaggle\images/Short/04_short_15.jpg;4
1588;short;1090;1139;1190;1241;.\data\pcb_defects_kaggle\Annotations\Short\04_short_16;0.3730366492146597;0.48295454545454547;100;102;3056;2464;0.032722513089005235;0.041396103896103896;.\data\pcb_defects_kaggle\images/Short/04_short_16.jpg;4
1589;short;1853;1033;1955;1121;.\data\pcb_defects_kaggle\Annotations\Short\04_short_16;0.6230366492146597;0.43709415584415584;102;88;3056;2464;0.03337696335078534;0.03571428571428571;.\data\pcb_defects_kaggle\images/Short/04_short_16.jpg;4
1590;short;1135;497;1210;584;.\data\pcb_defects_kaggle\Annotations\Short\04_short_17;0.38367146596858637;0.21935876623376624;75;87;3056;2464;0.02454188481675393;0.03530844155844156;.\data\pcb_defects_kaggle\images/Short/04_short_17.jpg;4
1591;short;961;1148;1048;1233;.\data\pcb_defects_kaggle\Annotations\Short\04_short_17;0.3286976439790576;0.4831574675324675;87;85;3056;2464;0.028468586387434554;0.03449675324675325;.\data\pcb_defects_kaggle\images/Short/04_short_17.jpg;4
1592;short;442;1195;550;1284;.\data\pcb_defects_kaggle\Annotations\Short\04_short_17;0.16230366492146597;0.5030438311688312;108;89;3056;2464;0.03534031413612566;0.03612012987012987;.\data\pcb_defects_kaggle\images/Short/04_short_17.jpg;4
1593;short;377;2177;482;2291;.\data\pcb_defects_kaggle\Annotations\Short\04_short_18;0.1405431937172775;0.9066558441558441;105;114;3056;2464;0.034358638743455495;0.04626623376623377;.\data\pcb_defects_kaggle\images/Short/04_short_18.jpg;4
1594;short;631;2166;728;2264;.\data\pcb_defects_kaggle\Annotations\Short\04_short_18;0.22234947643979058;0.8989448051948052;97;98;3056;2464;0.03174083769633508;0.03977272727272727;.\data\pcb_defects_kaggle\images/Short/04_short_18.jpg;4
1595;short;2404;1697;2521;1824;.\data\pcb_defects_kaggle\Annotations\Short\04_short_18;0.8057918848167539;0.7144886363636364;117;127;3056;2464;0.03828534031413613;0.05154220779220779;.\data\pcb_defects_kaggle\images/Short/04_short_18.jpg;4
1596;short;444;1284;548;1371;.\data\pcb_defects_kaggle\Annotations\Short\04_short_19;0.16230366492146597;0.5387581168831169;104;87;3056;2464;0.034031413612565446;0.03530844155844156;.\data\pcb_defects_kaggle\images/Short/04_short_19.jpg;4
1597;short;502;1928;619;2044;.\data\pcb_defects_kaggle\Annotations\Short\04_short_19;0.18340968586387435;0.8060064935064936;117;116;3056;2464;0.03828534031413613;0.04707792207792208;.\data\pcb_defects_kaggle\images/Short/04_short_19.jpg;4
1598;short;497;1582;595;1695;.\data\pcb_defects_kaggle\Annotations\Short\04_short_19;0.17866492146596857;0.6649756493506493;98;113;3056;2464;0.03206806282722513;0.04586038961038961;.\data\pcb_defects_kaggle\images/Short/04_short_19.jpg;4
1599;short;1111;490;1221;608;.\data\pcb_defects_kaggle\Annotations\Short\04_short_20;0.38154450261780104;0.22280844155844157;110;118;3056;2464;0.03599476439790576;0.04788961038961039;.\data\pcb_defects_kaggle\images/Short/04_short_20.jpg;4
1600;short;1802;1168;1888;1259;.\data\pcb_defects_kaggle\Annotations\Short\04_short_20;0.6037303664921466;0.49249188311688313;86;91;3056;2464;0.0281413612565445;0.036931818181818184;.\data\pcb_defects_kaggle\images/Short/04_short_20.jpg;4
1601;short;1261;1210;1350;1297;.\data\pcb_defects_kaggle\Annotations\Short\04_short_20;0.4271924083769634;0.5087256493506493;89;87;3056;2464;0.02912303664921466;0.03530844155844156;.\data\pcb_defects_kaggle\images/Short/04_short_20.jpg;4
1602;short;1653;1249;1728;1326;.\data\pcb_defects_kaggle\Annotations\Short\05_short_01;0.6645047169811321;0.5971706864564007;75;77;2544;2156;0.0294811320754717;0.03571428571428571;.\data\pcb_defects_kaggle\images/Short/05_short_01.jpg;4
1603;short;2163;1776;2256;1860;.\data\pcb_defects_kaggle\Annotations\Short\05_short_01;0.8685141509433962;0.8432282003710575;93;84;2544;2156;0.036556603773584904;0.03896103896103896;.\data\pcb_defects_kaggle\images/Short/05_short_01.jpg;4
1604;short;2264;1490;2331;1551;.\data\pcb_defects_kaggle\Annotations\Short\05_short_01;0.9031053459119497;0.7052411873840445;67;61;2544;2156;0.026336477987421385;0.02829313543599258;.\data\pcb_defects_kaggle\images/Short/05_short_01.jpg;4
1605;short;1845;1340;1922;1412;.\data\pcb_defects_kaggle\Annotations\Short\05_short_02;0.7403694968553459;0.6382189239332097;77;72;2544;2156;0.030267295597484277;0.03339517625231911;.\data\pcb_defects_kaggle\images/Short/05_short_02.jpg;4
1606;short;1485;1706;1552;1771;.\data\pcb_defects_kaggle\Annotations\Short\05_short_02;0.5968946540880503;0.8063543599257885;67;65;2544;2156;0.026336477987421385;0.030148423005565864;.\data\pcb_defects_kaggle\images/Short/05_short_02.jpg;4
1607;short;136;995;205;1059;.\data\pcb_defects_kaggle\Annotations\Short\05_short_02;0.06702044025157233;0.47634508348794063;69;64;2544;2156;0.027122641509433963;0.029684601113172542;.\data\pcb_defects_kaggle\images/Short/05_short_02.jpg;4
1608;short;2285;1818;2364;1893;.\data\pcb_defects_kaggle\Annotations\Short\05_short_03;0.9137185534591195;0.860621521335807;79;75;2544;2156;0.031053459119496855;0.034786641929499075;.\data\pcb_defects_kaggle\images/Short/05_short_03.jpg;4
1609;short;2400;1684;2460;1740;.\data\pcb_defects_kaggle\Annotations\Short\05_short_03;0.9551886792452831;0.7940630797773655;60;56;2544;2156;0.02358490566037736;0.025974025974025976;.\data\pcb_defects_kaggle\images/Short/05_short_03.jpg;4
1610;short;1578;1135;1660;1207;.\data\pcb_defects_kaggle\Annotations\Short\05_short_03;0.6363993710691824;0.5431354359925789;82;72;2544;2156;0.03223270440251572;0.03339517625231911;.\data\pcb_defects_kaggle\images/Short/05_short_03.jpg;4
1611;short;1856;1332;1938;1413;.\data\pcb_defects_kaggle\Annotations\Short\05_short_04;0.7456761006289309;0.636595547309833;82;81;2544;2156;0.03223270440251572;0.037569573283859;.\data\pcb_defects_kaggle\images/Short/05_short_04.jpg;4
1612;short;1380;1512;1449;1584;.\data\pcb_defects_kaggle\Annotations\Short\05_short_04;0.5560141509433962;0.7179962894248608;69;72;2544;2156;0.027122641509433963;0.03339517625231911;.\data\pcb_defects_kaggle\images/Short/05_short_04.jpg;4
1613;short;1983;904;2099;984;.\data\pcb_defects_kaggle\Annotations\Short\05_short_04;0.8022798742138365;0.437847866419295;116;80;2544;2156;0.04559748427672956;0.03710575139146568;.\data\pcb_defects_kaggle\images/Short/05_short_04.jpg;4
1614;short;2253;1492;2324;1559;.\data\pcb_defects_kaggle\Annotations\Short\05_short_05;0.8995676100628931;0.7075602968460112;71;67;2544;2156;0.02790880503144654;0.031076066790352505;.\data\pcb_defects_kaggle\images/Short/05_short_05.jpg;4
1615;short;2399;1568;2466;1635;.\data\pcb_defects_kaggle\Annotations\Short\05_short_05;0.9561713836477987;0.7428107606679035;67;67;2544;2156;0.026336477987421385;0.031076066790352505;.\data\pcb_defects_kaggle\images/Short/05_short_05.jpg;4
1616;short;1531;1076;1605;1157;.\data\pcb_defects_kaggle\Annotations\Short\05_short_05;0.6163522012578616;0.5178571428571429;74;81;2544;2156;0.02908805031446541;0.037569573283859;.\data\pcb_defects_kaggle\images/Short/05_short_05.jpg;4
1617;short;585;634;672;728;.\data\pcb_defects_kaggle\Annotations\Short\05_short_06;0.24705188679245282;0.31586270871985156;87;94;2544;2156;0.03419811320754717;0.04359925788497217;.\data\pcb_defects_kaggle\images/Short/05_short_06.jpg;4
1618;short;1999;874;2080;943;.\data\pcb_defects_kaggle\Annotations\Short\05_short_06;0.8016902515723271;0.4213821892393321;81;69;2544;2156;0.031839622641509434;0.03200371057513915;.\data\pcb_defects_kaggle\images/Short/05_short_06.jpg;4
1619;short;1981;356;2056;423;.\data\pcb_defects_kaggle\Annotations\Short\05_short_06;0.793435534591195;0.18065862708719851;75;67;2544;2156;0.0294811320754717;0.031076066790352505;.\data\pcb_defects_kaggle\images/Short/05_short_06.jpg;4
1620;short;1960;1335;2045;1410;.\data\pcb_defects_kaggle\Annotations\Short\05_short_07;0.7871462264150944;0.636595547309833;85;75;2544;2156;0.03341194968553459;0.034786641929499075;.\data\pcb_defects_kaggle\images/Short/05_short_07.jpg;4
1621;short;2256;1781;2364;1857;.\data\pcb_defects_kaggle\Annotations\Short\05_short_07;0.9080188679245284;0.8436920222634509;108;76;2544;2156;0.04245283018867924;0.03525046382189239;.\data\pcb_defects_kaggle\images/Short/05_short_07.jpg;4
1622;short;400;295;510;387;.\data\pcb_defects_kaggle\Annotations\Short\05_short_07;0.17885220125786164;0.15816326530612246;110;92;2544;2156;0.04323899371069182;0.04267161410018553;.\data\pcb_defects_kaggle\images/Short/05_short_07.jpg;4
1623;short;1022;1496;1111;1590;.\data\pcb_defects_kaggle\Annotations\Short\05_short_07;0.41922169811320753;0.7156771799628943;89;94;2544;2156;0.03498427672955975;0.04359925788497217;.\data\pcb_defects_kaggle\images/Short/05_short_07.jpg;4
1624;short;2361;1617;2431;1682;.\data\pcb_defects_kaggle\Annotations\Short\05_short_08;0.9418238993710691;0.765074211502783;70;65;2544;2156;0.027515723270440252;0.030148423005565864;.\data\pcb_defects_kaggle\images/Short/05_short_08.jpg;4
1625;short;1467;1698;1558;1779;.\data\pcb_defects_kaggle\Annotations\Short\05_short_08;0.5945361635220126;0.8063543599257885;91;81;2544;2156;0.035770440251572326;0.037569573283859;.\data\pcb_defects_kaggle\images/Short/05_short_08.jpg;4
1626;short;1706;542;1822;637;.\data\pcb_defects_kaggle\Annotations\Short\05_short_08;0.6933962264150944;0.2734230055658627;116;95;2544;2156;0.04559748427672956;0.04406307977736549;.\data\pcb_defects_kaggle\images/Short/05_short_08.jpg;4
1627;short;370;807;456;899;.\data\pcb_defects_kaggle\Annotations\Short\05_short_09;0.1623427672955975;0.39564007421150277;86;92;2544;2156;0.03380503144654088;0.04267161410018553;.\data\pcb_defects_kaggle\images/Short/05_short_09.jpg;4
1628;short;1670;1307;1763;1396;.\data\pcb_defects_kaggle\Annotations\Short\05_short_09;0.6747248427672956;0.6268552875695733;93;89;2544;2156;0.036556603773584904;0.041280148423005564;.\data\pcb_defects_kaggle\images/Short/05_short_09.jpg;4
1629;short;2000;765;2081;843;.\data\pcb_defects_kaggle\Annotations\Short\05_short_09;0.8020833333333334;0.37291280148423006;81;78;2544;2156;0.031839622641509434;0.036178107606679034;.\data\pcb_defects_kaggle\images/Short/05_short_09.jpg;4
1630;short;1497;270;1580;349;.\data\pcb_defects_kaggle\Annotations\Short\05_short_10;0.6047562893081762;0.14355287569573283;83;79;2544;2156;0.03262578616352201;0.036641929499072357;.\data\pcb_defects_kaggle\images/Short/05_short_10.jpg;4
1631;short;1119;393;1213;467;.\data\pcb_defects_kaggle\Annotations\Short\05_short_10;0.4583333333333333;0.19944341372912802;94;74;2544;2156;0.036949685534591194;0.03432282003710575;.\data\pcb_defects_kaggle\images/Short/05_short_10.jpg;4
1632;short;1662;1637;1725;1692;.\data\pcb_defects_kaggle\Annotations\Short\06_short_01;0.5904811715481172;0.7186960276338514;63;55;2868;2316;0.021966527196652718;0.023747841105354058;.\data\pcb_defects_kaggle\images/Short/06_short_01.jpg;4
1633;short;1935;858;1986;907;.\data\pcb_defects_kaggle\Annotations\Short\06_short_01;0.6835774058577406;0.3810449050086356;51;49;2868;2316;0.01778242677824268;0.021157167530224525;.\data\pcb_defects_kaggle\images/Short/06_short_01.jpg;4
1634;short;1701;480;1771;539;.\data\pcb_defects_kaggle\Annotations\Short\06_short_01;0.6052998605299861;0.21999136442141623;70;59;2868;2316;0.024407252440725245;0.02547495682210708;.\data\pcb_defects_kaggle\images/Short/06_short_01.jpg;4
1635;short;688;890;772;961;.\data\pcb_defects_kaggle\Annotations\Short\06_short_01;0.25453277545327757;0.39961139896373055;84;71;2868;2316;0.029288702928870293;0.03065630397236615;.\data\pcb_defects_kaggle\images/Short/06_short_01.jpg;4
1636;short;1359;1049;1406;1083;.\data\pcb_defects_kaggle\Annotations\Short\06_short_01;0.48204323570432356;0.46027633851468047;47;34;2868;2316;0.016387726638772665;0.01468048359240069;.\data\pcb_defects_kaggle\images/Short/06_short_01.jpg;4
1637;short;1993;1159;2050;1217;.\data\pcb_defects_kaggle\Annotations\Short\06_short_02;0.7048465829846583;0.5129533678756477;57;58;2868;2316;0.0198744769874477;0.025043177892918825;.\data\pcb_defects_kaggle\images/Short/06_short_02.jpg;4
1638;short;1810;742;1871;792;.\data\pcb_defects_kaggle\Annotations\Short\06_short_02;0.6417364016736402;0.33117443868739205;61;50;2868;2316;0.021269177126917713;0.02158894645941278;.\data\pcb_defects_kaggle\images/Short/06_short_02.jpg;4
1639;short;1055;1047;1111;1095;.\data\pcb_defects_kaggle\Annotations\Short\06_short_02;0.3776150627615063;0.46243523316062174;56;48;2868;2316;0.019525801952580194;0.02072538860103627;.\data\pcb_defects_kaggle\images/Short/06_short_02.jpg;4
1640;short;1001;734;1067;792;.\data\pcb_defects_kaggle\Annotations\Short\06_short_02;0.36052998605299863;0.32944732297063906;66;58;2868;2316;0.02301255230125523;0.025043177892918825;.\data\pcb_defects_kaggle\images/Short/06_short_02.jpg;4
1641;short;2462;1602;2543;1676;.\data\pcb_defects_kaggle\Annotations\Short\06_short_02;0.8725592747559274;0.707685664939551;81;74;2868;2316;0.028242677824267783;0.03195164075993091;.\data\pcb_defects_kaggle\images/Short/06_short_02.jpg;4
1642;short;1927;1202;1989;1254;.\data\pcb_defects_kaggle\Annotations\Short\06_short_03;0.6827057182705718;0.5302245250431779;62;52;2868;2316;0.021617852161785217;0.022452504317789293;.\data\pcb_defects_kaggle\images/Short/06_short_03.jpg;4
1643;short;940;1302;1016;1364;.\data\pcb_defects_kaggle\Annotations\Short\06_short_03;0.3410041841004184;0.5755613126079447;76;62;2868;2316;0.026499302649930265;0.02677029360967185;.\data\pcb_defects_kaggle\images/Short/06_short_03.jpg;4
1644;short;1830;2059;1947;2147;.\data\pcb_defects_kaggle\Annotations\Short\06_short_03;0.6584728033472803;0.9080310880829016;117;88;2868;2316;0.04079497907949791;0.037996545768566495;.\data\pcb_defects_kaggle\images/Short/06_short_03.jpg;4
1645;short;428;1417;488;1481;.\data\pcb_defects_kaggle\Annotations\Short\06_short_03;0.1596931659693166;0.6256476683937824;60;64;2868;2316;0.02092050209205021;0.027633851468048358;.\data\pcb_defects_kaggle\images/Short/06_short_03.jpg;4
1646;short;159;907;240;988;.\data\pcb_defects_kaggle\Annotations\Short\06_short_03;0.06956066945606694;0.40911053540587217;81;81;2868;2316;0.028242677824267783;0.034974093264248704;.\data\pcb_defects_kaggle\images/Short/06_short_03.jpg;4
1647;short;2016;759;2079;807;.\data\pcb_defects_kaggle\Annotations\Short\06_short_04;0.7139121338912134;0.3380829015544041;63;48;2868;2316;0.021966527196652718;0.02072538860103627;.\data\pcb_defects_kaggle\images/Short/06_short_04.jpg;4
1648;short;1816;771;1871;822;.\data\pcb_defects_kaggle\Annotations\Short\06_short_04;0.6427824267782427;0.3439119170984456;55;51;2868;2316;0.019177126917712693;0.022020725388601035;.\data\pcb_defects_kaggle\images/Short/06_short_04.jpg;4
1649;short;1374;1566;1427;1617;.\data\pcb_defects_kaggle\Annotations\Short\06_short_04;0.4883193863319386;0.6871761658031088;53;51;2868;2316;0.018479776847977684;0.022020725388601035;.\data\pcb_defects_kaggle\images/Short/06_short_04.jpg;4
1650;short;486;920;574;1002;.\data\pcb_defects_kaggle\Annotations\Short\06_short_04;0.18479776847977686;0.41493955094991364;88;82;2868;2316;0.030683403068340307;0.03540587219343696;.\data\pcb_defects_kaggle\images/Short/06_short_04.jpg;4
1651;short;955;1042;1015;1097;.\data\pcb_defects_kaggle\Annotations\Short\06_short_04;0.34344490934449096;0.46178756476683935;60;55;2868;2316;0.02092050209205021;0.023747841105354058;.\data\pcb_defects_kaggle\images/Short/06_short_04.jpg;4
1652;short;1140;615;1204;683;.\data\pcb_defects_kaggle\Annotations\Short\06_short_05;0.4086471408647141;0.2802245250431779;64;68;2868;2316;0.022315202231520222;0.02936096718480138;.\data\pcb_defects_kaggle\images/Short/06_short_05.jpg;4
1653;short;1416;486;1498;541;.\data\pcb_defects_kaggle\Annotations\Short\06_short_05;0.5080195258019525;0.22171848013816925;82;55;2868;2316;0.028591352859135284;0.023747841105354058;.\data\pcb_defects_kaggle\images/Short/06_short_05.jpg;4
1654;short;933;331;1006;400;.\data\pcb_defects_kaggle\Annotations\Short\06_short_05;0.3380404463040446;0.15781519861830742;73;69;2868;2316;0.025453277545327755;0.029792746113989636;.\data\pcb_defects_kaggle\images/Short/06_short_05.jpg;4
1655;short;532;434;601;492;.\data\pcb_defects_kaggle\Annotations\Short\06_short_05;0.19752440725244072;0.19991364421416236;69;58;2868;2316;0.02405857740585774;0.025043177892918825;.\data\pcb_defects_kaggle\images/Short/06_short_05.jpg;4
1656;short;2199;1575;2272;1644;.\data\pcb_defects_kaggle\Annotations\Short\06_short_05;0.779463040446304;0.6949481865284974;73;69;2868;2316;0.025453277545327755;0.029792746113989636;.\data\pcb_defects_kaggle\images/Short/06_short_05.jpg;4
1657;short;1510;920;1572;975;.\data\pcb_defects_kaggle\Annotations\Short\06_short_06;0.5373082287308228;0.40911053540587217;62;55;2868;2316;0.021617852161785217;0.023747841105354058;.\data\pcb_defects_kaggle\images/Short/06_short_06.jpg;4
1658;short;1740;800;1801;853;.\data\pcb_defects_kaggle\Annotations\Short\06_short_06;0.6173291492329149;0.35686528497409326;61;53;2868;2316;0.021269177126917713;0.022884283246977548;.\data\pcb_defects_kaggle\images/Short/06_short_06.jpg;4
1659;short;1199;1085;1257;1136;.\data\pcb_defects_kaggle\Annotations\Short\06_short_06;0.4281729428172943;0.4794905008635579;58;51;2868;2316;0.020223152022315203;0.022020725388601035;.\data\pcb_defects_kaggle\images/Short/06_short_06.jpg;4
1660;short;1737;1564;1799;1619;.\data\pcb_defects_kaggle\Annotations\Short\06_short_06;0.6164574616457462;0.6871761658031088;62;55;2868;2316;0.021617852161785217;0.023747841105354058;.\data\pcb_defects_kaggle\images/Short/06_short_06.jpg;4
1661;short;1206;1264;1269;1324;.\data\pcb_defects_kaggle\Annotations\Short\06_short_06;0.4314853556485356;0.5587219343696027;63;60;2868;2316;0.021966527196652718;0.025906735751295335;.\data\pcb_defects_kaggle\images/Short/06_short_06.jpg;4
1662;short;2079;1492;2137;1544;.\data\pcb_defects_kaggle\Annotations\Short\06_short_07;0.7350069735006973;0.655440414507772;58;52;2868;2316;0.020223152022315203;0.022452504317789293;.\data\pcb_defects_kaggle\images/Short/06_short_07.jpg;4
1663;short;1035;2127;1113;2205;.\data\pcb_defects_kaggle\Annotations\Short\06_short_07;0.37447698744769875;0.9352331606217616;78;78;2868;2316;0.027196652719665274;0.03367875647668394;.\data\pcb_defects_kaggle\images/Short/06_short_07.jpg;4
1664;short;2311;1898;2372;1963;.\data\pcb_defects_kaggle\Annotations\Short\06_short_07;0.8164225941422594;0.8335492227979274;61;65;2868;2316;0.021269177126917713;0.028065630397236616;.\data\pcb_defects_kaggle\images/Short/06_short_07.jpg;4
1665;short;121;1353;198;1415;.\data\pcb_defects_kaggle\Annotations\Short\06_short_07;0.055613668061366806;0.5975820379965457;77;62;2868;2316;0.02684797768479777;0.02677029360967185;.\data\pcb_defects_kaggle\images/Short/06_short_07.jpg;4
1666;short;659;1927;737;2000;.\data\pcb_defects_kaggle\Annotations\Short\06_short_07;0.24337517433751743;0.8477979274611399;78;73;2868;2316;0.027196652719665274;0.03151986183074266;.\data\pcb_defects_kaggle\images/Short/06_short_07.jpg;4
1667;short;428;1409;481;1463;.\data\pcb_defects_kaggle\Annotations\Short\06_short_08;0.15847280334728034;0.6200345423143351;53;54;2868;2316;0.018479776847977684;0.023316062176165803;.\data\pcb_defects_kaggle\images/Short/06_short_08.jpg;4
1668;short;871;251;952;305;.\data\pcb_defects_kaggle\Annotations\Short\06_short_08;0.31781729428172945;0.12003454231433507;81;54;2868;2316;0.028242677824267783;0.023316062176165803;.\data\pcb_defects_kaggle\images/Short/06_short_08.jpg;4
1669;short;254;725;325;803;.\data\pcb_defects_kaggle\Annotations\Short\06_short_08;0.10094142259414227;0.3298791018998273;71;78;2868;2316;0.024755927475592746;0.03367875647668394;.\data\pcb_defects_kaggle\images/Short/06_short_08.jpg;4
1670;short;528;459;604;524;.\data\pcb_defects_kaggle\Annotations\Short\06_short_08;0.19735006973500696;0.21221934369602763;76;65;2868;2316;0.026499302649930265;0.028065630397236616;.\data\pcb_defects_kaggle\images/Short/06_short_08.jpg;4
1671;short;720;92;791;163;.\data\pcb_defects_kaggle\Annotations\Short\06_short_08;0.26342398884239887;0.05505181347150259;71;71;2868;2316;0.024755927475592746;0.03065630397236615;.\data\pcb_defects_kaggle\images/Short/06_short_08.jpg;4
1672;short;1104;364;1165;436;.\data\pcb_defects_kaggle\Annotations\Short\06_short_09;0.3955718270571827;0.17271157167530224;61;72;2868;2316;0.021269177126917713;0.031088082901554404;.\data\pcb_defects_kaggle\images/Short/06_short_09.jpg;4
1673;short;1745;476;1818;537;.\data\pcb_defects_kaggle\Annotations\Short\06_short_09;0.6211645746164575;0.21869602763385146;73;61;2868;2316;0.025453277545327755;0.026338514680483593;.\data\pcb_defects_kaggle\images/Short/06_short_09.jpg;4
1674;short;2030;314;2125;398;.\data\pcb_defects_kaggle\Annotations\Short\06_short_09;0.7243723849372385;0.153713298791019;95;84;2868;2316;0.033124128312412834;0.03626943005181347;.\data\pcb_defects_kaggle\images/Short/06_short_09.jpg;4
1675;short;882;325;962;405;.\data\pcb_defects_kaggle\Annotations\Short\06_short_09;0.3214783821478382;0.15759930915371329;80;80;2868;2316;0.02789400278940028;0.03454231433506045;.\data\pcb_defects_kaggle\images/Short/06_short_09.jpg;4
1676;short;571;593;638;658;.\data\pcb_defects_kaggle\Annotations\Short\06_short_09;0.21077405857740586;0.2700777202072539;67;65;2868;2316;0.023361227336122732;0.028065630397236616;.\data\pcb_defects_kaggle\images/Short/06_short_09.jpg;4
1677;short;1798;739;1865;795;.\data\pcb_defects_kaggle\Annotations\Short\06_short_10;0.6385983263598326;0.33117443868739205;67;56;2868;2316;0.023361227336122732;0.024179620034542316;.\data\pcb_defects_kaggle\images/Short/06_short_10.jpg;4
1678;short;1540;1085;1604;1132;.\data\pcb_defects_kaggle\Annotations\Short\06_short_10;0.5481171548117155;0.4786269430051813;64;47;2868;2316;0.022315202231520222;0.020293609671848015;.\data\pcb_defects_kaggle\images/Short/06_short_10.jpg;4
1679;short;1069;1064;1137;1137;.\data\pcb_defects_kaggle\Annotations\Short\06_short_10;0.38458856345885634;0.4751727115716753;68;73;2868;2316;0.023709902370990237;0.03151986183074266;.\data\pcb_defects_kaggle\images/Short/06_short_10.jpg;4
1680;short;1565;1247;1632;1300;.\data\pcb_defects_kaggle\Annotations\Short\06_short_10;0.5573570432357043;0.5498704663212435;67;53;2868;2316;0.023361227336122732;0.022884283246977548;.\data\pcb_defects_kaggle\images/Short/06_short_10.jpg;4
1681;short;1376;1517;1435;1570;.\data\pcb_defects_kaggle\Annotations\Short\06_short_10;0.49006276150627615;0.6664507772020726;59;53;2868;2316;0.020571827057182707;0.022884283246977548;.\data\pcb_defects_kaggle\images/Short/06_short_10.jpg;4
1682;short;1798;544;1879;615;.\data\pcb_defects_kaggle\Annotations\Short\06_short_11;0.6410390516039052;0.2502158894645941;81;71;2868;2316;0.028242677824267783;0.03065630397236615;.\data\pcb_defects_kaggle\images/Short/06_short_11.jpg;4
1683;short;1901;1268;1962;1329;.\data\pcb_defects_kaggle\Annotations\Short\06_short_11;0.673465829846583;0.5606649395509499;61;61;2868;2316;0.021269177126917713;0.026338514680483593;.\data\pcb_defects_kaggle\images/Short/06_short_11.jpg;4
1684;short;2047;1285;2115;1339;.\data\pcb_defects_kaggle\Annotations\Short\06_short_11;0.7255927475592747;0.5664939550949913;68;54;2868;2316;0.023709902370990237;0.023316062176165803;.\data\pcb_defects_kaggle\images/Short/06_short_11.jpg;4
1685;short;1767;1588;1845;1649;.\data\pcb_defects_kaggle\Annotations\Short\06_short_11;0.6297071129707112;0.6988341968911918;78;61;2868;2316;0.027196652719665274;0.026338514680483593;.\data\pcb_defects_kaggle\images/Short/06_short_11.jpg;4
1686;short;999;731;1060;797;.\data\pcb_defects_kaggle\Annotations\Short\06_short_11;0.3589609483960948;0.3298791018998273;61;66;2868;2316;0.021269177126917713;0.02849740932642487;.\data\pcb_defects_kaggle\images/Short/06_short_11.jpg;4
1687;short;899;353;1003;427;.\data\pcb_defects_kaggle\Annotations\Short\07_short_01;0.3274793388429752;0.2030192608016658;104;74;2904;1921;0.03581267217630854;0.038521603331598125;.\data\pcb_defects_kaggle\images/Short/07_short_01.jpg;4
1688;short;398;622;539;731;.\data\pcb_defects_kaggle\Annotations\Short\07_short_01;0.1613292011019284;0.3521603331598126;141;109;2904;1921;0.04855371900826446;0.05674128058302967;.\data\pcb_defects_kaggle\images/Short/07_short_01.jpg;4
1689;short;1229;869;1310;955;.\data\pcb_defects_kaggle\Annotations\Short\07_short_01;0.4371556473829201;0.4747527329515877;81;86;2904;1921;0.027892561983471075;0.04476834981780323;.\data\pcb_defects_kaggle\images/Short/07_short_01.jpg;4
1690;short;1863;924;1961;1012;.\data\pcb_defects_kaggle\Annotations\Short\07_short_01;0.6584022038567493;0.5039042165538782;98;88;2904;1921;0.0337465564738292;0.045809474232170744;.\data\pcb_defects_kaggle\images/Short/07_short_01.jpg;4
1691;short;1898;720;1987;800;.\data\pcb_defects_kaggle\Annotations\Short\07_short_01;0.668904958677686;0.3956272774596564;89;80;2904;1921;0.030647382920110194;0.041644976574700676;.\data\pcb_defects_kaggle\images/Short/07_short_01.jpg;4
1692;short;1872;619;1975;698;.\data\pcb_defects_kaggle\Annotations\Short\07_short_02;0.662362258953168;0.3427902134305049;103;79;2904;1921;0.03546831955922865;0.04112441436751692;.\data\pcb_defects_kaggle\images/Short/07_short_02.jpg;4
1693;short;1773;844;1891;941;.\data\pcb_defects_kaggle\Annotations\Short\07_short_02;0.6308539944903582;0.4646017699115044;118;97;2904;1921;0.040633608815427;0.05049453409682457;.\data\pcb_defects_kaggle\images/Short/07_short_02.jpg;4
1694;short;1427;791;1523;874;.\data\pcb_defects_kaggle\Annotations\Short\07_short_02;0.5079201101928374;0.4333680374804789;96;83;2904;1921;0.03305785123966942;0.04320666319625195;.\data\pcb_defects_kaggle\images/Short/07_short_02.jpg;4
1695;short;963;839;1082;931;.\data\pcb_defects_kaggle\Annotations\Short\07_short_02;0.35210055096418735;0.46069755335762624;119;92;2904;1921;0.040977961432506885;0.04789172306090578;.\data\pcb_defects_kaggle\images/Short/07_short_02.jpg;4
1696;short;815;236;932;334;.\data\pcb_defects_kaggle\Annotations\Short\07_short_02;0.30079201101928377;0.14836022904737117;117;98;2904;1921;0.040289256198347105;0.05101509630400833;.\data\pcb_defects_kaggle\images/Short/07_short_02.jpg;4
1697;short;1449;584;1539;676;.\data\pcb_defects_kaggle\Annotations\Short\07_short_03;0.5144628099173554;0.32795419052576785;90;92;2904;1921;0.030991735537190084;0.04789172306090578;.\data\pcb_defects_kaggle\images/Short/07_short_03.jpg;4
1698;short;1794;638;1879;732;.\data\pcb_defects_kaggle\Annotations\Short\07_short_03;0.6324035812672176;0.35658511192087455;85;94;2904;1921;0.029269972451790634;0.048932847475273294;.\data\pcb_defects_kaggle\images/Short/07_short_03.jpg;4
1699;short;2115;826;2205;934;.\data\pcb_defects_kaggle\Annotations\Short\07_short_03;0.743801652892562;0.45809474232170744;90;108;2904;1921;0.030991735537190084;0.05622071837584591;.\data\pcb_defects_kaggle\images/Short/07_short_03.jpg;4
1700;short;1403;786;1510;867;.\data\pcb_defects_kaggle\Annotations\Short\07_short_03;0.5015495867768595;0.43024466423737634;107;81;2904;1921;0.03684573002754821;0.042165538781884435;.\data\pcb_defects_kaggle\images/Short/07_short_03.jpg;4
1701;short;1162;881;1234;950;.\data\pcb_defects_kaggle\Annotations\Short\07_short_03;0.41253443526170797;0.47657470067673086;72;69;2904;1921;0.024793388429752067;0.03591879229567933;.\data\pcb_defects_kaggle\images/Short/07_short_03.jpg;4
1702;short;1717;608;1779;672;.\data\pcb_defects_kaggle\Annotations\Short\07_short_04;0.6019283746556474;0.3331598125976054;62;64;2904;1921;0.02134986225895317;0.03331598125976054;.\data\pcb_defects_kaggle\images/Short/07_short_04.jpg;4
1703;short;1432;598;1508;672;.\data\pcb_defects_kaggle\Annotations\Short\07_short_04;0.506198347107438;0.3305570015616866;76;74;2904;1921;0.026170798898071626;0.038521603331598125;.\data\pcb_defects_kaggle\images/Short/07_short_04.jpg;4
1704;short;1041;872;1127;958;.\data\pcb_defects_kaggle\Annotations\Short\07_short_04;0.37327823691460055;0.47631441957313897;86;86;2904;1921;0.029614325068870524;0.04476834981780323;.\data\pcb_defects_kaggle\images/Short/07_short_04.jpg;4
1705;short;1368;789;1444;872;.\data\pcb_defects_kaggle\Annotations\Short\07_short_04;0.48415977961432505;0.4323269130661114;76;83;2904;1921;0.026170798898071626;0.04320666319625195;.\data\pcb_defects_kaggle\images/Short/07_short_04.jpg;4
1706;short;605;591;692;681;.\data\pcb_defects_kaggle\Annotations\Short\07_short_04;0.22331267217630854;0.3310775637688704;87;90;2904;1921;0.029958677685950414;0.04685059864653826;.\data\pcb_defects_kaggle\images/Short/07_short_04.jpg;4
1707;short;1896;634;1992;717;.\data\pcb_defects_kaggle\Annotations\Short\07_short_05;0.6694214876033058;0.3516397709526288;96;83;2904;1921;0.03305785123966942;0.04320666319625195;.\data\pcb_defects_kaggle\images/Short/07_short_05.jpg;4
1708;short;1418;908;1537;998;.\data\pcb_defects_kaggle\Annotations\Short\07_short_05;0.5087809917355371;0.4960957834461218;119;90;2904;1921;0.040977961432506885;0.04685059864653826;.\data\pcb_defects_kaggle\images/Short/07_short_05.jpg;4
1709;short;2184;610;2313;691;.\data\pcb_defects_kaggle\Annotations\Short\07_short_05;0.7742768595041323;0.33862571577303485;129;81;2904;1921;0.04442148760330578;0.042165538781884435;.\data\pcb_defects_kaggle\images/Short/07_short_05.jpg;4
1710;short;1453;463;1584;546;.\data\pcb_defects_kaggle\Annotations\Short\07_short_05;0.5228994490358126;0.26262363352420615;131;83;2904;1921;0.04511019283746556;0.04320666319625195;.\data\pcb_defects_kaggle\images/Short/07_short_05.jpg;4
1711;short;2113;451;2217;534;.\data\pcb_defects_kaggle\Annotations\Short\07_short_05;0.7455234159779615;0.25637688703800104;104;83;2904;1921;0.03581267217630854;0.04320666319625195;.\data\pcb_defects_kaggle\images/Short/07_short_05.jpg;4
1712;short;1634;819;1746;898;.\data\pcb_defects_kaggle\Annotations\Short\07_short_06;0.5819559228650137;0.4469026548672566;112;79;2904;1921;0.03856749311294766;0.04112441436751692;.\data\pcb_defects_kaggle\images/Short/07_short_06.jpg;4
1713;short;2022;938;2151;1034;.\data\pcb_defects_kaggle\Annotations\Short\07_short_06;0.71849173553719;0.5132743362831859;129;96;2904;1921;0.04442148760330578;0.04997397188964081;.\data\pcb_defects_kaggle\images/Short/07_short_06.jpg;4
1714;short;1187;913;1303;998;.\data\pcb_defects_kaggle\Annotations\Short\07_short_06;0.4287190082644628;0.4973971889640812;116;85;2904;1921;0.03994490358126722;0.04424778761061947;.\data\pcb_defects_kaggle\images/Short/07_short_06.jpg;4
1715;short;387;608;530;705;.\data\pcb_defects_kaggle\Annotations\Short\07_short_06;0.15788567493112948;0.34174908901613743;143;97;2904;1921;0.04924242424242424;0.05049453409682457;.\data\pcb_defects_kaggle\images/Short/07_short_06.jpg;4
1716;short;889;355;1005;438;.\data\pcb_defects_kaggle\Annotations\Short\07_short_06;0.3261019283746556;0.20640291514836023;116;83;2904;1921;0.03994490358126722;0.04320666319625195;.\data\pcb_defects_kaggle\images/Short/07_short_06.jpg;4
1717;short;1620;631;1722;729;.\data\pcb_defects_kaggle\Annotations\Short\07_short_07;0.5754132231404959;0.35398230088495575;102;98;2904;1921;0.03512396694214876;0.05101509630400833;.\data\pcb_defects_kaggle\images/Short/07_short_07.jpg;4
1718;short;2042;884;2118;969;.\data\pcb_defects_kaggle\Annotations\Short\07_short_07;0.7162534435261708;0.4823008849557522;76;85;2904;1921;0.026170798898071626;0.04424778761061947;.\data\pcb_defects_kaggle\images/Short/07_short_07.jpg;4
1719;short;1858;920;1953;1008;.\data\pcb_defects_kaggle\Annotations\Short\07_short_07;0.65616391184573;0.5018219677251432;95;88;2904;1921;0.03271349862258953;0.045809474232170744;.\data\pcb_defects_kaggle\images/Short/07_short_07.jpg;4
1720;short;1325;826;1410;910;.\data\pcb_defects_kaggle\Annotations\Short\07_short_07;0.4709022038567493;0.45184799583550234;85;84;2904;1921;0.029269972451790634;0.04372722540343571;.\data\pcb_defects_kaggle\images/Short/07_short_07.jpg;4
1721;short;1058;872;1144;944;.\data\pcb_defects_kaggle\Annotations\Short\07_short_07;0.37913223140495866;0.4726704841228527;86;72;2904;1921;0.029614325068870524;0.03748047891723061;.\data\pcb_defects_kaggle\images/Short/07_short_07.jpg;4
1722;short;1522;631;1622;729;.\data\pcb_defects_kaggle\Annotations\Short\07_short_08;0.5413223140495868;0.35398230088495575;100;98;2904;1921;0.03443526170798898;0.05101509630400833;.\data\pcb_defects_kaggle\images/Short/07_short_08.jpg;4
1723;short;1875;677;1958;751;.\data\pcb_defects_kaggle\Annotations\Short\07_short_08;0.6599517906336089;0.37168141592920356;83;74;2904;1921;0.028581267217630855;0.038521603331598125;.\data\pcb_defects_kaggle\images/Short/07_short_08.jpg;4
1724;short;1773;843;1892;932;.\data\pcb_defects_kaggle\Annotations\Short\07_short_08;0.6310261707988981;0.4619989588755856;119;89;2904;1921;0.040977961432506885;0.0463300364393545;.\data\pcb_defects_kaggle\images/Short/07_short_08.jpg;4
1725;short;1344;826;1451;919;.\data\pcb_defects_kaggle\Annotations\Short\07_short_08;0.481232782369146;0.45419052576782926;107;93;2904;1921;0.03684573002754821;0.048412285268089536;.\data\pcb_defects_kaggle\images/Short/07_short_08.jpg;4
1726;short;1108;907;1211;1000;.\data\pcb_defects_kaggle\Annotations\Short\07_short_08;0.3992768595041322;0.4963560645497137;103;93;2904;1921;0.03546831955922865;0.048412285268089536;.\data\pcb_defects_kaggle\images/Short/07_short_08.jpg;4
1727;short;1029;238;1129;329;.\data\pcb_defects_kaggle\Annotations\Short\07_short_09;0.3715564738292011;0.14757938573659551;100;91;2904;1921;0.03443526170798898;0.04737116085372202;.\data\pcb_defects_kaggle\images/Short/07_short_09.jpg;4
1728;short;1986;677;2096;772;.\data\pcb_defects_kaggle\Annotations\Short\07_short_09;0.7028236914600551;0.377147319104633;110;95;2904;1921;0.03787878787878788;0.04945340968245705;.\data\pcb_defects_kaggle\images/Short/07_short_09.jpg;4
1729;short;1134;412;1237;529;.\data\pcb_defects_kaggle\Annotations\Short\07_short_09;0.40823002754820936;0.24492451847995836;103;117;2904;1921;0.03546831955922865;0.06090577824049974;.\data\pcb_defects_kaggle\images/Short/07_short_09.jpg;4
1730;short;1444;593;1542;681;.\data\pcb_defects_kaggle\Annotations\Short\07_short_09;0.5141184573002755;0.33159812597605415;98;88;2904;1921;0.0337465564738292;0.045809474232170744;.\data\pcb_defects_kaggle\images/Short/07_short_09.jpg;4
1731;short;817;238;930;339;.\data\pcb_defects_kaggle\Annotations\Short\07_short_09;0.30079201101928377;0.15018219677251432;113;101;2904;1921;0.038911845730027546;0.052576782925559604;.\data\pcb_defects_kaggle\images/Short/07_short_09.jpg;4
1732;short;1630;903;1746;986;.\data\pcb_defects_kaggle\Annotations\Short\07_short_10;0.581267217630854;0.49167100468505986;116;83;2904;1921;0.03994490358126722;0.04320666319625195;.\data\pcb_defects_kaggle\images/Short/07_short_10.jpg;4
1733;short;1779;836;1880;905;.\data\pcb_defects_kaggle\Annotations\Short\07_short_10;0.6299931129476584;0.4531494013534617;101;69;2904;1921;0.03477961432506887;0.03591879229567933;.\data\pcb_defects_kaggle\images/Short/07_short_10.jpg;4
1734;short;1956;386;2046;505;.\data\pcb_defects_kaggle\Annotations\Short\07_short_10;0.6890495867768595;0.23191046330036438;90;119;2904;1921;0.030991735537190084;0.061946902654867256;.\data\pcb_defects_kaggle\images/Short/07_short_10.jpg;4
1735;short;1396;786;1486;876;.\data\pcb_defects_kaggle\Annotations\Short\07_short_10;0.4962121212121212;0.43258719416970326;90;90;2904;1921;0.030991735537190084;0.04685059864653826;.\data\pcb_defects_kaggle\images/Short/07_short_10.jpg;4
1736;short;1137;913;1234;1001;.\data\pcb_defects_kaggle\Annotations\Short\07_short_10;0.40823002754820936;0.49817803227485685;97;88;2904;1921;0.03340220385674931;0.045809474232170744;.\data\pcb_defects_kaggle\images/Short/07_short_10.jpg;4
1737;short;2394;1398;2450;1459;.\data\pcb_defects_kaggle\Annotations\Short\08_short_01;0.8778542950344328;0.6631847725162489;56;61;2759;2154;0.02029720913374411;0.028319405756731662;.\data\pcb_defects_kaggle\images/Short/08_short_01.jpg;4
1738;short;2015;610;2079;659;.\data\pcb_defects_kaggle\Annotations\Short\08_short_01;0.7419354838709677;0.2945682451253482;64;49;2759;2154;0.023196810438564697;0.02274837511606314;.\data\pcb_defects_kaggle\images/Short/08_short_01.jpg;4
1739;short;1058;1210;1137;1293;.\data\pcb_defects_kaggle\Annotations\Short\08_short_01;0.3977890540050743;0.5810120705663882;79;83;2759;2154;0.028633562885103298;0.038532961931290625;.\data\pcb_defects_kaggle\images/Short/08_short_01.jpg;4
1740;short;426;1408;501;1476;.\data\pcb_defects_kaggle\Annotations\Short\08_short_01;0.16799565059804278;0.669452181987001;75;68;2759;2154;0.027183762232693004;0.031569173630454965;.\data\pcb_defects_kaggle\images/Short/08_short_01.jpg;4
1741;short;243;1823;315;1879;.\data\pcb_defects_kaggle\Annotations\Short\08_short_01;0.10112359550561797;0.8593314763231198;72;56;2759;2154;0.026096411743385284;0.025998142989786442;.\data\pcb_defects_kaggle\images/Short/08_short_01.jpg;4
1742;short;2250;1213;2325;1287;.\data\pcb_defects_kaggle\Annotations\Short\08_short_02;0.8291047480971366;0.5803156917363046;75;74;2759;2154;0.027183762232693004;0.034354688950789226;.\data\pcb_defects_kaggle\images/Short/08_short_02.jpg;4
1743;short;1743;600;1832;666;.\data\pcb_defects_kaggle\Annotations\Short\08_short_02;0.6478796665458499;0.2938718662952646;89;66;2759;2154;0.03225806451612903;0.03064066852367688;.\data\pcb_defects_kaggle\images/Short/08_short_02.jpg;4
1744;short;423;1405;509;1475;.\data\pcb_defects_kaggle\Annotations\Short\08_short_02;0.1689017760057992;0.6685236768802229;86;70;2759;2154;0.03117071402682131;0.032497678737233054;.\data\pcb_defects_kaggle\images/Short/08_short_02.jpg;4
1745;short;605;1934;694;2018;.\data\pcb_defects_kaggle\Annotations\Short\08_short_02;0.23541138093512143;0.9173630454967502;89;84;2759;2154;0.03225806451612903;0.03899721448467967;.\data\pcb_defects_kaggle\images/Short/08_short_02.jpg;4
1746;short;2517;1574;2591;1651;.\data\pcb_defects_kaggle\Annotations\Short\08_short_02;0.9256977165639725;0.7486072423398329;74;77;2759;2154;0.02682131206959043;0.03574744661095636;.\data\pcb_defects_kaggle\images/Short/08_short_02.jpg;4
1747;short;971;966;1094;1069;.\data\pcb_defects_kaggle\Annotations\Short\08_short_03;0.374229793403407;0.4723769730733519;123;103;2759;2154;0.044581370061616526;0.04781801299907149;.\data\pcb_defects_kaggle\images/Short/08_short_03.jpg;4
1748;short;758;1206;840;1287;.\data\pcb_defects_kaggle\Annotations\Short\08_short_03;0.28959768031895616;0.5786908077994429;82;81;2759;2154;0.029720913374411018;0.037604456824512536;.\data\pcb_defects_kaggle\images/Short/08_short_03.jpg;4
1749;short;2389;1326;2456;1395;.\data\pcb_defects_kaggle\Annotations\Short\08_short_03;0.8780355201159841;0.6316155988857939;67;69;2759;2154;0.024284160927872417;0.03203342618384401;.\data\pcb_defects_kaggle\images/Short/08_short_03.jpg;4
1750;short;2553;1236;2638;1326;.\data\pcb_defects_kaggle\Annotations\Short\08_short_03;0.9407393983327292;0.5947075208913649;85;90;2759;2154;0.030808263863718738;0.04178272980501393;.\data\pcb_defects_kaggle\images/Short/08_short_03.jpg;4
1751;short;2556;1623;2658;1705;.\data\pcb_defects_kaggle\Annotations\Short\08_short_03;0.9449075752084088;0.7725162488393686;102;82;2759;2154;0.036969916636462485;0.03806870937790158;.\data\pcb_defects_kaggle\images/Short/08_short_03.jpg;4
1752;short;1963;1067;2053;1154;.\data\pcb_defects_kaggle\Annotations\Short\08_short_04;0.7277999275099674;0.515552460538533;90;87;2759;2154;0.032620514679231605;0.0403899721448468;.\data\pcb_defects_kaggle\images/Short/08_short_04.jpg;4
1753;short;1841;634;1907;690;.\data\pcb_defects_kaggle\Annotations\Short\08_short_04;0.6792316056542226;0.3073351903435469;66;56;2759;2154;0.023921710764769843;0.025998142989786442;.\data\pcb_defects_kaggle\images/Short/08_short_04.jpg;4
1754;short;392;1679;451;1736;.\data\pcb_defects_kaggle\Annotations\Short\08_short_04;0.1527727437477347;0.792711234911792;59;57;2759;2154;0.02138455962305183;0.026462395543175487;.\data\pcb_defects_kaggle\images/Short/08_short_04.jpg;4
1755;short;274;1832;348;1894;.\data\pcb_defects_kaggle\Annotations\Short\08_short_04;0.11272200072490032;0.8649025069637883;74;62;2759;2154;0.02682131206959043;0.028783658310120707;.\data\pcb_defects_kaggle\images/Short/08_short_04.jpg;4
1756;short;1958;1202;2053;1261;.\data\pcb_defects_kaggle\Annotations\Short\08_short_05;0.726893802102211;0.5717270194986073;95;59;2759;2154;0.03443276549474447;0.027390900649953576;.\data\pcb_defects_kaggle\images/Short/08_short_05.jpg;4
1757;short;2250;1220;2327;1277;.\data\pcb_defects_kaggle\Annotations\Short\08_short_05;0.8294671982602392;0.5796193129062209;77;57;2759;2154;0.02790866255889815;0.026462395543175487;.\data\pcb_defects_kaggle\images/Short/08_short_05.jpg;4
1758;short;245;1741;312;1800;.\data\pcb_defects_kaggle\Annotations\Short\08_short_05;0.10094237042406669;0.8219591457753017;67;59;2759;2154;0.024284160927872417;0.027390900649953576;.\data\pcb_defects_kaggle\images/Short/08_short_05.jpg;4
1759;short;2386;1328;2453;1390;.\data\pcb_defects_kaggle\Annotations\Short\08_short_05;0.8769481696266763;0.6309192200557103;67;62;2759;2154;0.024284160927872417;0.028783658310120707;.\data\pcb_defects_kaggle\images/Short/08_short_05.jpg;4
1760;short;1976;605;2051;666;.\data\pcb_defects_kaggle\Annotations\Short\08_short_05;0.7297934034070316;0.29503249767873724;75;61;2759;2154;0.027183762232693004;0.028319405756731662;.\data\pcb_defects_kaggle\images/Short/08_short_05.jpg;4
1761;short;2009;728;2138;821;.\data\pcb_defects_kaggle\Annotations\Short\08_short_06;0.751540413193186;0.3595636025998143;129;93;2759;2154;0.04675607104023197;0.04317548746518106;.\data\pcb_defects_kaggle\images/Short/08_short_06.jpg;4
1762;short;710;1206;791;1284;.\data\pcb_defects_kaggle\Annotations\Short\08_short_06;0.2720188474084813;0.5779944289693594;81;78;2759;2154;0.029358463211308444;0.036211699164345405;.\data\pcb_defects_kaggle\images/Short/08_short_06.jpg;4
1763;short;600;1933;681;2015;.\data\pcb_defects_kaggle\Annotations\Short\08_short_06;0.23214932946719827;0.9164345403899722;81;82;2759;2154;0.029358463211308444;0.03806870937790158;.\data\pcb_defects_kaggle\images/Short/08_short_06.jpg;4
1764;short;338;1682;407;1733;.\data\pcb_defects_kaggle\Annotations\Short\08_short_06;0.1350126857557086;0.792711234911792;69;51;2759;2154;0.025009061254077564;0.023676880222841225;.\data\pcb_defects_kaggle\images/Short/08_short_06.jpg;4
1765;short;2246;1200;2322;1274;.\data\pcb_defects_kaggle\Annotations\Short\08_short_06;0.8278361725262776;0.5742804085422469;76;74;2759;2154;0.027546212395795577;0.034354688950789226;.\data\pcb_defects_kaggle\images/Short/08_short_06.jpg;4
1766;short;1841;631;1904;688;.\data\pcb_defects_kaggle\Annotations\Short\08_short_07;0.6786879304095687;0.3061745589600743;63;57;2759;2154;0.022834360275462123;0.026462395543175487;.\data\pcb_defects_kaggle\images/Short/08_short_07.jpg;4
1767;short;2519;1606;2589;1670;.\data\pcb_defects_kaggle\Annotations\Short\08_short_07;0.9256977165639725;0.7604456824512534;70;64;2759;2154;0.025371511417180137;0.029712163416898793;.\data\pcb_defects_kaggle\images/Short/08_short_07.jpg;4
1768;short;1605;966;1725;1052;.\data\pcb_defects_kaggle\Annotations\Short\08_short_07;0.6034795215657847;0.46843082636954503;120;86;2759;2154;0.043494019572308806;0.039925719591457756;.\data\pcb_defects_kaggle\images/Short/08_short_07.jpg;4
1769;short;268;1829;356;1902;.\data\pcb_defects_kaggle\Annotations\Short\08_short_07;0.1130844508880029;0.8660631383472609;88;73;2759;2154;0.03189561435302646;0.033890436397400185;.\data\pcb_defects_kaggle\images/Short/08_short_07.jpg;4
1770;short;1951;1064;2058;1138;.\data\pcb_defects_kaggle\Annotations\Short\08_short_07;0.7265313519391083;0.5111420612813371;107;74;2759;2154;0.03878216745197535;0.034354688950789226;.\data\pcb_defects_kaggle\images/Short/08_short_07.jpg;4
1771;short;973;918;1087;985;.\data\pcb_defects_kaggle\Annotations\Short\08_short_08;0.3733236679956506;0.441736304549675;114;67;2759;2154;0.041319318593693366;0.031104921077065924;.\data\pcb_defects_kaggle\images/Short/08_short_08.jpg;4
1772;short;2248;1205;2335;1269;.\data\pcb_defects_kaggle\Annotations\Short\08_short_08;0.8305545487495469;0.5742804085422469;87;64;2759;2154;0.031533164189923885;0.029712163416898793;.\data\pcb_defects_kaggle\images/Short/08_short_08.jpg;4
1773;short;2559;1231;2643;1334;.\data\pcb_defects_kaggle\Annotations\Short\08_short_08;0.9427328742297933;0.5954038997214485;84;103;2759;2154;0.030445813700616164;0.04781801299907149;.\data\pcb_defects_kaggle\images/Short/08_short_08.jpg;4
1774;short;1076;1215;1148;1280;.\data\pcb_defects_kaggle\Annotations\Short\08_short_08;0.4030445813700616;0.5791550603528319;72;65;2759;2154;0.026096411743385284;0.030176415970287838;.\data\pcb_defects_kaggle\images/Short/08_short_08.jpg;4
1775;short;1953;1441;2051;1511;.\data\pcb_defects_kaggle\Annotations\Short\08_short_08;0.725625226531352;0.6852367688022284;98;70;2759;2154;0.03552011598405219;0.032497678737233054;.\data\pcb_defects_kaggle\images/Short/08_short_08.jpg;4
1776;short;1935;657;2005;725;.\data\pcb_defects_kaggle\Annotations\Short\08_short_09;0.7140268213120696;0.32079851439182916;70;68;2759;2154;0.025371511417180137;0.031569173630454965;.\data\pcb_defects_kaggle\images/Short/08_short_09.jpg;4
1777;short;2514;1615;2592;1680;.\data\pcb_defects_kaggle\Annotations\Short\08_short_09;0.9253352664008698;0.7648560817084494;78;65;2759;2154;0.028271112722000724;0.030176415970287838;.\data\pcb_defects_kaggle\images/Short/08_short_09.jpg;4
1778;short;241;1734;315;1806;.\data\pcb_defects_kaggle\Annotations\Short\08_short_09;0.1007611453425154;0.8217270194986073;74;72;2759;2154;0.02682131206959043;0.033426183844011144;.\data\pcb_defects_kaggle\images/Short/08_short_09.jpg;4
1779;short;632;874;740;964;.\data\pcb_defects_kaggle\Annotations\Short\08_short_09;0.24864081188836534;0.4266480965645311;108;90;2759;2154;0.039144617615077926;0.04178272980501393;.\data\pcb_defects_kaggle\images/Short/08_short_09.jpg;4
1780;short;2010;939;2125;1026;.\data\pcb_defects_kaggle\Annotations\Short\08_short_09;0.7493657122145705;0.4561281337047354;115;87;2759;2154;0.04168176875679594;0.0403899721448468;.\data\pcb_defects_kaggle\images/Short/08_short_09.jpg;4
1781;short;773;913;879;972;.\data\pcb_defects_kaggle\Annotations\Short\08_short_10;0.2993838347227256;0.4375580315691736;106;59;2759;2154;0.03841971728887278;0.027390900649953576;.\data\pcb_defects_kaggle\images/Short/08_short_10.jpg;4
1782;short;1546;606;1610;667;.\data\pcb_defects_kaggle\Annotations\Short\08_short_10;0.5719463573758609;0.2954967502321263;64;61;2759;2154;0.023196810438564697;0.028319405756731662;.\data\pcb_defects_kaggle\images/Short/08_short_10.jpg;4
1783;short;1927;662;2002;725;.\data\pcb_defects_kaggle\Annotations\Short\08_short_10;0.7120333454150054;0.32195914577530177;75;63;2759;2154;0.027183762232693004;0.02924791086350975;.\data\pcb_defects_kaggle\images/Short/08_short_10.jpg;4
1784;short;2384;1356;2458;1420;.\data\pcb_defects_kaggle\Annotations\Short\08_short_10;0.8774918448713301;0.6443825441039925;74;64;2759;2154;0.02682131206959043;0.029712163416898793;.\data\pcb_defects_kaggle\images/Short/08_short_10.jpg;4
1785;short;782;1788;850;1862;.\data\pcb_defects_kaggle\Annotations\Short\08_short_10;0.2957593330916999;0.8472609099350047;68;74;2759;2154;0.02464661109097499;0.034354688950789226;.\data\pcb_defects_kaggle\images/Short/08_short_10.jpg;4
1786;short;669;561;753;638;.\data\pcb_defects_kaggle\Annotations\Short\09_short_01;0.2562162162162162;0.277674849467346;84;77;2775;2159;0.03027027027027027;0.035664659564613246;.\data\pcb_defects_kaggle\images/Short/09_short_01.jpg;4
1787;short;1340;418;1459;505;.\data\pcb_defects_kaggle\Annotations\Short\09_short_01;0.5043243243243243;0.21375636868920797;119;87;2775;2159;0.04288288288288288;0.04029643353404354;.\data\pcb_defects_kaggle\images/Short/09_short_01.jpg;4
1788;short;2210;1225;2279;1287;.\data\pcb_defects_kaggle\Annotations\Short\09_short_01;0.8088288288288288;0.5817508105604446;69;62;2775;2159;0.024864864864864864;0.02871699861046781;.\data\pcb_defects_kaggle\images/Short/09_short_01.jpg;4
1789;short;1130;1086;1249;1161;.\data\pcb_defects_kaggle\Annotations\Short\09_short_01;0.42864864864864866;0.5203798054654933;119;75;2775;2159;0.04288288288288288;0.03473830477072719;.\data\pcb_defects_kaggle\images/Short/09_short_01.jpg;4
1790;short;1763;1431;1876;1497;.\data\pcb_defects_kaggle\Annotations\Short\09_short_01;0.6556756756756756;0.6780917091245947;113;66;2775;2159;0.04072072072072072;0.030569708198239925;.\data\pcb_defects_kaggle\images/Short/09_short_01.jpg;4
1791;short;715;433;822;490;.\data\pcb_defects_kaggle\Annotations\Short\09_short_02;0.27693693693693694;0.21375636868920797;107;57;2775;2159;0.03855855855855856;0.026401111625752663;.\data\pcb_defects_kaggle\images/Short/09_short_02.jpg;4
1792;short;774;881;890;940;.\data\pcb_defects_kaggle\Annotations\Short\09_short_02;0.2998198198198198;0.4217230199166281;116;59;2775;2159;0.041801801801801805;0.02732746641963872;.\data\pcb_defects_kaggle\images/Short/09_short_02.jpg;4
1793;short;1949;1199;2027;1258;.\data\pcb_defects_kaggle\Annotations\Short\09_short_02;0.7163963963963964;0.5690134321445114;78;59;2775;2159;0.02810810810810811;0.02732746641963872;.\data\pcb_defects_kaggle\images/Short/09_short_02.jpg;4
1794;short;1843;961;1912;1017;.\data\pcb_defects_kaggle\Annotations\Short\09_short_02;0.6765765765765765;0.45808244557665584;69;56;2775;2159;0.024864864864864864;0.025937934228809634;.\data\pcb_defects_kaggle\images/Short/09_short_02.jpg;4
1795;short;1671;502;1766;566;.\data\pcb_defects_kaggle\Annotations\Short\09_short_02;0.6192792792792793;0.24733672996757758;95;64;2775;2159;0.03423423423423423;0.029643353404353867;.\data\pcb_defects_kaggle\images/Short/09_short_02.jpg;4
1796;short;1151;902;1218;999;.\data\pcb_defects_kaggle\Annotations\Short\09_short_03;0.4268468468468469;0.44025011579434925;67;97;2775;2159;0.024144144144144144;0.04492820750347383;.\data\pcb_defects_kaggle\images/Short/09_short_03.jpg;4
1797;short;1812;994;1879;1059;.\data\pcb_defects_kaggle\Annotations\Short\09_short_03;0.665045045045045;0.47545159796201947;67;65;2775;2159;0.024144144144144144;0.030106530801296896;.\data\pcb_defects_kaggle\images/Short/09_short_03.jpg;4
1798;short;2213;1102;2287;1154;.\data\pcb_defects_kaggle\Annotations\Short\09_short_03;0.8108108108108109;0.5224641037517369;74;52;2775;2159;0.02666666666666667;0.024085224641037517;.\data\pcb_defects_kaggle\images/Short/09_short_03.jpg;4
1799;short;1690;1402;1807;1463;.\data\pcb_defects_kaggle\Annotations\Short\09_short_03;0.6300900900900901;0.6635016211208893;117;61;2775;2159;0.04216216216216216;0.02825382121352478;.\data\pcb_defects_kaggle\images/Short/09_short_03.jpg;4
1800;short;1902;1433;1986;1494;.\data\pcb_defects_kaggle\Annotations\Short\09_short_03;0.7005405405405405;0.6778601204261232;84;61;2775;2159;0.03027027027027027;0.02825382121352478;.\data\pcb_defects_kaggle\images/Short/09_short_03.jpg;4
1801;short;1913;143;2023;205;.\data\pcb_defects_kaggle\Annotations\Short\09_short_04;0.7091891891891892;0.08059286706808708;110;62;2775;2159;0.03963963963963964;0.02871699861046781;.\data\pcb_defects_kaggle\images/Short/09_short_04.jpg;4
1802;short;1574;258;1643;320;.\data\pcb_defects_kaggle\Annotations\Short\09_short_04;0.5796396396396396;0.13385826771653545;69;62;2775;2159;0.024864864864864864;0.02871699861046781;.\data\pcb_defects_kaggle\images/Short/09_short_04.jpg;4
1803;short;1622;535;1705;604;.\data\pcb_defects_kaggle\Annotations\Short\09_short_04;0.5994594594594594;0.2637795275590551;83;69;2775;2159;0.02990990990990991;0.03195924038906901;.\data\pcb_defects_kaggle\images/Short/09_short_04.jpg;4
1804;short;2210;1249;2279;1310;.\data\pcb_defects_kaggle\Annotations\Short\09_short_04;0.8088288288288288;0.5926354793886058;69;61;2775;2159;0.024864864864864864;0.02825382121352478;.\data\pcb_defects_kaggle\images/Short/09_short_04.jpg;4
1805;short;1951;1130;2023;1195;.\data\pcb_defects_kaggle\Annotations\Short\09_short_04;0.716036036036036;0.5384437239462714;72;65;2775;2159;0.025945945945945945;0.030106530801296896;.\data\pcb_defects_kaggle\images/Short/09_short_04.jpg;4
1806;short;1486;479;1592;549;.\data\pcb_defects_kaggle\Annotations\Short\09_short_05;0.5545945945945946;0.238073182028717;106;70;2775;2159;0.0381981981981982;0.03242241778601204;.\data\pcb_defects_kaggle\images/Short/09_short_05.jpg;4
1807;short;1074;574;1156;636;.\data\pcb_defects_kaggle\Annotations\Short\09_short_05;0.4018018018018018;0.28022232515053264;82;62;2775;2159;0.02954954954954955;0.02871699861046781;.\data\pcb_defects_kaggle\images/Short/09_short_05.jpg;4
1808;short;766;874;916;936;.\data\pcb_defects_kaggle\Annotations\Short\09_short_05;0.3030630630630631;0.4191755442334414;150;62;2775;2159;0.05405405405405406;0.02871699861046781;.\data\pcb_defects_kaggle\images/Short/09_short_05.jpg;4
1809;short;1204;874;1264;941;.\data\pcb_defects_kaggle\Annotations\Short\09_short_05;0.4446846846846847;0.420333487725799;60;67;2775;2159;0.021621621621621623;0.031032885595182955;.\data\pcb_defects_kaggle\images/Short/09_short_05.jpg;4
1810;short;1802;989;1872;1059;.\data\pcb_defects_kaggle\Annotations\Short\09_short_05;0.661981981981982;0.4742936544696619;70;70;2775;2159;0.025225225225225224;0.03242241778601204;.\data\pcb_defects_kaggle\images/Short/09_short_05.jpg;4
1811;short;1194;812;1271;908;.\data\pcb_defects_kaggle\Annotations\Short\09_short_06;0.44414414414414416;0.3983325613710051;77;96;2775;2159;0.02774774774774775;0.0444650301065308;.\data\pcb_defects_kaggle\images/Short/09_short_06.jpg;4
1812;short;1897;990;1959;1059;.\data\pcb_defects_kaggle\Annotations\Short\09_short_06;0.6947747747747748;0.4745252431681334;62;69;2775;2159;0.022342342342342343;0.03195924038906901;.\data\pcb_defects_kaggle\images/Short/09_short_06.jpg;4
1813;short;1756;1461;1871;1528;.\data\pcb_defects_kaggle\Annotations\Short\09_short_06;0.6535135135135135;0.6922186197313571;115;67;2775;2159;0.04144144144144144;0.031032885595182955;.\data\pcb_defects_kaggle\images/Short/09_short_06.jpg;4
1814;short;2249;968;2307;1030;.\data\pcb_defects_kaggle\Annotations\Short\09_short_06;0.820900900900901;0.46271421954608616;58;62;2775;2159;0.020900900900900903;0.02871699861046781;.\data\pcb_defects_kaggle\images/Short/09_short_06.jpg;4
1815;short;648;1125;754;1168;.\data\pcb_defects_kaggle\Annotations\Short\09_short_06;0.2526126126126126;0.5310328855951829;106;43;2775;2159;0.0381981981981982;0.019916628068550254;.\data\pcb_defects_kaggle\images/Short/09_short_06.jpg;4
1816;short;946;564;1027;623;.\data\pcb_defects_kaggle\Annotations\Short\09_short_07;0.3554954954954955;0.2748957850856878;81;59;2775;2159;0.02918918918918919;0.02732746641963872;.\data\pcb_defects_kaggle\images/Short/09_short_07.jpg;4
1817;short;771;715;900;768;.\data\pcb_defects_kaggle\Annotations\Short\09_short_07;0.30108108108108106;0.3434460398332561;129;53;2775;2159;0.046486486486486484;0.024548402037980546;.\data\pcb_defects_kaggle\images/Short/09_short_07.jpg;4
1818;short;1954;1359;2018;1412;.\data\pcb_defects_kaggle\Annotations\Short\09_short_07;0.7156756756756757;0.6417322834645669;64;53;2775;2159;0.023063063063063063;0.024548402037980546;.\data\pcb_defects_kaggle\images/Short/09_short_07.jpg;4
1819;short;2210;1092;2279;1146;.\data\pcb_defects_kaggle\Annotations\Short\09_short_07;0.8088288288288288;0.5182955071792497;69;54;2775;2159;0.024864864864864864;0.025011579434923575;.\data\pcb_defects_kaggle\images/Short/09_short_07.jpg;4
1820;short;1836;259;1904;317;.\data\pcb_defects_kaggle\Annotations\Short\09_short_07;0.6738738738738739;0.1333950903195924;68;58;2775;2159;0.024504504504504504;0.026864289022695692;.\data\pcb_defects_kaggle\images/Short/09_short_07.jpg;4
1821;short;963;905;1031;990;.\data\pcb_defects_kaggle\Annotations\Short\09_short_08;0.3592792792792793;0.43886058360352015;68;85;2775;2159;0.024504504504504504;0.03937007874015748;.\data\pcb_defects_kaggle\images/Short/09_short_08.jpg;4
1822;short;1795;995;1856;1058;.\data\pcb_defects_kaggle\Annotations\Short\09_short_08;0.6578378378378379;0.47545159796201947;61;63;2775;2159;0.021981981981981983;0.029180176007410838;.\data\pcb_defects_kaggle\images/Short/09_short_08.jpg;4
1823;short;1953;1159;2027;1220;.\data\pcb_defects_kaggle\Annotations\Short\09_short_08;0.7171171171171171;0.5509495136637332;74;61;2775;2159;0.02666666666666667;0.02825382121352478;.\data\pcb_defects_kaggle\images/Short/09_short_08.jpg;4
1824;short;1758;1410;1879;1472;.\data\pcb_defects_kaggle\Annotations\Short\09_short_08;0.6553153153153153;0.667438628994905;121;62;2775;2159;0.0436036036036036;0.02871699861046781;.\data\pcb_defects_kaggle\images/Short/09_short_08.jpg;4
1825;short;1604;1235;1672;1323;.\data\pcb_defects_kaggle\Annotations\Short\09_short_08;0.5902702702702702;0.5924038906901343;68;88;2775;2159;0.024504504504504504;0.04075961093098657;.\data\pcb_defects_kaggle\images/Short/09_short_08.jpg;4
1826;short;1136;404;1248;461;.\data\pcb_defects_kaggle\Annotations\Short\09_short_09;0.42954954954954955;0.2003242241778601;112;57;2775;2159;0.04036036036036036;0.026401111625752663;.\data\pcb_defects_kaggle\images/Short/09_short_09.jpg;4
1827;short;1808;317;1856;354;.\data\pcb_defects_kaggle\Annotations\Short\09_short_09;0.6601801801801802;0.1553960166743863;48;37;2775;2159;0.017297297297297298;0.01713756368689208;.\data\pcb_defects_kaggle\images/Short/09_short_09.jpg;4
1828;short;1212;817;1274;900;.\data\pcb_defects_kaggle\Annotations\Short\09_short_09;0.4479279279279279;0.39763779527559057;62;83;2775;2159;0.022342342342342343;0.03844372394627142;.\data\pcb_defects_kaggle\images/Short/09_short_09.jpg;4
1829;short;577;1120;682;1164;.\data\pcb_defects_kaggle\Annotations\Short\09_short_09;0.22684684684684683;0.5289485873089393;105;44;2775;2159;0.03783783783783784;0.020379805465493284;.\data\pcb_defects_kaggle\images/Short/09_short_09.jpg;4
1830;short;1317;1245;1384;1315;.\data\pcb_defects_kaggle\Annotations\Short\09_short_09;0.4866666666666667;0.5928670680870773;67;70;2775;2159;0.024144144144144144;0.03242241778601204;.\data\pcb_defects_kaggle\images/Short/09_short_09.jpg;4
1831;short;1333;443;1464;507;.\data\pcb_defects_kaggle\Annotations\Short\09_short_10;0.5039639639639639;0.22000926354793887;131;64;2775;2159;0.047207207207207204;0.029643353404353867;.\data\pcb_defects_kaggle\images/Short/09_short_10.jpg;4
1832;short;1982;181;2092;251;.\data\pcb_defects_kaggle\Annotations\Short\09_short_10;0.7340540540540541;0.1000463177396943;110;70;2775;2159;0.03963963963963964;0.03242241778601204;.\data\pcb_defects_kaggle\images/Short/09_short_10.jpg;4
1833;short;1720;308;1782;363;.\data\pcb_defects_kaggle\Annotations\Short\09_short_10;0.630990990990991;0.1553960166743863;62;55;2775;2159;0.022342342342342343;0.025474756831866605;.\data\pcb_defects_kaggle\images/Short/09_short_10.jpg;4
1834;short;1902;963;1966;1023;.\data\pcb_defects_kaggle\Annotations\Short\09_short_10;0.6969369369369369;0.45993515516442796;64;60;2775;2159;0.023063063063063063;0.02779064381658175;.\data\pcb_defects_kaggle\images/Short/09_short_10.jpg;4
1835;short;2217;1108;2277;1161;.\data\pcb_defects_kaggle\Annotations\Short\09_short_10;0.8097297297297297;0.5254747568318666;60;53;2775;2159;0.021621621621621623;0.024548402037980546;.\data\pcb_defects_kaggle\images/Short/09_short_10.jpg;4
1836;short;969;577;1143;686;.\data\pcb_defects_kaggle\Annotations\Short\10_short_01;0.4714285714285714;0.3132440476190476;174;109;2240;2016;0.07767857142857143;0.05406746031746032;.\data\pcb_defects_kaggle\images/Short/10_short_01.jpg;4
1837;short;1887;516;2019;616;.\data\pcb_defects_kaggle\Annotations\Short\10_short_01;0.871875;0.28075396825396826;132;100;2240;2016;0.05892857142857143;0.0496031746031746;.\data\pcb_defects_kaggle\images/Short/10_short_01.jpg;4
1838;short;1108;1548;1230;1708;.\data\pcb_defects_kaggle\Annotations\Short\10_short_01;0.521875;0.8075396825396826;122;160;2240;2016;0.054464285714285715;0.07936507936507936;.\data\pcb_defects_kaggle\images/Short/10_short_01.jpg;4
1839;short;1704;1634;1832;1785;.\data\pcb_defects_kaggle\Annotations\Short\10_short_01;0.7892857142857143;0.8479662698412699;128;151;2240;2016;0.05714285714285714;0.07490079365079365;.\data\pcb_defects_kaggle\images/Short/10_short_01.jpg;4
1840;short;1778;680;1869;832;.\data\pcb_defects_kaggle\Annotations\Short\10_short_01;0.8140625;0.375;91;152;2240;2016;0.040625;0.07539682539682539;.\data\pcb_defects_kaggle\images/Short/10_short_01.jpg;4
1841;short;1653;648;1858;803;.\data\pcb_defects_kaggle\Annotations\Short\10_short_02;0.7837053571428572;0.35987103174603174;205;155;2240;2016;0.09151785714285714;0.07688492063492064;.\data\pcb_defects_kaggle\images/Short/10_short_02.jpg;4
1842;short;1007;851;1156;987;.\data\pcb_defects_kaggle\Annotations\Short\10_short_02;0.4828125;0.4558531746031746;149;136;2240;2016;0.06651785714285714;0.06746031746031746;.\data\pcb_defects_kaggle\images/Short/10_short_02.jpg;4
1843;short;1395;1260;1568;1373;.\data\pcb_defects_kaggle\Annotations\Short\10_short_02;0.6613839285714286;0.6530257936507936;173;113;2240;2016;0.07723214285714286;0.056051587301587304;.\data\pcb_defects_kaggle\images/Short/10_short_02.jpg;4
1844;short;1840;1645;1945;1798;.\data\pcb_defects_kaggle\Annotations\Short\10_short_02;0.8448660714285714;0.8539186507936508;105;153;2240;2016;0.046875;0.07589285714285714;.\data\pcb_defects_kaggle\images/Short/10_short_02.jpg;4
1845;short;995;1316;1174;1480;.\data\pcb_defects_kaggle\Annotations\Short\10_short_02;0.4841517857142857;0.6934523809523809;179;164;2240;2016;0.07991071428571428;0.08134920634920635;.\data\pcb_defects_kaggle\images/Short/10_short_02.jpg;4
1846;short;1897;518;2017;616;.\data\pcb_defects_kaggle\Annotations\Short\10_short_03;0.8736607142857142;0.28125;120;98;2240;2016;0.05357142857142857;0.04861111111111111;.\data\pcb_defects_kaggle\images/Short/10_short_03.jpg;4
1847;short;1245;732;1487;886;.\data\pcb_defects_kaggle\Annotations\Short\10_short_03;0.6098214285714286;0.40128968253968256;242;154;2240;2016;0.10803571428571429;0.0763888888888889;.\data\pcb_defects_kaggle\images/Short/10_short_03.jpg;4
1848;short;1407;1251;1566;1377;.\data\pcb_defects_kaggle\Annotations\Short\10_short_03;0.6636160714285714;0.6517857142857143;159;126;2240;2016;0.07098214285714285;0.0625;.\data\pcb_defects_kaggle\images/Short/10_short_03.jpg;4
1849;short;1162;1299;1277;1448;.\data\pcb_defects_kaggle\Annotations\Short\10_short_03;0.5444196428571428;0.6812996031746031;115;149;2240;2016;0.05133928571428571;0.07390873015873016;.\data\pcb_defects_kaggle\images/Short/10_short_03.jpg;4
1850;short;1797;741;1946;858;.\data\pcb_defects_kaggle\Annotations\Short\10_short_03;0.8354910714285714;0.39657738095238093;149;117;2240;2016;0.06651785714285714;0.05803571428571429;.\data\pcb_defects_kaggle\images/Short/10_short_03.jpg;4
1851;short;979;547;1116;644;.\data\pcb_defects_kaggle\Annotations\Short\10_short_04;0.46763392857142855;0.29538690476190477;137;97;2240;2016;0.061160714285714284;0.04811507936507937;.\data\pcb_defects_kaggle\images/Short/10_short_04.jpg;4
1852;short;1882;527;2019;641;.\data\pcb_defects_kaggle\Annotations\Short\10_short_04;0.8707589285714286;0.2896825396825397;137;114;2240;2016;0.061160714285714284;0.05654761904761905;.\data\pcb_defects_kaggle\images/Short/10_short_04.jpg;4
1853;short;1737;698;1869;827;.\data\pcb_defects_kaggle\Annotations\Short\10_short_04;0.8049107142857143;0.37822420634920634;132;129;2240;2016;0.05892857142857143;0.06398809523809523;.\data\pcb_defects_kaggle\images/Short/10_short_04.jpg;4
1854;short;1163;1556;1281;1709;.\data\pcb_defects_kaggle\Annotations\Short\10_short_04;0.5455357142857142;0.8097718253968254;118;153;2240;2016;0.05267857142857143;0.07589285714285714;.\data\pcb_defects_kaggle\images/Short/10_short_04.jpg;4
1855;short;1752;1644;1871;1790;.\data\pcb_defects_kaggle\Annotations\Short\10_short_04;0.8087053571428572;0.8516865079365079;119;146;2240;2016;0.053125;0.07242063492063493;.\data\pcb_defects_kaggle\images/Short/10_short_04.jpg;4
1856;short;975;557;1126;670;.\data\pcb_defects_kaggle\Annotations\Short\10_short_05;0.4689732142857143;0.30431547619047616;151;113;2240;2016;0.06741071428571428;0.056051587301587304;.\data\pcb_defects_kaggle\images/Short/10_short_05.jpg;4
1857;short;1777;711;1892;837;.\data\pcb_defects_kaggle\Annotations\Short\10_short_05;0.8189732142857142;0.38392857142857145;115;126;2240;2016;0.05133928571428571;0.0625;.\data\pcb_defects_kaggle\images/Short/10_short_05.jpg;4
1858;short;1385;1164;1537;1286;.\data\pcb_defects_kaggle\Annotations\Short\10_short_05;0.6522321428571428;0.6076388888888888;152;122;2240;2016;0.06785714285714285;0.060515873015873016;.\data\pcb_defects_kaggle\images/Short/10_short_05.jpg;4
1859;short;1821;1664;1933;1787;.\data\pcb_defects_kaggle\Annotations\Short\10_short_05;0.8379464285714285;0.8559027777777778;112;123;2240;2016;0.05;0.06101190476190476;.\data\pcb_defects_kaggle\images/Short/10_short_05.jpg;4
1860;short;1139;1447;1262;1586;.\data\pcb_defects_kaggle\Annotations\Short\10_short_05;0.5359375;0.7522321428571429;123;139;2240;2016;0.054910714285714285;0.0689484126984127;.\data\pcb_defects_kaggle\images/Short/10_short_05.jpg;4
1861;short;1078;329;1175;429;.\data\pcb_defects_kaggle\Annotations\Short\11_short_01;0.4936459246275197;0.16859430604982206;97;100;2282;2248;0.04250657318141981;0.04448398576512456;.\data\pcb_defects_kaggle\images/Short/11_short_01.jpg;4
1862;short;1039;1075;1134;1153;.\data\pcb_defects_kaggle\Annotations\Short\11_short_01;0.4761174408413672;0.49555160142348753;95;78;2282;2248;0.04163014899211218;0.03469750889679715;.\data\pcb_defects_kaggle\images/Short/11_short_01.jpg;4
1863;short;1737;1635;1824;1735;.\data\pcb_defects_kaggle\Annotations\Short\11_short_01;0.780236634531113;0.7495551601423488;87;100;2282;2248;0.03812445223488168;0.04448398576512456;.\data\pcb_defects_kaggle\images/Short/11_short_01.jpg;4
1864;short;684;1326;788;1422;.\data\pcb_defects_kaggle\Annotations\Short\11_short_01;0.32252410166520595;0.6112099644128114;104;96;2282;2248;0.04557405784399649;0.042704626334519574;.\data\pcb_defects_kaggle\images/Short/11_short_01.jpg;4
1865;short;512;1514;619;1594;.\data\pcb_defects_kaggle\Annotations\Short\11_short_01;0.24780893952673094;0.6912811387900356;107;80;2282;2248;0.04688869412795793;0.03558718861209965;.\data\pcb_defects_kaggle\images/Short/11_short_01.jpg;4
1866;short;1024;1113;1098;1201;.\data\pcb_defects_kaggle\Annotations\Short\11_short_02;0.464943032427695;0.5146797153024911;74;88;2282;2248;0.03242769500438212;0.03914590747330961;.\data\pcb_defects_kaggle\images/Short/11_short_02.jpg;4
1867;short;1694;1632;1768;1740;.\data\pcb_defects_kaggle\Annotations\Short\11_short_02;0.7585451358457493;0.75;74;108;2282;2248;0.03242769500438212;0.04804270462633452;.\data\pcb_defects_kaggle\images/Short/11_short_02.jpg;4
1868;short;1666;1973;1732;2060;.\data\pcb_defects_kaggle\Annotations\Short\11_short_02;0.7445223488168273;0.8970195729537367;66;87;2282;2248;0.028921998247151623;0.03870106761565836;.\data\pcb_defects_kaggle\images/Short/11_short_02.jpg;4
1869;short;604;1662;714;1755;.\data\pcb_defects_kaggle\Annotations\Short\11_short_02;0.2887817703768624;0.760008896797153;110;93;2282;2248;0.04820333041191937;0.041370106761565835;.\data\pcb_defects_kaggle\images/Short/11_short_02.jpg;4
1870;short;430;1401;573;1501;.\data\pcb_defects_kaggle\Annotations\Short\11_short_02;0.21976336546888695;0.6454626334519573;143;100;2282;2248;0.06266432953549518;0.04448398576512456;.\data\pcb_defects_kaggle\images/Short/11_short_02.jpg;4
1871;short;1061;339;1183;429;.\data\pcb_defects_kaggle\Annotations\Short\11_short_03;0.49167397020157755;0.1708185053380783;122;90;2282;2248;0.05346187554776512;0.0400355871886121;.\data\pcb_defects_kaggle\images/Short/11_short_03.jpg;4
1872;short;860;1165;953;1244;.\data\pcb_defects_kaggle\Annotations\Short\11_short_03;0.39723926380368096;0.5358096085409253;93;79;2282;2248;0.04075372480280456;0.035142348754448396;.\data\pcb_defects_kaggle\images/Short/11_short_03.jpg;4
1873;short;1220;1104;1312;1213;.\data\pcb_defects_kaggle\Annotations\Short\11_short_03;0.5547765118317266;0.515346975088968;92;109;2282;2248;0.040315512708150744;0.04848754448398576;.\data\pcb_defects_kaggle\images/Short/11_short_03.jpg;4
1874;short;516;1378;624;1447;.\data\pcb_defects_kaggle\Annotations\Short\11_short_03;0.24978089395267308;0.6283362989323843;108;69;2282;2248;0.04732690622261174;0.03069395017793594;.\data\pcb_defects_kaggle\images/Short/11_short_03.jpg;4
1875;short;593;853;717;953;.\data\pcb_defects_kaggle\Annotations\Short\11_short_03;0.28702892199824714;0.40169039145907476;124;100;2282;2248;0.05433829973707274;0.04448398576512456;.\data\pcb_defects_kaggle\images/Short/11_short_03.jpg;4
1876;short;1080;1378;1184;1453;.\data\pcb_defects_kaggle\Annotations\Short\11_short_04;0.49605609114811566;0.6296708185053381;104;75;2282;2248;0.04557405784399649;0.03336298932384341;.\data\pcb_defects_kaggle\images/Short/11_short_04.jpg;4
1877;short;1730;1632;1814;1744;.\data\pcb_defects_kaggle\Annotations\Short\11_short_04;0.7765118317265557;0.7508896797153025;84;112;2282;2248;0.03680981595092025;0.0498220640569395;.\data\pcb_defects_kaggle\images/Short/11_short_04.jpg;4
1878;short;668;1640;781;1731;.\data\pcb_defects_kaggle\Annotations\Short\11_short_04;0.3174846625766871;0.7497775800711743;113;91;2282;2248;0.04951796669588081;0.04048042704626335;.\data\pcb_defects_kaggle\images/Short/11_short_04.jpg;4
1879;short;401;1614;486;1713;.\data\pcb_defects_kaggle\Annotations\Short\11_short_04;0.1943470639789658;0.739991103202847;85;99;2282;2248;0.03724802804557406;0.04403914590747331;.\data\pcb_defects_kaggle\images/Short/11_short_04.jpg;4
1880;short;434;1398;575;1475;.\data\pcb_defects_kaggle\Annotations\Short\11_short_04;0.2210780017528484;0.6390124555160143;141;77;2282;2248;0.061787905346187555;0.03425266903914591;.\data\pcb_defects_kaggle\images/Short/11_short_04.jpg;4
1881;short;847;1073;914;1153;.\data\pcb_defects_kaggle\Annotations\Short\11_short_05;0.38584574934268184;0.4951067615658363;67;80;2282;2248;0.029360210341805432;0.03558718861209965;.\data\pcb_defects_kaggle\images/Short/11_short_05.jpg;4
1882;short;1084;1568;1180;1634;.\data\pcb_defects_kaggle\Annotations\Short\11_short_05;0.49605609114811566;0.7121886120996441;96;66;2282;2248;0.042068361086765996;0.029359430604982206;.\data\pcb_defects_kaggle\images/Short/11_short_05.jpg;4
1883;short;719;1614;848;1694;.\data\pcb_defects_kaggle\Annotations\Short\11_short_05;0.343339176161262;0.7357651245551602;129;80;2282;2248;0.05652936021034181;0.03558718861209965;.\data\pcb_defects_kaggle\images/Short/11_short_05.jpg;4
1884;short;401;1622;493;1722;.\data\pcb_defects_kaggle\Annotations\Short\11_short_05;0.19588080631025417;0.7437722419928826;92;100;2282;2248;0.040315512708150744;0.04448398576512456;.\data\pcb_defects_kaggle\images/Short/11_short_05.jpg;4
1885;short;763;67;848;188;.\data\pcb_defects_kaggle\Annotations\Short\11_short_05;0.3529798422436459;0.056717081850533806;85;121;2282;2248;0.03724802804557406;0.05382562277580071;.\data\pcb_defects_kaggle\images/Short/11_short_05.jpg;4
1886;short;887;1167;951;1245;.\data\pcb_defects_kaggle\Annotations\Short\11_short_06;0.40271691498685364;0.5364768683274022;64;78;2282;2248;0.028045574057843997;0.03469750889679715;.\data\pcb_defects_kaggle\images/Short/11_short_06.jpg;4
1887;short;1158;1158;1222;1239;.\data\pcb_defects_kaggle\Annotations\Short\11_short_06;0.5214723926380368;0.5331405693950177;64;81;2282;2248;0.028045574057843997;0.03603202846975089;.\data\pcb_defects_kaggle\images/Short/11_short_06.jpg;4
1888;short;822;1934;893;2013;.\data\pcb_defects_kaggle\Annotations\Short\11_short_06;0.37576687116564417;0.8778914590747331;71;79;2282;2248;0.031113058720420684;0.035142348754448396;.\data\pcb_defects_kaggle\images/Short/11_short_06.jpg;4
1889;short;1834;1822;1935;1886;.\data\pcb_defects_kaggle\Annotations\Short\11_short_06;0.8258106923751095;0.8247330960854092;101;64;2282;2248;0.04425942156003506;0.028469750889679714;.\data\pcb_defects_kaggle\images/Short/11_short_06.jpg;4
1890;short;1045;1345;1124;1417;.\data\pcb_defects_kaggle\Annotations\Short\11_short_06;0.4752410166520596;0.6143238434163701;79;72;2282;2248;0.034618755477651184;0.03202846975088968;.\data\pcb_defects_kaggle\images/Short/11_short_06.jpg;4
1891;short;966;313;1075;372;.\data\pcb_defects_kaggle\Annotations\Short\11_short_07;0.4471954425942156;0.1523576512455516;109;59;2282;2248;0.047765118317265556;0.026245551601423486;.\data\pcb_defects_kaggle\images/Short/11_short_07.jpg;4
1892;short;1227;1108;1319;1193;.\data\pcb_defects_kaggle\Annotations\Short\11_short_07;0.5578439964943033;0.511788256227758;92;85;2282;2248;0.040315512708150744;0.037811387900355875;.\data\pcb_defects_kaggle\images/Short/11_short_07.jpg;4
1893;short;1314;1639;1499;1726;.\data\pcb_defects_kaggle\Annotations\Short\11_short_07;0.6163453111305872;0.7484430604982206;185;87;2282;2248;0.08106923751095531;0.03870106761565836;.\data\pcb_defects_kaggle\images/Short/11_short_07.jpg;4
1894;short;517;1396;622;1447;.\data\pcb_defects_kaggle\Annotations\Short\11_short_07;0.2495617879053462;0.6323398576512456;105;51;2282;2248;0.046012269938650305;0.022686832740213523;.\data\pcb_defects_kaggle\images/Short/11_short_07.jpg;4
1895;short;639;1152;739;1239;.\data\pcb_defects_kaggle\Annotations\Short\11_short_07;0.30192813321647677;0.531806049822064;100;87;2282;2248;0.04382120946538125;0.03870106761565836;.\data\pcb_defects_kaggle\images/Short/11_short_07.jpg;4
1896;short;1030;1065;1104;1160;.\data\pcb_defects_kaggle\Annotations\Short\11_short_08;0.46757230499561786;0.49488434163701067;74;95;2282;2248;0.03242769500438212;0.04225978647686833;.\data\pcb_defects_kaggle\images/Short/11_short_08.jpg;4
1897;short;1072;1403;1199;1450;.\data\pcb_defects_kaggle\Annotations\Short\11_short_08;0.49758983347940405;0.6345640569395018;127;47;2282;2248;0.05565293602103418;0.02090747330960854;.\data\pcb_defects_kaggle\images/Short/11_short_08.jpg;4
1898;short;430;1398;578;1457;.\data\pcb_defects_kaggle\Annotations\Short\11_short_08;0.22085889570552147;0.635008896797153;148;59;2282;2248;0.06485539000876424;0.026245551601423486;.\data\pcb_defects_kaggle\images/Short/11_short_08.jpg;4
1899;short;424;1616;484;1727;.\data\pcb_defects_kaggle\Annotations\Short\11_short_08;0.19894829097283084;0.743549822064057;60;111;2282;2248;0.026292725679228746;0.04937722419928826;.\data\pcb_defects_kaggle\images/Short/11_short_08.jpg;4
1900;short;1830;1760;1935;1819;.\data\pcb_defects_kaggle\Annotations\Short\11_short_08;0.824934268185802;0.796040925266904;105;59;2282;2248;0.046012269938650305;0.026245551601423486;.\data\pcb_defects_kaggle\images/Short/11_short_08.jpg;4
1901;short;853;355;1032;424;.\data\pcb_defects_kaggle\Annotations\Short\11_short_09;0.41301489921121826;0.17326512455516013;179;69;2282;2248;0.07843996494303243;0.03069395017793594;.\data\pcb_defects_kaggle\images/Short/11_short_09.jpg;4
1902;short;829;1070;889;1162;.\data\pcb_defects_kaggle\Annotations\Short\11_short_09;0.3764241893076249;0.49644128113879005;60;92;2282;2248;0.026292725679228746;0.04092526690391459;.\data\pcb_defects_kaggle\images/Short/11_short_09.jpg;4
1903;short;1145;1167;1212;1245;.\data\pcb_defects_kaggle\Annotations\Short\11_short_09;0.516432953549518;0.5364768683274022;67;78;2282;2248;0.029360210341805432;0.03469750889679715;.\data\pcb_defects_kaggle\images/Short/11_short_09.jpg;4
1904;short;676;1372;802;1447;.\data\pcb_defects_kaggle\Annotations\Short\11_short_09;0.3238387379491674;0.6270017793594306;126;75;2282;2248;0.05521472392638037;0.03336298932384341;.\data\pcb_defects_kaggle\images/Short/11_short_09.jpg;4
1905;short;714;1606;845;1699;.\data\pcb_defects_kaggle\Annotations\Short\11_short_09;0.3415863277826468;0.7350978647686833;131;93;2282;2248;0.05740578439964943;0.041370106761565835;.\data\pcb_defects_kaggle\images/Short/11_short_09.jpg;4
1906;short;1076;350;1186;424;.\data\pcb_defects_kaggle\Annotations\Short\11_short_10;0.4956178790534619;0.17215302491103202;110;74;2282;2248;0.04820333041191937;0.03291814946619217;.\data\pcb_defects_kaggle\images/Short/11_short_10.jpg;4
1907;short;973;667;1145;750;.\data\pcb_defects_kaggle\Annotations\Short\11_short_10;0.46406660823838736;0.3151690391459075;172;83;2282;2248;0.07537248028045573;0.03692170818505338;.\data\pcb_defects_kaggle\images/Short/11_short_10.jpg;4
1908;short;591;867;704;963;.\data\pcb_defects_kaggle\Annotations\Short\11_short_10;0.2837423312883436;0.4070284697508897;113;96;2282;2248;0.04951796669588081;0.042704626334519574;.\data\pcb_defects_kaggle\images/Short/11_short_10.jpg;4
1909;short;847;1072;924;1162;.\data\pcb_defects_kaggle\Annotations\Short\11_short_10;0.3880368098159509;0.4968861209964413;77;90;2282;2248;0.03374233128834356;0.0400355871886121;.\data\pcb_defects_kaggle\images/Short/11_short_10.jpg;4
1910;short;540;1934;655;2053;.\data\pcb_defects_kaggle\Annotations\Short\11_short_10;0.26183172655565295;0.886788256227758;115;119;2282;2248;0.050394390885188434;0.052935943060498224;.\data\pcb_defects_kaggle\images/Short/11_short_10.jpg;4
1911;short;1783;1932;1912;2055;.\data\pcb_defects_kaggle\Annotations\Short\11_short_10;0.8095968448729185;0.886788256227758;129;123;2282;2248;0.05652936021034181;0.0547153024911032;.\data\pcb_defects_kaggle\images/Short/11_short_10.jpg;4
1912;short;1713;584;1795;643;.\data\pcb_defects_kaggle\Annotations\Short\12_short_01;0.6935547647291419;0.2424901185770751;82;59;2529;2530;0.03242388295769079;0.0233201581027668;.\data\pcb_defects_kaggle\images/Short/12_short_01.jpg;4
1913;short;1197;1834;1253;1915;.\data\pcb_defects_kaggle\Annotations\Short\12_short_01;0.48438117833135624;0.740909090909091;56;81;2529;2530;0.022143139580862;0.032015810276679844;.\data\pcb_defects_kaggle\images/Short/12_short_01.jpg;4
1914;short;615;2237;695;2312;.\data\pcb_defects_kaggle\Annotations\Short\12_short_01;0.25899565045472517;0.8990118577075099;80;75;2529;2530;0.03163305654408857;0.029644268774703556;.\data\pcb_defects_kaggle\images/Short/12_short_01.jpg;4
1915;short;266;1134;366;1210;.\data\pcb_defects_kaggle\Annotations\Short\12_short_01;0.12495057334914986;0.4632411067193676;100;76;2529;2530;0.039541320680110716;0.030039525691699605;.\data\pcb_defects_kaggle\images/Short/12_short_01.jpg;4
1916;short;2174;785;2265;848;.\data\pcb_defects_kaggle\Annotations\Short\12_short_01;0.8776196124950574;0.32272727272727275;91;63;2529;2530;0.03598260181890075;0.024901185770750987;.\data\pcb_defects_kaggle\images/Short/12_short_01.jpg;4
1917;short;1377;283;1462;343;.\data\pcb_defects_kaggle\Annotations\Short\12_short_02;0.5612890470541716;0.12371541501976284;85;60;2529;2530;0.033610122578094107;0.023715415019762844;.\data\pcb_defects_kaggle\images/Short/12_short_02.jpg;4
1918;short;1506;394;1591;452;.\data\pcb_defects_kaggle\Annotations\Short\12_short_02;0.6122973507315145;0.16719367588932807;85;58;2529;2530;0.033610122578094107;0.02292490118577075;.\data\pcb_defects_kaggle\images/Short/12_short_02.jpg;4
1919;short;1860;837;1949;903;.\data\pcb_defects_kaggle\Annotations\Short\12_short_02;0.7530644523527086;0.3438735177865613;89;66;2529;2530;0.03519177540529854;0.02608695652173913;.\data\pcb_defects_kaggle\images/Short/12_short_02.jpg;4
1920;short;1558;1577;1622;1646;.\data\pcb_defects_kaggle\Annotations\Short\12_short_02;0.6287069988137604;0.6369565217391304;64;69;2529;2530;0.02530644523527086;0.02727272727272727;.\data\pcb_defects_kaggle\images/Short/12_short_02.jpg;4
1921;short;1126;1079;1182;1152;.\data\pcb_defects_kaggle\Annotations\Short\12_short_02;0.45630684064847765;0.4409090909090909;56;73;2529;2530;0.022143139580862;0.028853754940711462;.\data\pcb_defects_kaggle\images/Short/12_short_02.jpg;4
1922;short;1917;812;2007;875;.\data\pcb_defects_kaggle\Annotations\Short\12_short_03;0.7758007117437722;0.333399209486166;90;63;2529;2530;0.03558718861209965;0.024901185770750987;.\data\pcb_defects_kaggle\images/Short/12_short_03.jpg;4
1923;short;2224;637;2311;692;.\data\pcb_defects_kaggle\Annotations\Short\12_short_03;0.8965994464215105;0.2626482213438735;87;55;2529;2530;0.03440094899169632;0.021739130434782608;.\data\pcb_defects_kaggle\images/Short/12_short_03.jpg;4
1924;short;1731;2239;1809;2330;.\data\pcb_defects_kaggle\Annotations\Short\12_short_03;0.6998813760379596;0.9029644268774704;78;91;2529;2530;0.03084223013048636;0.03596837944664032;.\data\pcb_defects_kaggle\images/Short/12_short_03.jpg;4
1925;short;220;1575;271;1652;.\data\pcb_defects_kaggle\Annotations\Short\12_short_03;0.09707394226967181;0.6377470355731225;51;77;2529;2530;0.020166073546856466;0.030434782608695653;.\data\pcb_defects_kaggle\images/Short/12_short_03.jpg;4
1926;short;617;1472;667;1574;.\data\pcb_defects_kaggle\Annotations\Short\12_short_03;0.2538552787663108;0.6019762845849802;50;102;2529;2530;0.019770660340055358;0.04031620553359684;.\data\pcb_defects_kaggle\images/Short/12_short_03.jpg;4
1927;short;1707;444;1795;499;.\data\pcb_defects_kaggle\Annotations\Short\12_short_04;0.6923685251087386;0.18636363636363637;88;55;2529;2530;0.03479636219849743;0.021739130434782608;.\data\pcb_defects_kaggle\images/Short/12_short_04.jpg;4
1928;short;1420;683;1491;741;.\data\pcb_defects_kaggle\Annotations\Short\12_short_04;0.5755239224990115;0.28142292490118576;71;58;2529;2530;0.02807433768287861;0.02292490118577075;.\data\pcb_defects_kaggle\images/Short/12_short_04.jpg;4
1929;short;1511;1526;1569;1604;.\data\pcb_defects_kaggle\Annotations\Short\12_short_04;0.608936338473705;0.6185770750988142;58;78;2529;2530;0.022933965994464216;0.0308300395256917;.\data\pcb_defects_kaggle\images/Short/12_short_04.jpg;4
1930;short;911;1786;958;1866;.\data\pcb_defects_kaggle\Annotations\Short\12_short_04;0.3695136417556346;0.7217391304347827;47;80;2529;2530;0.018584420719652037;0.03162055335968379;.\data\pcb_defects_kaggle\images/Short/12_short_04.jpg;4
1931;short;2273;979;2387;1055;.\data\pcb_defects_kaggle\Annotations\Short\12_short_04;0.9213127718465797;0.40197628458498025;114;76;2529;2530;0.045077105575326216;0.030039525691699605;.\data\pcb_defects_kaggle\images/Short/12_short_04.jpg;4
1932;short;2047;1186;2118;1279;.\data\pcb_defects_kaggle\Annotations\Short\12_short_05;0.8234480031633057;0.4871541501976285;71;93;2529;2530;0.02807433768287861;0.036758893280632414;.\data\pcb_defects_kaggle\images/Short/12_short_05.jpg;4
1933;short;1706;1450;1797;1501;.\data\pcb_defects_kaggle\Annotations\Short\12_short_05;0.6925662317121392;0.583201581027668;91;51;2529;2530;0.03598260181890075;0.02015810276679842;.\data\pcb_defects_kaggle\images/Short/12_short_05.jpg;4
1934;short;2127;1581;2180;1672;.\data\pcb_defects_kaggle\Annotations\Short\12_short_05;0.8515223408461843;0.6428853754940711;53;91;2529;2530;0.02095689996045868;0.03596837944664032;.\data\pcb_defects_kaggle\images/Short/12_short_05.jpg;4
1935;short;546;1588;597;1657;.\data\pcb_defects_kaggle\Annotations\Short\12_short_05;0.22597864768683273;0.6413043478260869;51;69;2529;2530;0.020166073546856466;0.02727272727272727;.\data\pcb_defects_kaggle\images/Short/12_short_05.jpg;4
1936;short;1560;1792;1618;1874;.\data\pcb_defects_kaggle\Annotations\Short\12_short_05;0.6283115856069593;0.724505928853755;58;82;2529;2530;0.022933965994464216;0.03241106719367589;.\data\pcb_defects_kaggle\images/Short/12_short_05.jpg;4
1937;short;2166;1044;2233;1126;.\data\pcb_defects_kaggle\Annotations\Short\12_short_06;0.8697113483590352;0.4288537549407115;67;82;2529;2530;0.02649268485567418;0.03241106719367589;.\data\pcb_defects_kaggle\images/Short/12_short_06.jpg;4
1938;short;2080;1588;2140;1670;.\data\pcb_defects_kaggle\Annotations\Short\12_short_06;0.8343218663503361;0.6438735177865612;60;82;2529;2530;0.02372479240806643;0.03241106719367589;.\data\pcb_defects_kaggle\images/Short/12_short_06.jpg;4
1939;short;884;1588;937;1644;.\data\pcb_defects_kaggle\Annotations\Short\12_short_06;0.3600237247924081;0.6387351778656126;53;56;2529;2530;0.02095689996045868;0.022134387351778657;.\data\pcb_defects_kaggle\images/Short/12_short_06.jpg;4
1940;short;920;2019;964;2090;.\data\pcb_defects_kaggle\Annotations\Short\12_short_06;0.37247924080664296;0.8120553359683794;44;71;2529;2530;0.017398181099248716;0.02806324110671937;.\data\pcb_defects_kaggle\images/Short/12_short_06.jpg;4
1941;short;2342;1806;2411;1850;.\data\pcb_defects_kaggle\Annotations\Short\12_short_06;0.9396994859628311;0.7225296442687748;69;44;2529;2530;0.027283511269276393;0.017391304347826087;.\data\pcb_defects_kaggle\images/Short/12_short_06.jpg;4
1942;short;1318;361;1411;423;.\data\pcb_defects_kaggle\Annotations\Short\12_short_07;0.5395413206801107;0.1549407114624506;93;62;2529;2530;0.036773428232502965;0.02450592885375494;.\data\pcb_defects_kaggle\images/Short/12_short_07.jpg;4
1943;short;1867;703;1953;772;.\data\pcb_defects_kaggle\Annotations\Short\12_short_07;0.7552392249901146;0.29150197628458496;86;69;2529;2530;0.034005535784895215;0.02727272727272727;.\data\pcb_defects_kaggle\images/Short/12_short_07.jpg;4
1944;short;2167;1479;2227;1575;.\data\pcb_defects_kaggle\Annotations\Short\12_short_07;0.8687228153420324;0.6035573122529644;60;96;2529;2530;0.02372479240806643;0.037944664031620556;.\data\pcb_defects_kaggle\images/Short/12_short_07.jpg;4
1945;short;813;2017;864;2075;.\data\pcb_defects_kaggle\Annotations\Short\12_short_07;0.33155397390272834;0.808695652173913;51;58;2529;2530;0.020166073546856466;0.02292490118577075;.\data\pcb_defects_kaggle\images/Short/12_short_07.jpg;4
1946;short;1302;1083;1360;1161;.\data\pcb_defects_kaggle\Annotations\Short\12_short_07;0.5262949782522737;0.4434782608695652;58;78;2529;2530;0.022933965994464216;0.0308300395256917;.\data\pcb_defects_kaggle\images/Short/12_short_07.jpg;4
1947;short;1866;452;1957;514;.\data\pcb_defects_kaggle\Annotations\Short\12_short_08;0.7558323448003164;0.19090909090909092;91;62;2529;2530;0.03598260181890075;0.02450592885375494;.\data\pcb_defects_kaggle\images/Short/12_short_08.jpg;4
1948;short;2069;1184;2129;1281;.\data\pcb_defects_kaggle\Annotations\Short\12_short_08;0.8299723210755239;0.4871541501976285;60;97;2529;2530;0.02372479240806643;0.0383399209486166;.\data\pcb_defects_kaggle\images/Short/12_short_08.jpg;4
1949;short;1231;1088;1289;1148;.\data\pcb_defects_kaggle\Annotations\Short\12_short_08;0.498220640569395;0.44189723320158103;58;60;2529;2530;0.022933965994464216;0.023715415019762844;.\data\pcb_defects_kaggle\images/Short/12_short_08.jpg;4
1950;short;469;1583;522;1654;.\data\pcb_defects_kaggle\Annotations\Short\12_short_08;0.1959272439699486;0.6397233201581027;53;71;2529;2530;0.02095689996045868;0.02806324110671937;.\data\pcb_defects_kaggle\images/Short/12_short_08.jpg;4
1951;short;275;1174;369;1237;.\data\pcb_defects_kaggle\Annotations\Short\12_short_08;0.1273230525899565;0.4764822134387352;94;63;2529;2530;0.03716884143930407;0.024901185770750987;.\data\pcb_defects_kaggle\images/Short/12_short_08.jpg;4
1952;short;1807;1484;1902;1552;.\data\pcb_defects_kaggle\Annotations\Short\12_short_09;0.7332937920126532;0.6;95;68;2529;2530;0.03756425464610518;0.026877470355731226;.\data\pcb_defects_kaggle\images/Short/12_short_09.jpg;4
1953;short;2180;823;2260;884;.\data\pcb_defects_kaggle\Annotations\Short\12_short_09;0.8778173190984578;0.3373517786561265;80;61;2529;2530;0.03163305654408857;0.024110671936758893;.\data\pcb_defects_kaggle\images/Short/12_short_09.jpg;4
1954;short;757;1581;813;1648;.\data\pcb_defects_kaggle\Annotations\Short\12_short_09;0.31039936733886914;0.6381422924901186;56;67;2529;2530;0.022143139580862;0.026482213438735178;.\data\pcb_defects_kaggle\images/Short/12_short_09.jpg;4
1955;short;1493;1888;1555;1961;.\data\pcb_defects_kaggle\Annotations\Short\12_short_09;0.6026097271648873;0.7606719367588933;62;73;2529;2530;0.024515618821668642;0.028853754940711462;.\data\pcb_defects_kaggle\images/Short/12_short_09.jpg;4
1956;short;77;1881;158;1943;.\data\pcb_defects_kaggle\Annotations\Short\12_short_09;0.04646105179913009;0.7557312252964427;81;62;2529;2530;0.03202846975088968;0.02450592885375494;.\data\pcb_defects_kaggle\images/Short/12_short_09.jpg;4
1957;short;1920;768;2009;839;.\data\pcb_defects_kaggle\Annotations\Short\12_short_10;0.776789244760775;0.3175889328063241;89;71;2529;2530;0.03519177540529854;0.02806324110671937;.\data\pcb_defects_kaggle\images/Short/12_short_10.jpg;4
1958;short;1709;1435;1797;1484;.\data\pcb_defects_kaggle\Annotations\Short\12_short_10;0.6931593515223409;0.5768774703557312;88;49;2529;2530;0.03479636219849743;0.019367588932806323;.\data\pcb_defects_kaggle\images/Short/12_short_10.jpg;4
1959;short;2269;1712;2335;1766;.\data\pcb_defects_kaggle\Annotations\Short\12_short_10;0.9102412020561487;0.6873517786561265;66;54;2529;2530;0.02609727164887307;0.021343873517786563;.\data\pcb_defects_kaggle\images/Short/12_short_10.jpg;4
1960;short;1266;1088;1331;1155;.\data\pcb_defects_kaggle\Annotations\Short\12_short_10;0.5134440490312376;0.4432806324110672;65;67;2529;2530;0.025701858442071967;0.026482213438735178;.\data\pcb_defects_kaggle\images/Short/12_short_10.jpg;4
1961;short;1380;764;1455;819;.\data\pcb_defects_kaggle\Annotations\Short\12_short_10;0.5604982206405694;0.31284584980237157;75;55;2529;2530;0.02965599051008304;0.021739130434782608;.\data\pcb_defects_kaggle\images/Short/12_short_10.jpg;4
1962;spur;1444;1123;1474;1156;.\data\pcb_defects_kaggle\Annotations\Spur\01_spur_01;0.480883322346737;0.7184741488020177;30;33;3034;1586;0.00988793671720501;0.02080706179066835;.\data\pcb_defects_kaggle\images/Spur/01_spur_01.jpg;5
1963;spur;1318;1263;1353;1295;.\data\pcb_defects_kaggle\Annotations\Spur\01_spur_01;0.4401779828609097;0.8064312736443884;35;32;3034;1586;0.011535926170072512;0.0201765447667087;.\data\pcb_defects_kaggle\images/Spur/01_spur_01.jpg;5
1964;spur;952;1291;987;1323;.\data\pcb_defects_kaggle\Annotations\Spur\01_spur_01;0.31954515491100854;0.8240857503152585;35;32;3034;1586;0.011535926170072512;0.0201765447667087;.\data\pcb_defects_kaggle\images/Spur/01_spur_01.jpg;5
1965;spur;766;1156;804;1199;.\data\pcb_defects_kaggle\Annotations\Spur\01_spur_02;0.25873434410019774;0.7424337957124842;38;43;3034;1586;0.012524719841793012;0.02711223203026482;.\data\pcb_defects_kaggle\images/Spur/01_spur_02.jpg;5
1966;spur;720;1224;758;1259;.\data\pcb_defects_kaggle\Annotations\Spur\01_spur_02;0.24357284113381675;0.7827868852459017;38;35;3034;1586;0.012524719841793012;0.022068095838587643;.\data\pcb_defects_kaggle\images/Spur/01_spur_02.jpg;5
1967;spur;821;1337;862;1377;.\data\pcb_defects_kaggle\Annotations\Spur\01_spur_02;0.27735662491760055;0.8556116015132409;41;40;3034;1586;0.013513513513513514;0.025220680958385876;.\data\pcb_defects_kaggle\images/Spur/01_spur_02.jpg;5
1968;spur;1257;1308;1294;1350;.\data\pcb_defects_kaggle\Annotations\Spur\01_spur_03;0.4204021094264997;0.8379571248423707;37;42;3034;1586;0.012195121951219513;0.02648171500630517;.\data\pcb_defects_kaggle\images/Spur/01_spur_03.jpg;5
1969;spur;1650;1376;1687;1411;.\data\pcb_defects_kaggle\Annotations\Spur\01_spur_03;0.5499340804218853;0.8786254728877679;37;35;3034;1586;0.012195121951219513;0.022068095838587643;.\data\pcb_defects_kaggle\images/Spur/01_spur_03.jpg;5
1970;spur;1669;1100;1707;1138;.\data\pcb_defects_kaggle\Annotations\Spur\01_spur_03;0.5563612392880686;0.7055485498108449;38;38;3034;1586;0.012524719841793012;0.02395964691046658;.\data\pcb_defects_kaggle\images/Spur/01_spur_03.jpg;5
1971;spur;2708;937;2751;973;.\data\pcb_defects_kaggle\Annotations\Spur\01_spur_04;0.8996374423203691;0.6021437578814628;43;36;3034;1586;0.014172709294660513;0.02269861286254729;.\data\pcb_defects_kaggle\images/Spur/01_spur_04.jpg;5
1972;spur;2153;1156;2190;1189;.\data\pcb_defects_kaggle\Annotations\Spur\01_spur_04;0.715721819380356;0.739281210592686;37;33;3034;1586;0.012195121951219513;0.02080706179066835;.\data\pcb_defects_kaggle\images/Spur/01_spur_04.jpg;5
1973;spur;2329;1141;2372;1188;.\data\pcb_defects_kaggle\Annotations\Spur\01_spur_04;0.7747198417930126;0.7342370744010088;43;47;3034;1586;0.014172709294660513;0.029634300126103404;.\data\pcb_defects_kaggle\images/Spur/01_spur_04.jpg;5
1974;spur;1912;815;1966;856;.\data\pcb_defects_kaggle\Annotations\Spur\01_spur_05;0.6390903098220171;0.526796973518285;54;41;3034;1586;0.017798286090969017;0.025851197982345524;.\data\pcb_defects_kaggle\images/Spur/01_spur_05.jpg;5
1975;spur;2323;1098;2356;1134;.\data\pcb_defects_kaggle\Annotations\Spur\01_spur_05;0.771094264996704;0.7036569987389659;33;36;3034;1586;0.010876730388925511;0.02269861286254729;.\data\pcb_defects_kaggle\images/Spur/01_spur_05.jpg;5
1976;spur;2157;844;2208;884;.\data\pcb_defects_kaggle\Annotations\Spur\01_spur_05;0.7193473961766644;0.544766708701135;51;40;3034;1586;0.016809492419248517;0.025220680958385876;.\data\pcb_defects_kaggle\images/Spur/01_spur_05.jpg;5
1977;spur;2200;590;2238;633;.\data\pcb_defects_kaggle\Annotations\Spur\01_spur_06;0.7313777191825972;0.3855611601513241;38;43;3034;1586;0.012524719841793012;0.02711223203026482;.\data\pcb_defects_kaggle\images/Spur/01_spur_06.jpg;5
1978;spur;2613;449;2651;485;.\data\pcb_defects_kaggle\Annotations\Spur\01_spur_06;0.8675016479894528;0.2944514501891551;38;36;3034;1586;0.012524719841793012;0.02269861286254729;.\data\pcb_defects_kaggle\images/Spur/01_spur_06.jpg;5
1979;spur;2181;287;2230;328;.\data\pcb_defects_kaggle\Annotations\Spur\01_spur_06;0.726928147659855;0.19388398486759142;49;41;3034;1586;0.016150296638101518;0.025851197982345524;.\data\pcb_defects_kaggle\images/Spur/01_spur_06.jpg;5
1980;spur;1668;402;1708;443;.\data\pcb_defects_kaggle\Annotations\Spur\01_spur_07;0.5563612392880686;0.26639344262295084;40;41;3034;1586;0.013183915622940013;0.025851197982345524;.\data\pcb_defects_kaggle\images/Spur/01_spur_07.jpg;5
1981;spur;1695;579;1737;621;.\data\pcb_defects_kaggle\Annotations\Spur\01_spur_07;0.5655899802241265;0.37831021437578816;42;42;3034;1586;0.013843111404087014;0.02648171500630517;.\data\pcb_defects_kaggle\images/Spur/01_spur_07.jpg;5
1982;spur;1326;390;1398;452;.\data\pcb_defects_kaggle\Annotations\Spur\01_spur_07;0.44891232696110744;0.26544766708701134;72;62;3034;1586;0.023731048121292023;0.03909205548549811;.\data\pcb_defects_kaggle\images/Spur/01_spur_07.jpg;5
1983;spur;1510;1162;1566;1217;.\data\pcb_defects_kaggle\Annotations\Spur\01_spur_08;0.5069215557020436;0.75;56;55;3034;1586;0.01845748187211602;0.03467843631778058;.\data\pcb_defects_kaggle\images/Spur/01_spur_08.jpg;5
1984;spur;1680;1369;1721;1410;.\data\pcb_defects_kaggle\Annotations\Spur\01_spur_08;0.5604812129202373;0.8761034047919294;41;41;3034;1586;0.013513513513513514;0.025851197982345524;.\data\pcb_defects_kaggle\images/Spur/01_spur_08.jpg;5
1985;spur;1254;1337;1307;1373;.\data\pcb_defects_kaggle\Annotations\Spur\01_spur_08;0.4220500988793672;0.8543505674653216;53;36;3034;1586;0.01746868820039552;0.02269861286254729;.\data\pcb_defects_kaggle\images/Spur/01_spur_08.jpg;5
1986;spur;783;1033;828;1077;.\data\pcb_defects_kaggle\Annotations\Spur\01_spur_09;0.26549110085695454;0.6651954602774275;45;44;3034;1586;0.014831905075807514;0.027742749054224466;.\data\pcb_defects_kaggle\images/Spur/01_spur_09.jpg;5
1987;spur;473;964;519;1012;.\data\pcb_defects_kaggle\Annotations\Spur\01_spur_09;0.16348055372445616;0.6229508196721312;46;48;3034;1586;0.015161502966381015;0.03026481715006305;.\data\pcb_defects_kaggle\images/Spur/01_spur_09.jpg;5
1988;spur;472;393;530;432;.\data\pcb_defects_kaggle\Annotations\Spur\01_spur_10;0.16512854317732367;0.26008827238335436;58;39;3034;1586;0.01911667765326302;0.02459016393442623;.\data\pcb_defects_kaggle\images/Spur/01_spur_10.jpg;5
1989;spur;178;1117;211;1156;.\data\pcb_defects_kaggle\Annotations\Spur\01_spur_10;0.06410678971654582;0.7165825977301387;33;39;3034;1586;0.010876730388925511;0.02459016393442623;.\data\pcb_defects_kaggle\images/Spur/01_spur_10.jpg;5
1990;spur;529;1184;562;1219;.\data\pcb_defects_kaggle\Annotations\Spur\01_spur_10;0.17979564930784442;0.7575662042875158;33;35;3034;1586;0.010876730388925511;0.022068095838587643;.\data\pcb_defects_kaggle\images/Spur/01_spur_10.jpg;5
1991;spur;597;801;635;845;.\data\pcb_defects_kaggle\Annotations\Spur\01_spur_11;0.2030323005932762;0.5189155107187894;38;44;3034;1586;0.012524719841793012;0.027742749054224466;.\data\pcb_defects_kaggle\images/Spur/01_spur_11.jpg;5
1992;spur;720;741;765;771;.\data\pcb_defects_kaggle\Annotations\Spur\01_spur_11;0.244726433750824;0.4766708701134931;45;30;3034;1586;0.014831905075807514;0.018915510718789406;.\data\pcb_defects_kaggle\images/Spur/01_spur_11.jpg;5
1993;spur;961;885;1005;923;.\data\pcb_defects_kaggle\Annotations\Spur\01_spur_11;0.3239947264337508;0.5699873896595208;44;38;3034;1586;0.014502307185234015;0.02395964691046658;.\data\pcb_defects_kaggle\images/Spur/01_spur_11.jpg;5
1994;spur;589;972;625;1010;.\data\pcb_defects_kaggle\Annotations\Spur\01_spur_12;0.2000659195781147;0.6248423707440101;36;38;3034;1586;0.011865524060646011;0.02395964691046658;.\data\pcb_defects_kaggle\images/Spur/01_spur_12.jpg;5
1995;spur;601;1197;645;1243;.\data\pcb_defects_kaggle\Annotations\Spur\01_spur_12;0.2053394858272907;0.7692307692307693;44;46;3034;1586;0.014502307185234015;0.029003783102143757;.\data\pcb_defects_kaggle\images/Spur/01_spur_12.jpg;5
1996;spur;1516;1030;1549;1066;.\data\pcb_defects_kaggle\Annotations\Spur\01_spur_13;0.5051087673038892;0.6607818411097099;33;36;3034;1586;0.010876730388925511;0.02269861286254729;.\data\pcb_defects_kaggle\images/Spur/01_spur_13.jpg;5
1997;spur;1653;1092;1689;1120;.\data\pcb_defects_kaggle\Annotations\Spur\01_spur_13;0.5507580751483191;0.6973518284993695;36;28;3034;1586;0.011865524060646011;0.017654476670870115;.\data\pcb_defects_kaggle\images/Spur/01_spur_13.jpg;5
1998;spur;1671;804;1711;840;.\data\pcb_defects_kaggle\Annotations\Spur\01_spur_14;0.557350032959789;0.5182849936948297;40;36;3034;1586;0.013183915622940013;0.02269861286254729;.\data\pcb_defects_kaggle\images/Spur/01_spur_14.jpg;5
1999;spur;1684;401;1725;435;.\data\pcb_defects_kaggle\Annotations\Spur\01_spur_14;0.5617996044825313;0.2635561160151324;41;34;3034;1586;0.013513513513513514;0.021437578814627996;.\data\pcb_defects_kaggle\images/Spur/01_spur_14.jpg;5
2000;spur;1475;591;1513;629;.\data\pcb_defects_kaggle\Annotations\Spur\01_spur_14;0.4924192485168095;0.38461538461538464;38;38;3034;1586;0.012524719841793012;0.02395964691046658;.\data\pcb_defects_kaggle\images/Spur/01_spur_14.jpg;5
2001;spur;399;426;471;474;.\data\pcb_defects_kaggle\Annotations\Spur\01_spur_15;0.14337508239947264;0.2837326607818411;72;48;3034;1586;0.023731048121292023;0.03026481715006305;.\data\pcb_defects_kaggle\images/Spur/01_spur_15.jpg;5
2002;spur;717;287;775;333;.\data\pcb_defects_kaggle\Annotations\Spur\01_spur_15;0.24588002636783124;0.19546027742749053;58;46;3034;1586;0.01911667765326302;0.029003783102143757;.\data\pcb_defects_kaggle\images/Spur/01_spur_15.jpg;5
2003;spur;2295;1289;2331;1328;.\data\pcb_defects_kaggle\Annotations\Spur\01_spur_16;0.7623599208965063;0.825031525851198;36;39;3034;1586;0.011865524060646011;0.02459016393442623;.\data\pcb_defects_kaggle\images/Spur/01_spur_16.jpg;5
2004;spur;2129;980;2175;1020;.\data\pcb_defects_kaggle\Annotations\Spur\01_spur_16;0.7092946605141727;0.6305170239596469;46;40;3034;1586;0.015161502966381015;0.025220680958385876;.\data\pcb_defects_kaggle\images/Spur/01_spur_16.jpg;5
2005;spur;2419;1105;2467;1146;.\data\pcb_defects_kaggle\Annotations\Spur\01_spur_16;0.8052076466710613;0.7096469104665826;48;41;3034;1586;0.015820698747528016;0.025851197982345524;.\data\pcb_defects_kaggle\images/Spur/01_spur_16.jpg;5
2006;spur;2205;595;2237;638;.\data\pcb_defects_kaggle\Annotations\Spur\01_spur_17;0.7320369149637442;0.38871374527112235;32;43;3034;1586;0.01054713249835201;0.02711223203026482;.\data\pcb_defects_kaggle\images/Spur/01_spur_17.jpg;5
2007;spur;1923;750;1964;780;.\data\pcb_defects_kaggle\Annotations\Spur\01_spur_17;0.6405735003295979;0.4823455233291299;41;30;3034;1586;0.013513513513513514;0.018915510718789406;.\data\pcb_defects_kaggle\images/Spur/01_spur_17.jpg;5
2008;spur;2482;597;2525;630;.\data\pcb_defects_kaggle\Annotations\Spur\01_spur_17;0.825148319050758;0.38682219419924335;43;33;3034;1586;0.014172709294660513;0.02080706179066835;.\data\pcb_defects_kaggle\images/Spur/01_spur_17.jpg;5
2009;spur;2499;442;2545;489;.\data\pcb_defects_kaggle\Annotations\Spur\01_spur_18;0.8312458800263678;0.29350567465321564;46;47;3034;1586;0.015161502966381015;0.029634300126103404;.\data\pcb_defects_kaggle\images/Spur/01_spur_18.jpg;5
2010;spur;2669;315;2706;344;.\data\pcb_defects_kaggle\Annotations\Spur\01_spur_18;0.8857943309162821;0.20775535939470366;37;29;3034;1586;0.012195121951219513;0.01828499369482976;.\data\pcb_defects_kaggle\images/Spur/01_spur_18.jpg;5
2011;spur;2430;1166;2470;1205;.\data\pcb_defects_kaggle\Annotations\Spur\01_spur_19;0.8075148319050758;0.7474779319041615;40;39;3034;1586;0.013183915622940013;0.02459016393442623;.\data\pcb_defects_kaggle\images/Spur/01_spur_19.jpg;5
2012;spur;2700;1164;2744;1201;.\data\pcb_defects_kaggle\Annotations\Spur\01_spur_19;0.8971654581410679;0.7455863808322825;44;37;3034;1586;0.014502307185234015;0.023329129886506934;.\data\pcb_defects_kaggle\images/Spur/01_spur_19.jpg;5
2013;spur;2140;1151;2194;1188;.\data\pcb_defects_kaggle\Annotations\Spur\01_spur_20;0.7142386288727752;0.737389659520807;54;37;3034;1586;0.017798286090969017;0.023329129886506934;.\data\pcb_defects_kaggle\images/Spur/01_spur_20.jpg;5
2014;spur;1977;1021;2018;1071;.\data\pcb_defects_kaggle\Annotations\Spur\01_spur_20;0.6583717864205669;0.6595208070617906;41;50;3034;1586;0.013513513513513514;0.031525851197982346;.\data\pcb_defects_kaggle\images/Spur/01_spur_20.jpg;5
2015;spur;1917;1357;1984;1441;.\data\pcb_defects_kaggle\Annotations\Spur\04_spur_01;0.6382526178010471;0.567775974025974;67;84;3056;2464;0.021924083769633507;0.03409090909090909;.\data\pcb_defects_kaggle\images/Spur/04_spur_01.jpg;5
2016;spur;997;2064;1117;2126;.\data\pcb_defects_kaggle\Annotations\Spur\04_spur_01;0.3458769633507853;0.8502435064935064;120;62;3056;2464;0.03926701570680628;0.025162337662337664;.\data\pcb_defects_kaggle\images/Spur/04_spur_01.jpg;5
2017;spur;830;1215;911;1268;.\data\pcb_defects_kaggle\Annotations\Spur\04_spur_01;0.2848494764397906;0.5038555194805194;81;53;3056;2464;0.02650523560209424;0.02150974025974026;.\data\pcb_defects_kaggle\images/Spur/04_spur_01.jpg;5
2018;spur;1697;1830;1775;1888;.\data\pcb_defects_kaggle\Annotations\Spur\04_spur_02;0.5680628272251309;0.7544642857142857;78;58;3056;2464;0.025523560209424083;0.02353896103896104;.\data\pcb_defects_kaggle\images/Spur/04_spur_02.jpg;5
2019;spur;2486;1871;2559;1930;.\data\pcb_defects_kaggle\Annotations\Spur\04_spur_02;0.825425392670157;0.7713068181818182;73;59;3056;2464;0.023887434554973823;0.023944805194805196;.\data\pcb_defects_kaggle\images/Spur/04_spur_02.jpg;5
2020;spur;2168;866;2219;944;.\data\pcb_defects_kaggle\Annotations\Spur\04_spur_02;0.7177683246073299;0.367288961038961;51;78;3056;2464;0.01668848167539267;0.03165584415584415;.\data\pcb_defects_kaggle\images/Spur/04_spur_02.jpg;5
2021;spur;1955;1288;2017;1370;.\data\pcb_defects_kaggle\Annotations\Spur\04_spur_03;0.649869109947644;0.5393668831168831;62;82;3056;2464;0.020287958115183247;0.033279220779220776;.\data\pcb_defects_kaggle\images/Spur/04_spur_03.jpg;5
2022;spur;2601;1693;2655;1782;.\data\pcb_defects_kaggle\Annotations\Spur\04_spur_03;0.8599476439790575;0.7051542207792207;54;89;3056;2464;0.01767015706806283;0.03612012987012987;.\data\pcb_defects_kaggle\images/Spur/04_spur_03.jpg;5
2023;spur;1888;1782;1942;1864;.\data\pcb_defects_kaggle\Annotations\Spur\04_spur_03;0.6266361256544503;0.7398538961038961;54;82;3056;2464;0.01767015706806283;0.033279220779220776;.\data\pcb_defects_kaggle\images/Spur/04_spur_03.jpg;5
2024;spur;1913;1319;1986;1421;.\data\pcb_defects_kaggle\Annotations\Spur\04_spur_04;0.637925392670157;0.5560064935064936;73;102;3056;2464;0.023887434554973823;0.041396103896103896;.\data\pcb_defects_kaggle\images/Spur/04_spur_04.jpg;5
2025;spur;608;1304;664;1391;.\data\pcb_defects_kaggle\Annotations\Spur\04_spur_04;0.2081151832460733;0.546875;56;87;3056;2464;0.01832460732984293;0.03530844155844156;.\data\pcb_defects_kaggle\images/Spur/04_spur_04.jpg;5
2026;spur;424;1322;482;1421;.\data\pcb_defects_kaggle\Annotations\Spur\04_spur_04;0.1482329842931937;0.5566152597402597;58;99;3056;2464;0.018979057591623036;0.04017857142857143;.\data\pcb_defects_kaggle\images/Spur/04_spur_04.jpg;5
2027;spur;2202;879;2264;951;.\data\pcb_defects_kaggle\Annotations\Spur\04_spur_05;0.7306937172774869;0.3713474025974026;62;72;3056;2464;0.020287958115183247;0.02922077922077922;.\data\pcb_defects_kaggle\images/Spur/04_spur_05.jpg;5
2028;spur;2075;637;2122;726;.\data\pcb_defects_kaggle\Annotations\Spur\04_spur_05;0.6866819371727748;0.2765827922077922;47;89;3056;2464;0.015379581151832461;0.03612012987012987;.\data\pcb_defects_kaggle\images/Spur/04_spur_05.jpg;5
2029;spur;1635;722;1675;779;.\data\pcb_defects_kaggle\Annotations\Spur\04_spur_05;0.5415575916230366;0.304586038961039;40;57;3056;2464;0.013089005235602094;0.023133116883116884;.\data\pcb_defects_kaggle\images/Spur/04_spur_05.jpg;5
2030;spur;1928;1371;1982;1471;.\data\pcb_defects_kaggle\Annotations\Spur\04_spur_06;0.6397251308900523;0.5767045454545454;54;100;3056;2464;0.01767015706806283;0.040584415584415584;.\data\pcb_defects_kaggle\images/Spur/04_spur_06.jpg;5
2031;spur;757;2068;846;2131;.\data\pcb_defects_kaggle\Annotations\Spur\04_spur_06;0.26227094240837695;0.8520698051948052;89;63;3056;2464;0.02912303664921466;0.02556818181818182;.\data\pcb_defects_kaggle\images/Spur/04_spur_06.jpg;5
2032;spur;1179;1891;1231;1964;.\data\pcb_defects_kaggle\Annotations\Spur\04_spur_06;0.3943062827225131;0.7822646103896104;52;73;3056;2464;0.017015706806282723;0.029626623376623376;.\data\pcb_defects_kaggle\images/Spur/04_spur_06.jpg;5
2033;spur;2199;831;2262;917;.\data\pcb_defects_kaggle\Annotations\Spur\04_spur_07;0.7298756544502618;0.3547077922077922;63;86;3056;2464;0.0206151832460733;0.0349025974025974;.\data\pcb_defects_kaggle\images/Spur/04_spur_07.jpg;5
2034;spur;922;1091;997;1173;.\data\pcb_defects_kaggle\Annotations\Spur\04_spur_07;0.31397251308900526;0.4594155844155844;75;82;3056;2464;0.02454188481675393;0.033279220779220776;.\data\pcb_defects_kaggle\images/Spur/04_spur_07.jpg;5
2035;spur;2410;1362;2479;1448;.\data\pcb_defects_kaggle\Annotations\Spur\04_spur_07;0.799901832460733;0.570211038961039;69;86;3056;2464;0.022578534031413612;0.0349025974025974;.\data\pcb_defects_kaggle\images/Spur/04_spur_07.jpg;5
2036;spur;1946;1350;2017;1446;.\data\pcb_defects_kaggle\Annotations\Spur\04_spur_08;0.6483965968586387;0.5673701298701299;71;96;3056;2464;0.023232984293193717;0.03896103896103896;.\data\pcb_defects_kaggle\images/Spur/04_spur_08.jpg;5
2037;spur;962;1026;1013;1099;.\data\pcb_defects_kaggle\Annotations\Spur\04_spur_08;0.3231348167539267;0.4312094155844156;51;73;3056;2464;0.01668848167539267;0.029626623376623376;.\data\pcb_defects_kaggle\images/Spur/04_spur_08.jpg;5
2038;spur;477;1290;531;1390;.\data\pcb_defects_kaggle\Annotations\Spur\04_spur_08;0.1649214659685864;0.5438311688311688;54;100;3056;2464;0.01767015706806283;0.040584415584415584;.\data\pcb_defects_kaggle\images/Spur/04_spur_08.jpg;5
2039;spur;848;1237;933;1282;.\data\pcb_defects_kaggle\Annotations\Spur\04_spur_09;0.2913939790575916;0.5111607142857143;85;45;3056;2464;0.027814136125654452;0.018262987012987012;.\data\pcb_defects_kaggle\images/Spur/04_spur_09.jpg;5
2040;spur;461;1231;515;1310;.\data\pcb_defects_kaggle\Annotations\Spur\04_spur_09;0.15968586387434555;0.515625;54;79;3056;2464;0.01767015706806283;0.03206168831168831;.\data\pcb_defects_kaggle\images/Spur/04_spur_09.jpg;5
2041;spur;382;2199;450;2257;.\data\pcb_defects_kaggle\Annotations\Spur\04_spur_09;0.13612565445026178;0.9042207792207793;68;58;3056;2464;0.02225130890052356;0.02353896103896104;.\data\pcb_defects_kaggle\images/Spur/04_spur_09.jpg;5
2042;spur;2071;619;2131;699;.\data\pcb_defects_kaggle\Annotations\Spur\04_spur_10;0.6875;0.2674512987012987;60;80;3056;2464;0.01963350785340314;0.032467532467532464;.\data\pcb_defects_kaggle\images/Spur/04_spur_10.jpg;5
2043;spur;1748;799;1808;873;.\data\pcb_defects_kaggle\Annotations\Spur\04_spur_10;0.5818062827225131;0.3392857142857143;60;74;3056;2464;0.01963350785340314;0.030032467532467532;.\data\pcb_defects_kaggle\images/Spur/04_spur_10.jpg;5
2044;spur;461;524;548;579;.\data\pcb_defects_kaggle\Annotations\Spur\04_spur_10;0.16508507853403143;0.22382305194805194;87;55;3056;2464;0.028468586387434554;0.022321428571428572;.\data\pcb_defects_kaggle\images/Spur/04_spur_10.jpg;5
2045;spur;2135;1804;2190;1897;.\data\pcb_defects_kaggle\Annotations\Spur\04_spur_11;0.7076243455497382;0.7510146103896104;55;93;3056;2464;0.01799738219895288;0.037743506493506496;.\data\pcb_defects_kaggle\images/Spur/04_spur_11.jpg;5
2046;spur;926;2101;1033;2170;.\data\pcb_defects_kaggle\Annotations\Spur\04_spur_11;0.3205170157068063;0.8666801948051948;107;69;3056;2464;0.0350130890052356;0.028003246753246752;.\data\pcb_defects_kaggle\images/Spur/04_spur_11.jpg;5
2047;spur;2610;1671;2666;1768;.\data\pcb_defects_kaggle\Annotations\Spur\04_spur_11;0.8632198952879581;0.697849025974026;56;97;3056;2464;0.01832460732984293;0.03936688311688312;.\data\pcb_defects_kaggle\images/Spur/04_spur_11.jpg;5
2048;spur;1959;1326;2008;1431;.\data\pcb_defects_kaggle\Annotations\Spur\04_spur_12;0.6490510471204188;0.5594561688311688;49;105;3056;2464;0.016034031413612565;0.04261363636363636;.\data\pcb_defects_kaggle\images/Spur/04_spur_12.jpg;5
2049;spur;659;1219;759;1268;.\data\pcb_defects_kaggle\Annotations\Spur\04_spur_12;0.2320026178010471;0.5046672077922078;100;49;3056;2464;0.032722513089005235;0.019886363636363636;.\data\pcb_defects_kaggle\images/Spur/04_spur_12.jpg;5
2050;spur;859;1118;928;1161;.\data\pcb_defects_kaggle\Annotations\Spur\04_spur_12;0.29237565445026176;0.4624594155844156;69;43;3056;2464;0.022578534031413612;0.0174512987012987;.\data\pcb_defects_kaggle\images/Spur/04_spur_12.jpg;5
2051;spur;2166;877;2224;962;.\data\pcb_defects_kaggle\Annotations\Spur\04_spur_13;0.7182591623036649;0.3731737012987013;58;85;3056;2464;0.018979057591623036;0.03449675324675325;.\data\pcb_defects_kaggle\images/Spur/04_spur_13.jpg;5
2052;spur;521;2277;595;2337;.\data\pcb_defects_kaggle\Annotations\Spur\04_spur_13;0.18259162303664922;0.9362824675324676;74;60;3056;2464;0.024214659685863876;0.024350649350649352;.\data\pcb_defects_kaggle\images/Spur/04_spur_13.jpg;5
2053;spur;2110;410;2184;459;.\data\pcb_defects_kaggle\Annotations\Spur\04_spur_13;0.7025523560209425;0.17633928571428573;74;49;3056;2464;0.024214659685863876;0.019886363636363636;.\data\pcb_defects_kaggle\images/Spur/04_spur_13.jpg;5
2054;spur;1931;1797;1984;1862;.\data\pcb_defects_kaggle\Annotations\Spur\04_spur_14;0.6405431937172775;0.7424918831168831;53;65;3056;2464;0.017342931937172776;0.026379870129870128;.\data\pcb_defects_kaggle\images/Spur/04_spur_14.jpg;5
2055;spur;788;2106;864;2164;.\data\pcb_defects_kaggle\Annotations\Spur\04_spur_14;0.27028795811518325;0.8664772727272727;76;58;3056;2464;0.024869109947643978;0.02353896103896104;.\data\pcb_defects_kaggle\images/Spur/04_spur_14.jpg;5
2056;spur;1137;1841;1204;1933;.\data\pcb_defects_kaggle\Annotations\Spur\04_spur_14;0.3830170157068063;0.765827922077922;67;92;3056;2464;0.021924083769633507;0.037337662337662336;.\data\pcb_defects_kaggle\images/Spur/04_spur_14.jpg;5
2057;spur;2441;1733;2499;1791;.\data\pcb_defects_kaggle\Annotations\Spur\04_spur_15;0.8082460732984293;0.7150974025974026;58;58;3056;2464;0.018979057591623036;0.02353896103896104;.\data\pcb_defects_kaggle\images/Spur/04_spur_15.jpg;5
2058;spur;1917;1415;1975;1497;.\data\pcb_defects_kaggle\Annotations\Spur\04_spur_15;0.6367801047120419;0.5909090909090909;58;82;3056;2464;0.018979057591623036;0.033279220779220776;.\data\pcb_defects_kaggle\images/Spur/04_spur_15.jpg;5
2059;spur;657;1210;744;1270;.\data\pcb_defects_kaggle\Annotations\Spur\04_spur_15;0.2292212041884817;0.5032467532467533;87;60;3056;2464;0.028468586387434554;0.024350649350649352;.\data\pcb_defects_kaggle\images/Spur/04_spur_15.jpg;5
2060;spur;457;1295;510;1393;.\data\pcb_defects_kaggle\Annotations\Spur\04_spur_16;0.15821335078534032;0.5454545454545454;53;98;3056;2464;0.017342931937172776;0.03977272727272727;.\data\pcb_defects_kaggle\images/Spur/04_spur_16.jpg;5
2061;spur;2417;1368;2473;1459;.\data\pcb_defects_kaggle\Annotations\Spur\04_spur_16;0.800065445026178;0.5736607142857143;56;91;3056;2464;0.01832460732984293;0.036931818181818184;.\data\pcb_defects_kaggle\images/Spur/04_spur_16.jpg;5
2062;spur;2386;1002;2461;1064;.\data\pcb_defects_kaggle\Annotations\Spur\04_spur_16;0.7930301047120419;0.419237012987013;75;62;3056;2464;0.02454188481675393;0.025162337662337664;.\data\pcb_defects_kaggle\images/Spur/04_spur_16.jpg;5
2063;spur;2201;846;2259;957;.\data\pcb_defects_kaggle\Annotations\Spur\04_spur_17;0.7297120418848168;0.3658685064935065;58;111;3056;2464;0.018979057591623036;0.045048701298701296;.\data\pcb_defects_kaggle\images/Spur/04_spur_17.jpg;5
2064;spur;1786;808;1839;866;.\data\pcb_defects_kaggle\Annotations\Spur\04_spur_17;0.5930955497382199;0.33969155844155846;53;58;3056;2464;0.017342931937172776;0.02353896103896104;.\data\pcb_defects_kaggle\images/Spur/04_spur_17.jpg;5
2065;spur;2628;1677;2675;1771;.\data\pcb_defects_kaggle\Annotations\Spur\04_spur_17;0.8676374345549738;0.6996753246753247;47;94;3056;2464;0.015379581151832461;0.03814935064935065;.\data\pcb_defects_kaggle\images/Spur/04_spur_17.jpg;5
2066;spur;448;2344;544;2391;.\data\pcb_defects_kaggle\Annotations\Spur\04_spur_18;0.16230366492146597;0.960836038961039;96;47;3056;2464;0.031413612565445025;0.019074675324675324;.\data\pcb_defects_kaggle\images/Spur/04_spur_18.jpg;5
2067;spur;2391;1039;2462;1122;.\data\pcb_defects_kaggle\Annotations\Spur\04_spur_18;0.7940117801047121;0.43851461038961037;71;83;3056;2464;0.023232984293193717;0.033685064935064936;.\data\pcb_defects_kaggle\images/Spur/04_spur_18.jpg;5
2068;spur;2424;1759;2522;1815;.\data\pcb_defects_kaggle\Annotations\Spur\04_spur_18;0.8092277486910995;0.7252435064935064;98;56;3056;2464;0.03206806282722513;0.022727272727272728;.\data\pcb_defects_kaggle\images/Spur/04_spur_18.jpg;5
2069;spur;855;1235;961;1286;.\data\pcb_defects_kaggle\Annotations\Spur\04_spur_19;0.29712041884816753;0.5115665584415584;106;51;3056;2464;0.03468586387434555;0.020698051948051948;.\data\pcb_defects_kaggle\images/Spur/04_spur_19.jpg;5
2070;spur;488;2297;586;2346;.\data\pcb_defects_kaggle\Annotations\Spur\04_spur_19;0.17571989528795812;0.9421672077922078;98;49;3056;2464;0.03206806282722513;0.019886363636363636;.\data\pcb_defects_kaggle\images/Spur/04_spur_19.jpg;5
2071;spur;831;2110;971;2157;.\data\pcb_defects_kaggle\Annotations\Spur\04_spur_19;0.29482984293193715;0.8658685064935064;140;47;3056;2464;0.04581151832460733;0.019074675324675324;.\data\pcb_defects_kaggle\images/Spur/04_spur_19.jpg;5
2072;spur;1955;1273;1997;1375;.\data\pcb_defects_kaggle\Annotations\Spur\04_spur_20;0.6465968586387435;0.5373376623376623;42;102;3056;2464;0.0137434554973822;0.041396103896103896;.\data\pcb_defects_kaggle\images/Spur/04_spur_20.jpg;5
2073;spur;490;1273;530;1371;.\data\pcb_defects_kaggle\Annotations\Spur\04_spur_20;0.1668848167539267;0.536525974025974;40;98;3056;2464;0.013089005235602094;0.03977272727272727;.\data\pcb_defects_kaggle\images/Spur/04_spur_20.jpg;5
2074;spur;1170;1873;1221;1962;.\data\pcb_defects_kaggle\Annotations\Spur\04_spur_20;0.3911976439790576;0.7782061688311688;51;89;3056;2464;0.01668848167539267;0.03612012987012987;.\data\pcb_defects_kaggle\images/Spur/04_spur_20.jpg;5
2075;spur;580;1438;645;1490;.\data\pcb_defects_kaggle\Annotations\Spur\05_spur_01;0.2407625786163522;0.6790352504638218;65;52;2544;2156;0.025550314465408806;0.02411873840445269;.\data\pcb_defects_kaggle\images/Spur/05_spur_01.jpg;5
2076;spur;1947;1465;2025;1506;.\data\pcb_defects_kaggle\Annotations\Spur\05_spur_01;0.7806603773584906;0.6890074211502782;78;41;2544;2156;0.030660377358490566;0.019016697588126158;.\data\pcb_defects_kaggle\images/Spur/05_spur_01.jpg;5
2077;spur;1577;726;1641;776;.\data\pcb_defects_kaggle\Annotations\Spur\05_spur_01;0.6324685534591195;0.34833024118738404;64;50;2544;2156;0.025157232704402517;0.023191094619666047;.\data\pcb_defects_kaggle\images/Spur/05_spur_01.jpg;5
2078;spur;919;959;1014;1012;.\data\pcb_defects_kaggle\Annotations\Spur\05_spur_01;0.3799135220125786;0.4570964749536178;95;53;2544;2156;0.03734276729559748;0.02458256029684601;.\data\pcb_defects_kaggle\images/Spur/05_spur_01.jpg;5
2079;spur;1617;1013;1691;1071;.\data\pcb_defects_kaggle\Annotations\Spur\05_spur_01;0.6501572327044025;0.48330241187384043;74;58;2544;2156;0.02908805031446541;0.026901669758812616;.\data\pcb_defects_kaggle\images/Spur/05_spur_01.jpg;5
2080;spur;803;329;883;381;.\data\pcb_defects_kaggle\Annotations\Spur\05_spur_02;0.3313679245283019;0.16465677179962895;80;52;2544;2156;0.031446540880503145;0.02411873840445269;.\data\pcb_defects_kaggle\images/Spur/05_spur_02.jpg;5
2081;spur;400;615;502;668;.\data\pcb_defects_kaggle\Annotations\Spur\05_spur_02;0.17727987421383648;0.2975417439703154;102;53;2544;2156;0.04009433962264151;0.02458256029684601;.\data\pcb_defects_kaggle\images/Spur/05_spur_02.jpg;5
2082;spur;895;1070;972;1131;.\data\pcb_defects_kaggle\Annotations\Spur\05_spur_02;0.3669418238993711;0.5104359925788498;77;61;2544;2156;0.030267295597484277;0.02829313543599258;.\data\pcb_defects_kaggle\images/Spur/05_spur_02.jpg;5
2083;spur;1563;862;1642;923;.\data\pcb_defects_kaggle\Annotations\Spur\05_spur_02;0.6299135220125787;0.413961038961039;79;61;2544;2156;0.031053459119496855;0.02829313543599258;.\data\pcb_defects_kaggle\images/Spur/05_spur_02.jpg;5
2084;spur;2272;1520;2342;1581;.\data\pcb_defects_kaggle\Annotations\Spur\05_spur_02;0.9068396226415094;0.7191558441558441;70;61;2544;2156;0.027515723270440252;0.02829313543599258;.\data\pcb_defects_kaggle\images/Spur/05_spur_02.jpg;5
2085;spur;1542;670;1628;715;.\data\pcb_defects_kaggle\Annotations\Spur\05_spur_03;0.6230345911949685;0.3211966604823748;86;45;2544;2156;0.03380503144654088;0.020871985157699443;.\data\pcb_defects_kaggle\images/Spur/05_spur_03.jpg;5
2086;spur;1905;1362;1964;1403;.\data\pcb_defects_kaggle\Annotations\Spur\05_spur_03;0.7604166666666666;0.6412337662337663;59;41;2544;2156;0.023191823899371068;0.019016697588126158;.\data\pcb_defects_kaggle\images/Spur/05_spur_03.jpg;5
2087;spur;784;1073;845;1125;.\data\pcb_defects_kaggle\Annotations\Spur\05_spur_03;0.32016509433962265;0.5097402597402597;61;52;2544;2156;0.02397798742138365;0.02411873840445269;.\data\pcb_defects_kaggle\images/Spur/05_spur_03.jpg;5
2088;spur;792;329;856;371;.\data\pcb_defects_kaggle\Annotations\Spur\05_spur_03;0.3238993710691824;0.16233766233766234;64;42;2544;2156;0.025157232704402517;0.01948051948051948;.\data\pcb_defects_kaggle\images/Spur/05_spur_03.jpg;5
2089;spur;1394;596;1436;690;.\data\pcb_defects_kaggle\Annotations\Spur\05_spur_03;0.5562106918238994;0.2982374768089054;42;94;2544;2156;0.01650943396226415;0.04359925788497217;.\data\pcb_defects_kaggle\images/Spur/05_spur_03.jpg;5
2090;spur;1850;1328;1945;1384;.\data\pcb_defects_kaggle\Annotations\Spur\05_spur_04;0.745872641509434;0.6289424860853432;95;56;2544;2156;0.03734276729559748;0.025974025974025976;.\data\pcb_defects_kaggle\images/Spur/05_spur_04.jpg;5
2091;spur;1752;1712;1852;1763;.\data\pcb_defects_kaggle\Annotations\Spur\05_spur_04;0.7083333333333334;0.8058905380333952;100;51;2544;2156;0.03930817610062893;0.02365491651205937;.\data\pcb_defects_kaggle\images/Spur/05_spur_04.jpg;5
2092;spur;453;740;574;815;.\data\pcb_defects_kaggle\Annotations\Spur\05_spur_04;0.20184748427672955;0.36062152133580705;121;75;2544;2156;0.04756289308176101;0.034786641929499075;.\data\pcb_defects_kaggle\images/Spur/05_spur_04.jpg;5
2093;spur;1564;1092;1655;1178;.\data\pcb_defects_kaggle\Annotations\Spur\05_spur_04;0.6326650943396226;0.5264378478664193;91;86;2544;2156;0.035770440251572326;0.039888682745825604;.\data\pcb_defects_kaggle\images/Spur/05_spur_04.jpg;5
2094;spur;1883;765;1964;818;.\data\pcb_defects_kaggle\Annotations\Spur\05_spur_04;0.7560927672955975;0.36711502782931354;81;53;2544;2156;0.031839622641509434;0.02458256029684601;.\data\pcb_defects_kaggle\images/Spur/05_spur_04.jpg;5
2095;spur;1544;667;1644;717;.\data\pcb_defects_kaggle\Annotations\Spur\05_spur_05;0.6265723270440252;0.3209647495361781;100;50;2544;2156;0.03930817610062893;0.023191094619666047;.\data\pcb_defects_kaggle\images/Spur/05_spur_05.jpg;5
2096;spur;1520;926;1625;971;.\data\pcb_defects_kaggle\Annotations\Spur\05_spur_05;0.61812106918239;0.43993506493506496;105;45;2544;2156;0.041273584905660375;0.020871985157699443;.\data\pcb_defects_kaggle\images/Spur/05_spur_05.jpg;5
2097;spur;610;910;756;979;.\data\pcb_defects_kaggle\Annotations\Spur\05_spur_05;0.2684748427672956;0.43807977736549164;146;69;2544;2156;0.05738993710691824;0.03200371057513915;.\data\pcb_defects_kaggle\images/Spur/05_spur_05.jpg;5
2098;spur;661;1310;745;1370;.\data\pcb_defects_kaggle\Annotations\Spur\05_spur_05;0.2763364779874214;0.62152133580705;84;60;2544;2156;0.0330188679245283;0.027829313543599257;.\data\pcb_defects_kaggle\images/Spur/05_spur_05.jpg;5
2099;spur;1967;407;2075;465;.\data\pcb_defects_kaggle\Annotations\Spur\05_spur_05;0.7944182389937107;0.20222634508348794;108;58;2544;2156;0.04245283018867924;0.026901669758812616;.\data\pcb_defects_kaggle\images/Spur/05_spur_05.jpg;5
2100;spur;695;803;802;860;.\data\pcb_defects_kaggle\Annotations\Spur\05_spur_06;0.29422169811320753;0.3856679035250464;107;57;2544;2156;0.042059748427672954;0.026437847866419294;.\data\pcb_defects_kaggle\images/Spur/05_spur_06.jpg;5
2101;spur;372;1295;466;1345;.\data\pcb_defects_kaggle\Annotations\Spur\05_spur_06;0.16470125786163523;0.6122448979591837;94;50;2544;2156;0.036949685534591194;0.023191094619666047;.\data\pcb_defects_kaggle\images/Spur/05_spur_06.jpg;5
2102;spur;1744;1334;1819;1390;.\data\pcb_defects_kaggle\Annotations\Spur\05_spur_06;0.7002751572327044;0.6317254174397031;75;56;2544;2156;0.0294811320754717;0.025974025974025976;.\data\pcb_defects_kaggle\images/Spur/05_spur_06.jpg;5
2103;spur;1413;320;1508;374;.\data\pcb_defects_kaggle\Annotations\Spur\05_spur_06;0.5740959119496856;0.16094619666048238;95;54;2544;2156;0.03734276729559748;0.02504638218923933;.\data\pcb_defects_kaggle\images/Spur/05_spur_06.jpg;5
2104;spur;1527;1098;1611;1173;.\data\pcb_defects_kaggle\Annotations\Spur\05_spur_06;0.6167452830188679;0.5266697588126159;84;75;2544;2156;0.0330188679245283;0.034786641929499075;.\data\pcb_defects_kaggle\images/Spur/05_spur_06.jpg;5
2105;spur;1828;1334;1906;1387;.\data\pcb_defects_kaggle\Annotations\Spur\05_spur_07;0.7338836477987422;0.6310296846011132;78;53;2544;2156;0.030660377358490566;0.02458256029684601;.\data\pcb_defects_kaggle\images/Spur/05_spur_07.jpg;5
2106;spur;374;329;470;379;.\data\pcb_defects_kaggle\Annotations\Spur\05_spur_07;0.16588050314465408;0.16419294990723562;96;50;2544;2156;0.03773584905660377;0.023191094619666047;.\data\pcb_defects_kaggle\images/Spur/05_spur_07.jpg;5
2107;spur;1991;418;2067;467;.\data\pcb_defects_kaggle\Annotations\Spur\05_spur_07;0.797562893081761;0.20524118738404454;76;49;2544;2156;0.029874213836477988;0.022727272727272728;.\data\pcb_defects_kaggle\images/Spur/05_spur_07.jpg;5
2108;spur;1224;1746;1305;1799;.\data\pcb_defects_kaggle\Annotations\Spur\05_spur_07;0.4970518867924528;0.8221243042671614;81;53;2544;2156;0.031839622641509434;0.02458256029684601;.\data\pcb_defects_kaggle\images/Spur/05_spur_07.jpg;5
2109;spur;1872;756;1966;820;.\data\pcb_defects_kaggle\Annotations\Spur\05_spur_07;0.7543238993710691;0.3654916512059369;94;64;2544;2156;0.036949685534591194;0.029684601113172542;.\data\pcb_defects_kaggle\images/Spur/05_spur_07.jpg;5
2110;spur;1542;638;1625;696;.\data\pcb_defects_kaggle\Annotations\Spur\05_spur_08;0.6224449685534591;0.30936920222634506;83;58;2544;2156;0.03262578616352201;0.026901669758812616;.\data\pcb_defects_kaggle\images/Spur/05_spur_08.jpg;5
2111;spur;661;634;767;699;.\data\pcb_defects_kaggle\Annotations\Spur\05_spur_08;0.2806603773584906;0.30913729128014844;106;65;2544;2156;0.041666666666666664;0.030148423005565864;.\data\pcb_defects_kaggle\images/Spur/05_spur_08.jpg;5
2112;spur;570;1304;661;1368;.\data\pcb_defects_kaggle\Annotations\Spur\05_spur_08;0.24194182389937108;0.6196660482374768;91;64;2544;2156;0.035770440251572326;0.029684601113172542;.\data\pcb_defects_kaggle\images/Spur/05_spur_08.jpg;5
2113;spur;1924;1362;2017;1417;.\data\pcb_defects_kaggle\Annotations\Spur\05_spur_08;0.7745676100628931;0.6444805194805194;93;55;2544;2156;0.036556603773584904;0.025510204081632654;.\data\pcb_defects_kaggle\images/Spur/05_spur_08.jpg;5
2114;spur;478;331;560;379;.\data\pcb_defects_kaggle\Annotations\Spur\05_spur_08;0.20400943396226415;0.16465677179962895;82;48;2544;2156;0.03223270440251572;0.022263450834879406;.\data\pcb_defects_kaggle\images/Spur/05_spur_08.jpg;5
2115;spur;1563;787;1633;840;.\data\pcb_defects_kaggle\Annotations\Spur\05_spur_09;0.6281446540880503;0.3773191094619666;70;53;2544;2156;0.027515723270440252;0.02458256029684601;.\data\pcb_defects_kaggle\images/Spur/05_spur_09.jpg;5
2116;spur;791;856;895;924;.\data\pcb_defects_kaggle\Annotations\Spur\05_spur_09;0.3313679245283019;0.41280148423005564;104;68;2544;2156;0.040880503144654086;0.03153988868274583;.\data\pcb_defects_kaggle\images/Spur/05_spur_09.jpg;5
2117;spur;617;606;727;678;.\data\pcb_defects_kaggle\Annotations\Spur\05_spur_09;0.2641509433962264;0.29777365491651203;110;72;2544;2156;0.04323899371069182;0.03339517625231911;.\data\pcb_defects_kaggle\images/Spur/05_spur_09.jpg;5
2118;spur;2016;1470;2080;1512;.\data\pcb_defects_kaggle\Annotations\Spur\05_spur_09;0.8050314465408805;0.6915584415584416;64;42;2544;2156;0.025157232704402517;0.01948051948051948;.\data\pcb_defects_kaggle\images/Spur/05_spur_09.jpg;5
2119;spur;1277;1470;1331;1556;.\data\pcb_defects_kaggle\Annotations\Spur\05_spur_09;0.5125786163522013;0.7017625231910947;54;86;2544;2156;0.02122641509433962;0.039888682745825604;.\data\pcb_defects_kaggle\images/Spur/05_spur_09.jpg;5
2120;spur;567;742;656;813;.\data\pcb_defects_kaggle\Annotations\Spur\05_spur_10;0.24036949685534592;0.36062152133580705;89;71;2544;2156;0.03498427672955975;0.03293135435992579;.\data\pcb_defects_kaggle\images/Spur/05_spur_10.jpg;5
2121;spur;705;326;781;385;.\data\pcb_defects_kaggle\Annotations\Spur\05_spur_10;0.29205974842767296;0.1648886827458256;76;59;2544;2156;0.029874213836477988;0.02736549165120594;.\data\pcb_defects_kaggle\images/Spur/05_spur_10.jpg;5
2122;spur;1986;412;2067;463;.\data\pcb_defects_kaggle\Annotations\Spur\05_spur_10;0.7965801886792453;0.20292207792207792;81;51;2544;2156;0.031839622641509434;0.02365491651205937;.\data\pcb_defects_kaggle\images/Spur/05_spur_10.jpg;5
2123;spur;1547;729;1628;785;.\data\pcb_defects_kaggle\Annotations\Spur\05_spur_10;0.6240172955974843;0.35111317254174396;81;56;2544;2156;0.031839622641509434;0.025974025974025976;.\data\pcb_defects_kaggle\images/Spur/05_spur_10.jpg;5
2124;spur;1577;1110;1669;1190;.\data\pcb_defects_kaggle\Annotations\Spur\05_spur_10;0.6379716981132075;0.5333951762523191;92;80;2544;2156;0.036163522012578615;0.03710575139146568;.\data\pcb_defects_kaggle\images/Spur/05_spur_10.jpg;5
2125;spur;452;953;576;1015;.\data\pcb_defects_kaggle\Annotations\Spur\06_spur_01;0.1792189679218968;0.42487046632124353;124;62;2868;2316;0.043235704323570434;0.02677029360967185;.\data\pcb_defects_kaggle\images/Spur/06_spur_01.jpg;5
2126;spur;1840;878;1874;944;.\data\pcb_defects_kaggle\Annotations\Spur\06_spur_01;0.647489539748954;0.39335060449050085;34;66;2868;2316;0.011854951185495118;0.02849740932642487;.\data\pcb_defects_kaggle\images/Spur/06_spur_01.jpg;5
2127;spur;964;1270;1006;1356;.\data\pcb_defects_kaggle\Annotations\Spur\06_spur_01;0.34344490934449096;0.5669257340241797;42;86;2868;2316;0.014644351464435146;0.037132987910189985;.\data\pcb_defects_kaggle\images/Spur/06_spur_01.jpg;5
2128;spur;2052;1392;2101;1476;.\data\pcb_defects_kaggle\Annotations\Spur\06_spur_01;0.724023709902371;0.6191709844559585;49;84;2868;2316;0.01708507670850767;0.03626943005181347;.\data\pcb_defects_kaggle\images/Spur/06_spur_01.jpg;5
2129;spur;1304;1888;1385;1912;.\data\pcb_defects_kaggle\Annotations\Spur\06_spur_01;0.4687935843793584;0.8203799654576857;81;24;2868;2316;0.028242677824267783;0.010362694300518135;.\data\pcb_defects_kaggle\images/Spur/06_spur_01.jpg;5
2130;spur;1401;654;1437;722;.\data\pcb_defects_kaggle\Annotations\Spur\06_spur_02;0.49476987447698745;0.2970639032815199;36;68;2868;2316;0.012552301255230125;0.02936096718480138;.\data\pcb_defects_kaggle\images/Spur/06_spur_02.jpg;5
2131;spur;437;953;540;1000;.\data\pcb_defects_kaggle\Annotations\Spur\06_spur_02;0.17032775453277546;0.4216321243523316;103;47;2868;2316;0.035913528591352856;0.020293609671848015;.\data\pcb_defects_kaggle\images/Spur/06_spur_02.jpg;5
2132;spur;445;1532;480;1608;.\data\pcb_defects_kaggle\Annotations\Spur\06_spur_02;0.16126220362622037;0.6778929188255614;35;76;2868;2316;0.012203626220362623;0.03281519861830743;.\data\pcb_defects_kaggle\images/Spur/06_spur_02.jpg;5
2133;spur;2088;947;2132;1032;.\data\pcb_defects_kaggle\Annotations\Spur\06_spur_02;0.7357043235704324;0.4272452504317789;44;85;2868;2316;0.015341701534170154;0.03670120898100173;.\data\pcb_defects_kaggle\images/Spur/06_spur_02.jpg;5
2134;spur;996;2146;1121;2209;.\data\pcb_defects_kaggle\Annotations\Spur\06_spur_02;0.36907252440725247;0.9401986183074266;125;63;2868;2316;0.04358437935843794;0.027202072538860103;.\data\pcb_defects_kaggle\images/Spur/06_spur_02.jpg;5
2135;spur;1860;2086;1991;2159;.\data\pcb_defects_kaggle\Annotations\Spur\06_spur_03;0.671373779637378;0.9164507772020726;131;73;2868;2316;0.04567642956764296;0.03151986183074266;.\data\pcb_defects_kaggle\images/Spur/06_spur_03.jpg;5
2136;spur;2077;649;2140;747;.\data\pcb_defects_kaggle\Annotations\Spur\06_spur_03;0.7351813110181311;0.3013816925734024;63;98;2868;2316;0.021966527196652718;0.04231433506044905;.\data\pcb_defects_kaggle\images/Spur/06_spur_03.jpg;5
2137;spur;391;905;489;968;.\data\pcb_defects_kaggle\Annotations\Spur\06_spur_03;0.15341701534170155;0.40436096718480136;98;63;2868;2316;0.03417015341701534;0.027202072538860103;.\data\pcb_defects_kaggle\images/Spur/06_spur_03.jpg;5
2138;spur;1008;1280;1047;1370;.\data\pcb_defects_kaggle\Annotations\Spur\06_spur_03;0.35826359832635984;0.5721070811744386;39;90;2868;2316;0.013598326359832637;0.038860103626943004;.\data\pcb_defects_kaggle\images/Spur/06_spur_03.jpg;5
2139;spur;1608;1519;1691;1570;.\data\pcb_defects_kaggle\Annotations\Spur\06_spur_03;0.575139470013947;0.6668825561312608;83;51;2868;2316;0.02894002789400279;0.022020725388601035;.\data\pcb_defects_kaggle\images/Spur/06_spur_03.jpg;5
2140;spur;1132;902;1232;944;.\data\pcb_defects_kaggle\Annotations\Spur\06_spur_04;0.4121338912133891;0.39853195164075994;100;42;2868;2316;0.03486750348675035;0.018134715025906734;.\data\pcb_defects_kaggle\images/Spur/06_spur_04.jpg;5
2141;spur;1840;1359;1876;1436;.\data\pcb_defects_kaggle\Annotations\Spur\06_spur_04;0.6478382147838215;0.6034110535405872;36;77;2868;2316;0.012552301255230125;0.033246977547495685;.\data\pcb_defects_kaggle\images/Spur/06_spur_04.jpg;5
2142;spur;1633;2086;1749;2142;.\data\pcb_defects_kaggle\Annotations\Spur\06_spur_04;0.5896094839609484;0.9127806563039723;116;56;2868;2316;0.040446304044630406;0.024179620034542316;.\data\pcb_defects_kaggle\images/Spur/06_spur_04.jpg;5
2143;spur;1640;1883;1728;1922;.\data\pcb_defects_kaggle\Annotations\Spur\06_spur_04;0.5871687587168759;0.8214594127806563;88;39;2868;2316;0.030683403068340307;0.01683937823834197;.\data\pcb_defects_kaggle\images/Spur/06_spur_04.jpg;5
2144;spur;1281;431;1382;476;.\data\pcb_defects_kaggle\Annotations\Spur\06_spur_05;0.4642608089260809;0.19581174438687393;101;45;2868;2316;0.035216178521617854;0.019430051813471502;.\data\pcb_defects_kaggle\images/Spur/06_spur_05.jpg;5
2145;spur;1750;1683;1855;1729;.\data\pcb_defects_kaggle\Annotations\Spur\06_spur_05;0.6284867503486751;0.7366148531951641;105;46;2868;2316;0.036610878661087864;0.019861830742659757;.\data\pcb_defects_kaggle\images/Spur/06_spur_05.jpg;5
2146;spur;952;2156;1076;2205;.\data\pcb_defects_kaggle\Annotations\Spur\06_spur_05;0.35355648535564854;0.9414939550949913;124;49;2868;2316;0.043235704323570434;0.021157167530224525;.\data\pcb_defects_kaggle\images/Spur/06_spur_05.jpg;5
2147;spur;1133;907;1228;944;.\data\pcb_defects_kaggle\Annotations\Spur\06_spur_05;0.41161087866108786;0.39961139896373055;95;37;2868;2316;0.033124128312412834;0.015975820379965457;.\data\pcb_defects_kaggle\images/Spur/06_spur_05.jpg;5
2148;spur;152;1178;194;1258;.\data\pcb_defects_kaggle\Annotations\Spur\06_spur_05;0.0603207810320781;0.5259067357512953;42;80;2868;2316;0.014644351464435146;0.03454231433506045;.\data\pcb_defects_kaggle\images/Spur/06_spur_05.jpg;5
2149;spur;2043;824;2091;946;.\data\pcb_defects_kaggle\Annotations\Spur\06_spur_06;0.7207112970711297;0.38212435233160624;48;122;2868;2316;0.016736401673640166;0.05267702936096719;.\data\pcb_defects_kaggle\images/Spur/06_spur_06.jpg;5
2150;spur;1237;386;1332;431;.\data\pcb_defects_kaggle\Annotations\Spur\06_spur_06;0.4478730822873082;0.17638169257340242;95;45;2868;2316;0.033124128312412834;0.019430051813471502;.\data\pcb_defects_kaggle\images/Spur/06_spur_06.jpg;5
2151;spur;1018;434;1116;480;.\data\pcb_defects_kaggle\Annotations\Spur\06_spur_06;0.37203626220362623;0.1973229706390328;98;46;2868;2316;0.03417015341701534;0.019861830742659757;.\data\pcb_defects_kaggle\images/Spur/06_spur_06.jpg;5
2152;spur;943;1285;984;1376;.\data\pcb_defects_kaggle\Annotations\Spur\06_spur_06;0.3359483960948396;0.5744818652849741;41;91;2868;2316;0.014295676429567642;0.03929188255613126;.\data\pcb_defects_kaggle\images/Spur/06_spur_06.jpg;5
2153;spur;299;714;394;756;.\data\pcb_defects_kaggle\Annotations\Spur\06_spur_06;0.12081589958158996;0.3173575129533679;95;42;2868;2316;0.033124128312412834;0.018134715025906734;.\data\pcb_defects_kaggle\images/Spur/06_spur_06.jpg;5
2154;spur;2087;1037;2131;1142;.\data\pcb_defects_kaggle\Annotations\Spur\06_spur_07;0.7353556485355649;0.4704231433506045;44;105;2868;2316;0.015341701534170154;0.04533678756476684;.\data\pcb_defects_kaggle\images/Spur/06_spur_07.jpg;5
2155;spur;1432;402;1535;456;.\data\pcb_defects_kaggle\Annotations\Spur\06_spur_07;0.5172594142259415;0.18523316062176165;103;54;2868;2316;0.035913528591352856;0.023316062176165803;.\data\pcb_defects_kaggle\images/Spur/06_spur_07.jpg;5
2156;spur;982;483;1042;559;.\data\pcb_defects_kaggle\Annotations\Spur\06_spur_07;0.3528591352859135;0.22495682210708118;60;76;2868;2316;0.02092050209205021;0.03281519861830743;.\data\pcb_defects_kaggle\images/Spur/06_spur_07.jpg;5
2157;spur;1267;1651;1310;1732;.\data\pcb_defects_kaggle\Annotations\Spur\06_spur_07;0.44926778242677823;0.7303540587219344;43;81;2868;2316;0.01499302649930265;0.034974093264248704;.\data\pcb_defects_kaggle\images/Spur/06_spur_07.jpg;5
2158;spur;1345;1197;1408;1235;.\data\pcb_defects_kaggle\Annotations\Spur\06_spur_07;0.47995118549511856;0.5250431778929189;63;38;2868;2316;0.021966527196652718;0.016407599309153715;.\data\pcb_defects_kaggle\images/Spur/06_spur_07.jpg;5
2159;spur;1304;1673;1355;1744;.\data\pcb_defects_kaggle\Annotations\Spur\06_spur_08;0.46356345885634587;0.7376943005181347;51;71;2868;2316;0.01778242677824268;0.03065630397236615;.\data\pcb_defects_kaggle\images/Spur/06_spur_08.jpg;5
2160;spur;1018;1276;1054;1378;.\data\pcb_defects_kaggle\Annotations\Spur\06_spur_08;0.3612273361227336;0.5729706390328152;36;102;2868;2316;0.012552301255230125;0.04404145077720207;.\data\pcb_defects_kaggle\images/Spur/06_spur_08.jpg;5
2161;spur;2474;1364;2540;1419;.\data\pcb_defects_kaggle\Annotations\Spur\06_spur_08;0.8741283124128313;0.6008203799654577;66;55;2868;2316;0.02301255230125523;0.023747841105354058;.\data\pcb_defects_kaggle\images/Spur/06_spur_08.jpg;5
2162;spur;2537;1837;2593;1942;.\data\pcb_defects_kaggle\Annotations\Spur\06_spur_08;0.8943514644351465;0.815846286701209;56;105;2868;2316;0.019525801952580194;0.04533678756476684;.\data\pcb_defects_kaggle\images/Spur/06_spur_08.jpg;5
2163;spur;1643;2051;1777;2112;.\data\pcb_defects_kaggle\Annotations\Spur\06_spur_08;0.5962343096234309;0.8987478411053541;134;61;2868;2316;0.046722454672245464;0.026338514680483593;.\data\pcb_defects_kaggle\images/Spur/06_spur_08.jpg;5
2164;spur;1833;1347;1874;1449;.\data\pcb_defects_kaggle\Annotations\Spur\06_spur_09;0.6462691771269177;0.6036269430051814;41;102;2868;2316;0.014295676429567642;0.04404145077720207;.\data\pcb_defects_kaggle\images/Spur/06_spur_09.jpg;5
2165;spur;1860;1690;1943;1724;.\data\pcb_defects_kaggle\Annotations\Spur\06_spur_09;0.6630055788005579;0.7370466321243523;83;34;2868;2316;0.02894002789400279;0.01468048359240069;.\data\pcb_defects_kaggle\images/Spur/06_spur_09.jpg;5
2166;spur;1318;409;1433;456;.\data\pcb_defects_kaggle\Annotations\Spur\06_spur_09;0.47960251046025104;0.18674438687392056;115;47;2868;2316;0.0400976290097629;0.020293609671848015;.\data\pcb_defects_kaggle\images/Spur/06_spur_09.jpg;5
2167;spur;2076;670;2132;773;.\data\pcb_defects_kaggle\Annotations\Spur\06_spur_09;0.7336122733612274;0.3115284974093264;56;103;2868;2316;0.019525801952580194;0.04447322970639033;.\data\pcb_defects_kaggle\images/Spur/06_spur_09.jpg;5
2168;spur;2064;307;2115;397;.\data\pcb_defects_kaggle\Annotations\Spur\06_spur_09;0.7285564853556485;0.15198618307426598;51;90;2868;2316;0.01778242677824268;0.038860103626943004;.\data\pcb_defects_kaggle\images/Spur/06_spur_09.jpg;5
2169;spur;2494;1829;2537;1959;.\data\pcb_defects_kaggle\Annotations\Spur\06_spur_10;0.877092050209205;0.8177892918825561;43;130;2868;2316;0.01499302649930265;0.05613126079447323;.\data\pcb_defects_kaggle\images/Spur/06_spur_10.jpg;5
2170;spur;1147;656;1232;707;.\data\pcb_defects_kaggle\Annotations\Spur\06_spur_10;0.4147489539748954;0.29425734024179623;85;51;2868;2316;0.029637377963737797;0.022020725388601035;.\data\pcb_defects_kaggle\images/Spur/06_spur_10.jpg;5
2171;spur;676;892;737;1002;.\data\pcb_defects_kaggle\Annotations\Spur\06_spur_10;0.24633891213389122;0.40889464594127806;61;110;2868;2316;0.021269177126917713;0.047495682210708115;.\data\pcb_defects_kaggle\images/Spur/06_spur_10.jpg;5
2172;spur;788;1515;904;1559;.\data\pcb_defects_kaggle\Annotations\Spur\06_spur_10;0.29497907949790797;0.6636442141623489;116;44;2868;2316;0.040446304044630406;0.018998272884283247;.\data\pcb_defects_kaggle\images/Spur/06_spur_10.jpg;5
2173;spur;1493;654;1543;732;.\data\pcb_defects_kaggle\Annotations\Spur\06_spur_10;0.5292887029288703;0.29922279792746115;50;78;2868;2316;0.017433751743375175;0.03367875647668394;.\data\pcb_defects_kaggle\images/Spur/06_spur_10.jpg;5
2174;spur;2129;822;2227;894;.\data\pcb_defects_kaggle\Annotations\Spur\07_spur_01;0.75;0.4466423737636648;98;72;2904;1921;0.0337465564738292;0.03748047891723061;.\data\pcb_defects_kaggle\images/Spur/07_spur_01.jpg;5
2175;spur;1765;824;1837;898;.\data\pcb_defects_kaggle\Annotations\Spur\07_spur_01;0.6201790633608816;0.44820406038521604;72;74;2904;1921;0.024793388429752067;0.038521603331598125;.\data\pcb_defects_kaggle\images/Spur/07_spur_01.jpg;5
2176;spur;1227;858;1322;901;.\data\pcb_defects_kaggle\Annotations\Spur\07_spur_01;0.4388774104683196;0.45783446121811555;95;43;2904;1921;0.03271349862258953;0.022384174908901613;.\data\pcb_defects_kaggle\images/Spur/07_spur_01.jpg;5
2177;spur;961;222;1063;282;.\data\pcb_defects_kaggle\Annotations\Spur\07_spur_01;0.3484848484848485;0.13118167621030713;102;60;2904;1921;0.03512396694214876;0.031233732431025507;.\data\pcb_defects_kaggle\images/Spur/07_spur_01.jpg;5
2178;spur;1649;1307;1751;1351;.\data\pcb_defects_kaggle\Annotations\Spur\07_spur_01;0.5853994490358126;0.691827173347215;102;44;2904;1921;0.03512396694214876;0.022904737116085372;.\data\pcb_defects_kaggle\images/Spur/07_spur_01.jpg;5
2179;spur;1560;853;1618;943;.\data\pcb_defects_kaggle\Annotations\Spur\07_spur_02;0.5471763085399449;0.4674648620510151;58;90;2904;1921;0.01997245179063361;0.04685059864653826;.\data\pcb_defects_kaggle\images/Spur/07_spur_02.jpg;5
2180;spur;2079;870;2158;920;.\data\pcb_defects_kaggle\Annotations\Spur\07_spur_02;0.7295110192837465;0.4659031754294638;79;50;2904;1921;0.027203856749311296;0.026028110359187923;.\data\pcb_defects_kaggle\images/Spur/07_spur_02.jpg;5
2181;spur;1849;1301;1968;1351;.\data\pcb_defects_kaggle\Annotations\Spur\07_spur_02;0.6571969696969697;0.6902654867256637;119;50;2904;1921;0.040977961432506885;0.026028110359187923;.\data\pcb_defects_kaggle\images/Spur/07_spur_02.jpg;5
2182;spur;792;944;834;1029;.\data\pcb_defects_kaggle\Annotations\Spur\07_spur_02;0.2799586776859504;0.5135346173867777;42;85;2904;1921;0.014462809917355372;0.04424778761061947;.\data\pcb_defects_kaggle\images/Spur/07_spur_02.jpg;5
2183;spur;1320;834;1446;888;.\data\pcb_defects_kaggle\Annotations\Spur\07_spur_02;0.4762396694214876;0.44820406038521604;126;54;2904;1921;0.04338842975206612;0.028110359187922956;.\data\pcb_defects_kaggle\images/Spur/07_spur_02.jpg;5
2184;spur;1587;634;1718;696;.\data\pcb_defects_kaggle\Annotations\Spur\07_spur_03;0.5690426997245179;0.3461738677771994;131;62;2904;1921;0.04511019283746556;0.032274856845393024;.\data\pcb_defects_kaggle\images/Spur/07_spur_03.jpg;5
2185;spur;934;1113;1050;1177;.\data\pcb_defects_kaggle\Annotations\Spur\07_spur_03;0.3415977961432507;0.5960437272254034;116;64;2904;1921;0.03994490358126722;0.03331598125976054;.\data\pcb_defects_kaggle\images/Spur/07_spur_03.jpg;5
2186;spur;2055;644;2108;715;.\data\pcb_defects_kaggle\Annotations\Spur\07_spur_03;0.7167699724517906;0.35372201978136386;53;71;2904;1921;0.01825068870523416;0.03695991671004685;.\data\pcb_defects_kaggle\images/Spur/07_spur_03.jpg;5
2187;spur;1473;882;1529;963;.\data\pcb_defects_kaggle\Annotations\Spur\07_spur_03;0.5168732782369146;0.48021863612701715;56;81;2904;1921;0.01928374655647383;0.042165538781884435;.\data\pcb_defects_kaggle\images/Spur/07_spur_03.jpg;5
2188;spur;1775;810;1836;908;.\data\pcb_defects_kaggle\Annotations\Spur\07_spur_03;0.621728650137741;0.4471629359708485;61;98;2904;1921;0.02100550964187328;0.05101509630400833;.\data\pcb_defects_kaggle\images/Spur/07_spur_03.jpg;5
2189;spur;1529;627;1610;693;.\data\pcb_defects_kaggle\Annotations\Spur\07_spur_04;0.540461432506887;0.3435710567412806;81;66;2904;1921;0.027892561983471075;0.03435710567412806;.\data\pcb_defects_kaggle\images/Spur/07_spur_04.jpg;5
2190;spur;1472;881;1549;960;.\data\pcb_defects_kaggle\Annotations\Spur\07_spur_04;0.5201446280991735;0.47917751171264966;77;79;2904;1921;0.026515151515151516;0.04112441436751692;.\data\pcb_defects_kaggle\images/Spur/07_spur_04.jpg;5
2191;spur;1056;912;1158;963;.\data\pcb_defects_kaggle\Annotations\Spur\07_spur_04;0.381198347107438;0.48802706923477357;102;51;2904;1921;0.03512396694214876;0.02654867256637168;.\data\pcb_defects_kaggle\images/Spur/07_spur_04.jpg;5
2192;spur;784;922;848;1003;.\data\pcb_defects_kaggle\Annotations\Spur\07_spur_04;0.2809917355371901;0.5010411244143675;64;81;2904;1921;0.02203856749311295;0.042165538781884435;.\data\pcb_defects_kaggle\images/Spur/07_spur_04.jpg;5
2193;spur;2144;815;2253;863;.\data\pcb_defects_kaggle\Annotations\Spur\07_spur_04;0.7570592286501377;0.4367516918271733;109;48;2904;1921;0.03753443526170799;0.024986985944820406;.\data\pcb_defects_kaggle\images/Spur/07_spur_04.jpg;5
2194;spur;1755;631;1875;696;.\data\pcb_defects_kaggle\Annotations\Spur\07_spur_05;0.625;0.3453930244664237;120;65;2904;1921;0.04132231404958678;0.0338365434669443;.\data\pcb_defects_kaggle\images/Spur/07_spur_05.jpg;5
2195;spur;1632;870;1692;962;.\data\pcb_defects_kaggle\Annotations\Spur\07_spur_05;0.5723140495867769;0.47683498178032274;60;92;2904;1921;0.02066115702479339;0.04789172306090578;.\data\pcb_defects_kaggle\images/Spur/07_spur_05.jpg;5
2196;spur;1958;539;2020;607;.\data\pcb_defects_kaggle\Annotations\Spur\07_spur_05;0.6849173553719008;0.2982821447162936;62;68;2904;1921;0.02134986225895317;0.035398230088495575;.\data\pcb_defects_kaggle\images/Spur/07_spur_05.jpg;5
2197;spur;2558;660;2611;767;.\data\pcb_defects_kaggle\Annotations\Spur\07_spur_05;0.8899793388429752;0.3714211348256117;53;107;2904;1921;0.01825068870523416;0.055700156168662154;.\data\pcb_defects_kaggle\images/Spur/07_spur_05.jpg;5
2198;spur;2111;834;2199;886;.\data\pcb_defects_kaggle\Annotations\Spur\07_spur_05;0.7420798898071626;0.44768349817803227;88;52;2904;1921;0.030303030303030304;0.02706923477355544;.\data\pcb_defects_kaggle\images/Spur/07_spur_05.jpg;5
2199;spur;1773;826;1836;913;.\data\pcb_defects_kaggle\Annotations\Spur\07_spur_06;0.6213842975206612;0.452628839146278;63;87;2904;1921;0.02169421487603306;0.045288912024986985;.\data\pcb_defects_kaggle\images/Spur/07_spur_06.jpg;5
2200;spur;1491;891;1553;953;.\data\pcb_defects_kaggle\Annotations\Spur\07_spur_06;0.5241046831955923;0.4799583550234253;62;62;2904;1921;0.02134986225895317;0.032274856845393024;.\data\pcb_defects_kaggle\images/Spur/07_spur_06.jpg;5
2201;spur;1082;903;1184;962;.\data\pcb_defects_kaggle\Annotations\Spur\07_spur_06;0.39015151515151514;0.48542425819885476;102;59;2904;1921;0.03512396694214876;0.03071317022384175;.\data\pcb_defects_kaggle\images/Spur/07_spur_06.jpg;5
2202;spur;2094;870;2163;920;.\data\pcb_defects_kaggle\Annotations\Spur\07_spur_06;0.7329545454545454;0.4659031754294638;69;50;2904;1921;0.023760330578512397;0.026028110359187923;.\data\pcb_defects_kaggle\images/Spur/07_spur_06.jpg;5
2203;spur;701;427;817;486;.\data\pcb_defects_kaggle\Annotations\Spur\07_spur_06;0.26136363636363635;0.23763664757938574;116;59;2904;1921;0.03994490358126722;0.03071317022384175;.\data\pcb_defects_kaggle\images/Spur/07_spur_06.jpg;5
2204;spur;1518;636;1599;686;.\data\pcb_defects_kaggle\Annotations\Spur\07_spur_07;0.5366735537190083;0.34409161894846435;81;50;2904;1921;0.027892561983471075;0.026028110359187923;.\data\pcb_defects_kaggle\images/Spur/07_spur_07.jpg;5
2205;spur;1942;572;2018;639;.\data\pcb_defects_kaggle\Annotations\Spur\07_spur_07;0.6818181818181818;0.31520041644976576;76;67;2904;1921;0.026170798898071626;0.034877667881311816;.\data\pcb_defects_kaggle\images/Spur/07_spur_07.jpg;5
2206;spur;1494;884;1555;941;.\data\pcb_defects_kaggle\Annotations\Spur\07_spur_07;0.524965564738292;0.4750130140551796;61;57;2904;1921;0.02100550964187328;0.029672045809474232;.\data\pcb_defects_kaggle\images/Spur/07_spur_07.jpg;5
2207;spur;1025;1122;1120;1172;.\data\pcb_defects_kaggle\Annotations\Spur\07_spur_07;0.3693181818181818;0.597084851639771;95;50;2904;1921;0.03271349862258953;0.026028110359187923;.\data\pcb_defects_kaggle\images/Spur/07_spur_07.jpg;5
2208;spur;711;962;777;1065;.\data\pcb_defects_kaggle\Annotations\Spur\07_spur_07;0.256198347107438;0.5275897969807392;66;103;2904;1921;0.022727272727272728;0.05361790733992712;.\data\pcb_defects_kaggle\images/Spur/07_spur_07.jpg;5
2209;spur;1561;876;1617;939;.\data\pcb_defects_kaggle\Annotations\Spur\07_spur_08;0.5471763085399449;0.4724102030192608;56;63;2904;1921;0.01928374655647383;0.03279541905257678;.\data\pcb_defects_kaggle\images/Spur/07_spur_08.jpg;5
2210;spur;1710;874;1770;977;.\data\pcb_defects_kaggle\Annotations\Spur\07_spur_08;0.5991735537190083;0.48178032274856847;60;103;2904;1921;0.02066115702479339;0.05361790733992712;.\data\pcb_defects_kaggle\images/Spur/07_spur_08.jpg;5
2211;spur;1982;691;2049;789;.\data\pcb_defects_kaggle\Annotations\Spur\07_spur_08;0.6940426997245179;0.38521603331598125;67;98;2904;1921;0.023071625344352618;0.05101509630400833;.\data\pcb_defects_kaggle\images/Spur/07_spur_08.jpg;5
2212;spur;960;962;1037;1020;.\data\pcb_defects_kaggle\Annotations\Spur\07_spur_08;0.34383608815426997;0.5158771473191046;77;58;2904;1921;0.026515151515151516;0.03019260801665799;.\data\pcb_defects_kaggle\images/Spur/07_spur_08.jpg;5
2213;spur;979;208;1063;282;.\data\pcb_defects_kaggle\Annotations\Spur\07_spur_08;0.3515840220385675;0.12753774076002083;84;74;2904;1921;0.028925619834710745;0.038521603331598125;.\data\pcb_defects_kaggle\images/Spur/07_spur_08.jpg;5
2214;spur;703;989;755;1100;.\data\pcb_defects_kaggle\Annotations\Spur\07_spur_09;0.2510330578512397;0.5437272254034358;52;111;2904;1921;0.01790633608815427;0.05778240499739719;.\data\pcb_defects_kaggle\images/Spur/07_spur_09.jpg;5
2215;spur;467;808;565;894;.\data\pcb_defects_kaggle\Annotations\Spur\07_spur_09;0.17768595041322313;0.44299843831337843;98;86;2904;1921;0.0337465564738292;0.04476834981780323;.\data\pcb_defects_kaggle\images/Spur/07_spur_09.jpg;5
2216;spur;2098;596;2177;658;.\data\pcb_defects_kaggle\Annotations\Spur\07_spur_09;0.7360537190082644;0.32639250390421654;79;62;2904;1921;0.027203856749311296;0.032274856845393024;.\data\pcb_defects_kaggle\images/Spur/07_spur_09.jpg;5
2217;spur;2534;919;2605;1060;.\data\pcb_defects_kaggle\Annotations\Spur\07_spur_09;0.8848140495867769;0.515096304008329;71;141;2904;1921;0.024449035812672177;0.07339927121290994;.\data\pcb_defects_kaggle\images/Spur/07_spur_09.jpg;5
2218;spur;1475;1641;1613;1696;.\data\pcb_defects_kaggle\Annotations\Spur\07_spur_09;0.5316804407713499;0.868558042686101;138;55;2904;1921;0.047520661157024795;0.028630921395106715;.\data\pcb_defects_kaggle\images/Spur/07_spur_09.jpg;5
2219;spur;1553;867;1622;939;.\data\pcb_defects_kaggle\Annotations\Spur\07_spur_10;0.5466597796143251;0.47006767308693387;69;72;2904;1921;0.023760330578512397;0.03748047891723061;.\data\pcb_defects_kaggle\images/Spur/07_spur_10.jpg;5
2220;spur;1665;629;1765;696;.\data\pcb_defects_kaggle\Annotations\Spur\07_spur_10;0.5905647382920111;0.34487246225923995;100;67;2904;1921;0.03443526170798898;0.034877667881311816;.\data\pcb_defects_kaggle\images/Spur/07_spur_10.jpg;5
2221;spur;2542;1143;2599;1243;.\data\pcb_defects_kaggle\Annotations\Spur\07_spur_10;0.8851584022038568;0.6210307131702238;57;100;2904;1921;0.01962809917355372;0.052056220718375845;.\data\pcb_defects_kaggle\images/Spur/07_spur_10.jpg;5
2222;spur;1160;1291;1273;1353;.\data\pcb_defects_kaggle\Annotations\Spur\07_spur_10;0.41890495867768596;0.6881832378969287;113;62;2904;1921;0.038911845730027546;0.032274856845393024;.\data\pcb_defects_kaggle\images/Spur/07_spur_10.jpg;5
2223;spur;1092;558;1146;663;.\data\pcb_defects_kaggle\Annotations\Spur\07_spur_10;0.3853305785123967;0.3178032274856845;54;105;2904;1921;0.01859504132231405;0.05465903175429464;.\data\pcb_defects_kaggle\images/Spur/07_spur_10.jpg;5
2224;spur;1563;1152;1623;1228;.\data\pcb_defects_kaggle\Annotations\Spur\08_spur_01;0.5773831098223994;0.552460538532962;60;76;2759;2154;0.021747009786154403;0.035283194057567316;.\data\pcb_defects_kaggle\images/Spur/08_spur_01.jpg;5
2225;spur;961;1231;1033;1277;.\data\pcb_defects_kaggle\Annotations\Spur\08_spur_01;0.3613628126132657;0.5821727019498607;72;46;2759;2154;0.026096411743385284;0.02135561745589601;.\data\pcb_defects_kaggle\images/Spur/08_spur_01.jpg;5
2226;spur;604;1933;687;1982;.\data\pcb_defects_kaggle\Annotations\Spur\08_spur_01;0.23396158028271113;0.908774373259053;83;49;2759;2154;0.03008336353751359;0.02274837511606314;.\data\pcb_defects_kaggle\images/Spur/08_spur_01.jpg;5
2227;spur;2378;1293;2414;1390;.\data\pcb_defects_kaggle\Annotations\Spur\08_spur_01;0.8684305907937658;0.622794800371402;36;97;2759;2154;0.013048205871692642;0.04503249767873723;.\data\pcb_defects_kaggle\images/Spur/08_spur_01.jpg;5
2228;spur;2079;705;2119;805;.\data\pcb_defects_kaggle\Annotations\Spur\08_spur_01;0.7607828923523016;0.35051067780872797;40;100;2759;2154;0.014498006524102935;0.04642525533890436;.\data\pcb_defects_kaggle\images/Spur/08_spur_01.jpg;5
2229;spur;876;1234;976;1279;.\data\pcb_defects_kaggle\Annotations\Spur\08_spur_02;0.33562885103298296;0.5833333333333334;100;45;2759;2154;0.03624501631025734;0.020891364902506964;.\data\pcb_defects_kaggle\images/Spur/08_spur_02.jpg;5
2230;spur;2255;1039;2307;1151;.\data\pcb_defects_kaggle\Annotations\Spur\08_spur_02;0.8267488220369699;0.5083565459610028;52;112;2759;2154;0.018847408481333816;0.051996285979572884;.\data\pcb_defects_kaggle\images/Spur/08_spur_02.jpg;5
2231;spur;1604;898;1664;998;.\data\pcb_defects_kaggle\Annotations\Spur\08_spur_02;0.592243566509605;0.4401114206128134;60;100;2759;2154;0.021747009786154403;0.04642525533890436;.\data\pcb_defects_kaggle\images/Spur/08_spur_02.jpg;5
2232;spur;1387;1803;1527;1859;.\data\pcb_defects_kaggle\Annotations\Spur\08_spur_02;0.5280898876404494;0.8500464252553389;140;56;2759;2154;0.050743022834360274;0.025998142989786442;.\data\pcb_defects_kaggle\images/Spur/08_spur_02.jpg;5
2233;spur;430;1405;512;1474;.\data\pcb_defects_kaggle\Annotations\Spur\08_spur_02;0.17071402682131206;0.6682915506035283;82;69;2759;2154;0.029720913374411018;0.03203342618384401;.\data\pcb_defects_kaggle\images/Spur/08_spur_02.jpg;5
2234;spur;2022;721;2081;834;.\data\pcb_defects_kaggle\Annotations\Spur\08_spur_03;0.7435665096049293;0.36095636025998146;59;113;2759;2154;0.02138455962305183;0.05246053853296193;.\data\pcb_defects_kaggle\images/Spur/08_spur_03.jpg;5
2235;spur;800;1205;925;1256;.\data\pcb_defects_kaggle\Annotations\Spur\08_spur_03;0.31261326567596953;0.5712627669452182;125;51;2759;2154;0.04530627038782167;0.023676880222841225;.\data\pcb_defects_kaggle\images/Spur/08_spur_03.jpg;5
2236;spur;2378;1295;2420;1398;.\data\pcb_defects_kaggle\Annotations\Spur\08_spur_03;0.8695179412830736;0.6251160631383472;42;103;2759;2154;0.015222906850308082;0.04781801299907149;.\data\pcb_defects_kaggle\images/Spur/08_spur_03.jpg;5
2237;spur;1682;905;1741;995;.\data\pcb_defects_kaggle\Annotations\Spur\08_spur_03;0.6203334541500544;0.44103992571959144;59;90;2759;2154;0.02138455962305183;0.04178272980501393;.\data\pcb_defects_kaggle\images/Spur/08_spur_03.jpg;5
2238;spur;692;892;745;972;.\data\pcb_defects_kaggle\Annotations\Spur\08_spur_03;0.26042044218919896;0.43268337975858867;53;80;2759;2154;0.01920985864443639;0.03714020427112349;.\data\pcb_defects_kaggle\images/Spur/08_spur_03.jpg;5
2239;spur;725;1231;843;1290;.\data\pcb_defects_kaggle\Annotations\Spur\08_spur_04;0.28416092787241753;0.5851903435468895;118;59;2759;2154;0.04276911924610366;0.027390900649953576;.\data\pcb_defects_kaggle\images/Spur/08_spur_04.jpg;5
2240;spur;823;1806;935;1852;.\data\pcb_defects_kaggle\Annotations\Spur\08_spur_04;0.31859369336716203;0.8491179201485608;112;46;2759;2154;0.04059441826748822;0.02135561745589601;.\data\pcb_defects_kaggle\images/Spur/08_spur_04.jpg;5
2241;spur;1955;1687;2055;1736;.\data\pcb_defects_kaggle\Annotations\Spur\08_spur_04;0.7267125770206596;0.7945682451253482;100;49;2759;2154;0.03624501631025734;0.02274837511606314;.\data\pcb_defects_kaggle\images/Spur/08_spur_04.jpg;5
2242;spur;2559;1584;2620;1692;.\data\pcb_defects_kaggle\Annotations\Spur\08_spur_04;0.9385646973541139;0.7604456824512534;61;108;2759;2154;0.022109459949256977;0.05013927576601671;.\data\pcb_defects_kaggle\images/Spur/08_spur_04.jpg;5
2243;spur;1353;1172;1412;1262;.\data\pcb_defects_kaggle\Annotations\Spur\08_spur_04;0.5010873504893077;0.5649953574744662;59;90;2759;2154;0.02138455962305183;0.04178272980501393;.\data\pcb_defects_kaggle\images/Spur/08_spur_04.jpg;5
2244;spur;1656;905;1730;984;.\data\pcb_defects_kaggle\Annotations\Spur\08_spur_05;0.6136281261326567;0.4384865366759517;74;79;2759;2154;0.02682131206959043;0.03667595171773445;.\data\pcb_defects_kaggle\images/Spur/08_spur_05.jpg;5
2245;spur;973;920;1032;1008;.\data\pcb_defects_kaggle\Annotations\Spur\08_spur_05;0.3633562885103298;0.44753946146703805;59;88;2759;2154;0.02138455962305183;0.04085422469823584;.\data\pcb_defects_kaggle\images/Spur/08_spur_05.jpg;5
2246;spur;1168;1271;1227;1366;.\data\pcb_defects_kaggle\Annotations\Spur\08_spur_05;0.43403407031533164;0.612116991643454;59;95;2759;2154;0.02138455962305183;0.04410399257195915;.\data\pcb_defects_kaggle\images/Spur/08_spur_05.jpg;5
2247;spur;2419;1356;2464;1447;.\data\pcb_defects_kaggle\Annotations\Spur\08_spur_05;0.884922073214933;0.6506499535747446;45;91;2759;2154;0.016310257339615802;0.04224698235840297;.\data\pcb_defects_kaggle\images/Spur/08_spur_05.jpg;5
2248;spur;2255;1041;2307;1129;.\data\pcb_defects_kaggle\Annotations\Spur\08_spur_05;0.8267488220369699;0.5037140204271123;52;88;2759;2154;0.018847408481333816;0.04085422469823584;.\data\pcb_defects_kaggle\images/Spur/08_spur_05.jpg;5
2249;spur;1709;1156;1774;1216;.\data\pcb_defects_kaggle\Annotations\Spur\08_spur_06;0.6312069590431316;0.5506035283194057;65;60;2759;2154;0.02355926060166727;0.027855153203342618;.\data\pcb_defects_kaggle\images/Spur/08_spur_06.jpg;5
2250;spur;632;897;689;980;.\data\pcb_defects_kaggle\Annotations\Spur\08_spur_06;0.23939833272924974;0.43570102135561745;57;83;2759;2154;0.020659659296846683;0.038532961931290625;.\data\pcb_defects_kaggle\images/Spur/08_spur_06.jpg;5
2251;spur;1702;1810;1812;1864;.\data\pcb_defects_kaggle\Annotations\Spur\08_spur_06;0.6368249365712214;0.8528319405756731;110;54;2759;2154;0.03986951794128307;0.025069637883008356;.\data\pcb_defects_kaggle\images/Spur/08_spur_06.jpg;5
2252;spur;440;1377;523;1441;.\data\pcb_defects_kaggle\Annotations\Spur\08_spur_06;0.1745197535338891;0.6541318477251625;83;64;2759;2154;0.03008336353751359;0.029712163416898793;.\data\pcb_defects_kaggle\images/Spur/08_spur_06.jpg;5
2253;spur;235;1729;289;1820;.\data\pcb_defects_kaggle\Annotations\Spur\08_spur_06;0.09496194273287423;0.8238161559888579;54;91;2759;2154;0.019572308807538963;0.04224698235840297;.\data\pcb_defects_kaggle\images/Spur/08_spur_06.jpg;5
2254;spur;2002;736;2061;826;.\data\pcb_defects_kaggle\Annotations\Spur\08_spur_07;0.7363175063428778;0.36258124419684307;59;90;2759;2154;0.02138455962305183;0.04178272980501393;.\data\pcb_defects_kaggle\images/Spur/08_spur_07.jpg;5
2255;spur;1663;906;1720;987;.\data\pcb_defects_kaggle\Annotations\Spur\08_spur_07;0.6130844508880029;0.43941504178272983;57;81;2759;2154;0.020659659296846683;0.037604456824512536;.\data\pcb_defects_kaggle\images/Spur/08_spur_07.jpg;5
2256;spur;894;906;959;1000;.\data\pcb_defects_kaggle\Annotations\Spur\08_spur_07;0.33581007611453423;0.4424326833797586;65;94;2759;2154;0.02355926060166727;0.0436397400185701;.\data\pcb_defects_kaggle\images/Spur/08_spur_07.jpg;5
2257;spur;1243;1306;1300;1403;.\data\pcb_defects_kaggle\Annotations\Spur\08_spur_07;0.4608553823849221;0.6288300835654597;57;97;2759;2154;0.020659659296846683;0.04503249767873723;.\data\pcb_defects_kaggle\images/Spur/08_spur_07.jpg;5
2258;spur;1773;1279;1885;1338;.\data\pcb_defects_kaggle\Annotations\Spur\08_spur_07;0.6629213483146067;0.6074744661095636;112;59;2759;2154;0.04059441826748822;0.027390900649953576;.\data\pcb_defects_kaggle\images/Spur/08_spur_07.jpg;5
2259;spur;766;1197;897;1262;.\data\pcb_defects_kaggle\Annotations\Spur\08_spur_08;0.3013773106197898;0.5707985143918292;131;65;2759;2154;0.047480971366437114;0.030176415970287838;.\data\pcb_defects_kaggle\images/Spur/08_spur_08.jpg;5
2260;spur;1437;1313;1525;1362;.\data\pcb_defects_kaggle\Annotations\Spur\08_spur_08;0.5367886915549112;0.6209377901578459;88;49;2759;2154;0.03189561435302646;0.02274837511606314;.\data\pcb_defects_kaggle\images/Spur/08_spur_08.jpg;5
2261;spur;2004;825;2050;888;.\data\pcb_defects_kaggle\Annotations\Spur\08_spur_08;0.7346864806089163;0.39763231197771587;46;63;2759;2154;0.016672707502718376;0.02924791086350975;.\data\pcb_defects_kaggle\images/Spur/08_spur_08.jpg;5
2262;spur;2256;1287;2304;1408;.\data\pcb_defects_kaggle\Annotations\Spur\08_spur_08;0.8263863718738673;0.6255803156917363;48;121;2759;2154;0.017397607828923523;0.05617455896007428;.\data\pcb_defects_kaggle\images/Spur/08_spur_08.jpg;5
2263;spur;2402;987;2458;1061;.\data\pcb_defects_kaggle\Annotations\Spur\08_spur_08;0.8807538963392534;0.4753946146703807;56;74;2759;2154;0.02029720913374411;0.034354688950789226;.\data\pcb_defects_kaggle\images/Spur/08_spur_08.jpg;5
2264;spur;1810;988;1917;1049;.\data\pcb_defects_kaggle\Annotations\Spur\08_spur_09;0.6754258789416455;0.47284122562674097;107;61;2759;2154;0.03878216745197535;0.028319405756731662;.\data\pcb_defects_kaggle\images/Spur/08_spur_09.jpg;5
2265;spur;1959;1687;2053;1739;.\data\pcb_defects_kaggle\Annotations\Spur\08_spur_09;0.7270750271837623;0.7952646239554317;94;52;2759;2154;0.0340703153316419;0.02414113277623027;.\data\pcb_defects_kaggle\images/Spur/08_spur_09.jpg;5
2266;spur;427;1662;530;1710;.\data\pcb_defects_kaggle\Annotations\Spur\08_spur_09;0.17343240304458138;0.7827298050139275;103;48;2759;2154;0.03733236679956506;0.022284122562674095;.\data\pcb_defects_kaggle\images/Spur/08_spur_09.jpg;5
2267;spur;264;1757;312;1851;.\data\pcb_defects_kaggle\Annotations\Spur\08_spur_09;0.10438564697354114;0.8375116063138347;48;94;2759;2154;0.017397607828923523;0.0436397400185701;.\data\pcb_defects_kaggle\images/Spur/08_spur_09.jpg;5
2268;spur;1868;595;1955;634;.\data\pcb_defects_kaggle\Annotations\Spur\08_spur_09;0.692823486770569;0.2852831940575673;87;39;2759;2154;0.031533164189923885;0.018105849582172703;.\data\pcb_defects_kaggle\images/Spur/08_spur_09.jpg;5
2269;spur;1561;1166;1610;1257;.\data\pcb_defects_kaggle\Annotations\Spur\08_spur_10;0.5746647335991302;0.5624419684308264;49;91;2759;2154;0.017760057992026096;0.04224698235840297;.\data\pcb_defects_kaggle\images/Spur/08_spur_10.jpg;5
2270;spur;1681;908;1722;988;.\data\pcb_defects_kaggle\Annotations\Spur\08_spur_10;0.6167089525190287;0.4401114206128134;41;80;2759;2154;0.014860456687205509;0.03714020427112349;.\data\pcb_defects_kaggle\images/Spur/08_spur_10.jpg;5
2271;spur;2389;1292;2428;1382;.\data\pcb_defects_kaggle\Annotations\Spur\08_spur_10;0.872961217832548;0.6207056638811513;39;90;2759;2154;0.014135556361000362;0.04178272980501393;.\data\pcb_defects_kaggle\images/Spur/08_spur_10.jpg;5
2272;spur;697;1241;789;1285;.\data\pcb_defects_kaggle\Annotations\Spur\08_spur_10;0.26930047118521205;0.5863509749303621;92;44;2759;2154;0.03334541500543675;0.02042711234911792;.\data\pcb_defects_kaggle\images/Spur/08_spur_10.jpg;5
2273;spur;2082;706;2119;787;.\data\pcb_defects_kaggle\Annotations\Spur\08_spur_10;0.7613265675969554;0.3465645311049211;37;81;2759;2154;0.013410656034795215;0.037604456824512536;.\data\pcb_defects_kaggle\images/Spur/08_spur_10.jpg;5
2274;spur;1100;894;1190;941;.\data\pcb_defects_kaggle\Annotations\Spur\09_spur_01;0.4126126126126126;0.42496526169522925;90;47;2775;2159;0.032432432432432434;0.02176933765632237;.\data\pcb_defects_kaggle\images/Spur/09_spur_01.jpg;5
2275;spur;1759;1186;1807;1264;.\data\pcb_defects_kaggle\Annotations\Spur\09_spur_01;0.6425225225225225;0.5673923112552107;48;78;2775;2159;0.017297297297297298;0.036127836961556276;.\data\pcb_defects_kaggle\images/Spur/09_spur_01.jpg;5
2276;spur;859;431;904;500;.\data\pcb_defects_kaggle\Annotations\Spur\09_spur_01;0.31765765765765763;0.2156090782769801;45;69;2775;2159;0.016216216216216217;0.03195924038906901;.\data\pcb_defects_kaggle\images/Spur/09_spur_01.jpg;5
2277;spur;1351;443;1402;517;.\data\pcb_defects_kaggle\Annotations\Spur\09_spur_01;0.496036036036036;0.222325150532654;51;74;2775;2159;0.018378378378378378;0.03427512737378416;.\data\pcb_defects_kaggle\images/Spur/09_spur_01.jpg;5
2278;spur;1523;1620;1623;1669;.\data\pcb_defects_kaggle\Annotations\Spur\09_spur_01;0.5668468468468468;0.7616952292728115;100;49;2775;2159;0.036036036036036036;0.02269569245020843;.\data\pcb_defects_kaggle\images/Spur/09_spur_01.jpg;5
2279;spur;1984;1095;2041;1186;.\data\pcb_defects_kaggle\Annotations\Spur\09_spur_02;0.7252252252252253;0.5282538212135248;57;91;2775;2159;0.02054054054054054;0.042149143121815655;.\data\pcb_defects_kaggle\images/Spur/09_spur_02.jpg;5
2280;spur;1022;895;1105;941;.\data\pcb_defects_kaggle\Annotations\Spur\09_spur_02;0.38324324324324327;0.4251968503937008;83;46;2775;2159;0.02990990990990991;0.021306160259379342;.\data\pcb_defects_kaggle\images/Spur/09_spur_02.jpg;5
2281;spur;1541;428;1590;507;.\data\pcb_defects_kaggle\Annotations\Spur\09_spur_02;0.5641441441441442;0.21653543307086615;49;79;2775;2159;0.017657657657657658;0.036591014358499305;.\data\pcb_defects_kaggle\images/Spur/09_spur_02.jpg;5
2282;spur;1300;1492;1382;1546;.\data\pcb_defects_kaggle\Annotations\Spur\09_spur_02;0.48324324324324325;0.7035664659564613;82;54;2775;2159;0.02954954954954955;0.025011579434923575;.\data\pcb_defects_kaggle\images/Spur/09_spur_02.jpg;5
2283;spur;1066;1112;1110;1164;.\data\pcb_defects_kaggle\Annotations\Spur\09_spur_02;0.39207207207207206;0.5270958777211672;44;52;2775;2159;0.015855855855855857;0.024085224641037517;.\data\pcb_defects_kaggle\images/Spur/09_spur_02.jpg;5
2284;spur;1202;812;1294;868;.\data\pcb_defects_kaggle\Annotations\Spur\09_spur_03;0.44972972972972974;0.3890690134321445;92;56;2775;2159;0.033153153153153155;0.025937934228809634;.\data\pcb_defects_kaggle\images/Spur/09_spur_03.jpg;5
2285;spur;1892;1222;1933;1305;.\data\pcb_defects_kaggle\Annotations\Spur\09_spur_03;0.6891891891891891;0.5852246410375174;41;83;2775;2159;0.014774774774774775;0.03844372394627142;.\data\pcb_defects_kaggle\images/Spur/09_spur_03.jpg;5
2286;spur;772;420;818;499;.\data\pcb_defects_kaggle\Annotations\Spur\09_spur_03;0.2864864864864865;0.2128300138953219;46;79;2775;2159;0.016576576576576577;0.036591014358499305;.\data\pcb_defects_kaggle\images/Spur/09_spur_03.jpg;5
2287;spur;2038;176;2084;256;.\data\pcb_defects_kaggle\Annotations\Spur\09_spur_03;0.7427027027027027;0.1000463177396943;46;80;2775;2159;0.016576576576576577;0.037054191755442334;.\data\pcb_defects_kaggle\images/Spur/09_spur_03.jpg;5
2288;spur;2202;1031;2251;1100;.\data\pcb_defects_kaggle\Annotations\Spur\09_spur_03;0.8023423423423424;0.49351551644279756;49;69;2775;2159;0.017657657657657658;0.03195924038906901;.\data\pcb_defects_kaggle\images/Spur/09_spur_03.jpg;5
2289;spur;2110;963;2208;1012;.\data\pcb_defects_kaggle\Annotations\Spur\09_spur_04;0.7780180180180181;0.4573876794812413;98;49;2775;2159;0.035315315315315315;0.02269569245020843;.\data\pcb_defects_kaggle\images/Spur/09_spur_04.jpg;5
2290;spur;1545;474;1587;551;.\data\pcb_defects_kaggle\Annotations\Spur\09_spur_04;0.5643243243243243;0.23737841593330244;42;77;2775;2159;0.015135135135135135;0.035664659564613246;.\data\pcb_defects_kaggle\images/Spur/09_spur_04.jpg;5
2291;spur;723;425;764;504;.\data\pcb_defects_kaggle\Annotations\Spur\09_spur_04;0.2679279279279279;0.21514590088003704;41;79;2775;2159;0.014774774774774775;0.036591014358499305;.\data\pcb_defects_kaggle\images/Spur/09_spur_04.jpg;5
2292;spur;854;1115;900;1177;.\data\pcb_defects_kaggle\Annotations\Spur\09_spur_04;0.316036036036036;0.5308012968967114;46;62;2775;2159;0.016576576576576577;0.02871699861046781;.\data\pcb_defects_kaggle\images/Spur/09_spur_04.jpg;5
2293;spur;530;810;589;905;.\data\pcb_defects_kaggle\Annotations\Spur\09_spur_04;0.20162162162162162;0.3971746178786475;59;95;2775;2159;0.021261261261261263;0.04400185270958777;.\data\pcb_defects_kaggle\images/Spur/09_spur_04.jpg;5
2294;spur;1125;712;1167;789;.\data\pcb_defects_kaggle\Annotations\Spur\09_spur_05;0.412972972972973;0.3476146364057434;42;77;2775;2159;0.015135135135135135;0.035664659564613246;.\data\pcb_defects_kaggle\images/Spur/09_spur_05.jpg;5
2295;spur;1840;1200;1882;1276;.\data\pcb_defects_kaggle\Annotations\Spur\09_spur_05;0.6706306306306307;0.5734136174154701;42;76;2775;2159;0.015135135135135135;0.03520148216767022;.\data\pcb_defects_kaggle\images/Spur/09_spur_05.jpg;5
2296;spur;1943;1131;1986;1228;.\data\pcb_defects_kaggle\Annotations\Spur\09_spur_05;0.7079279279279279;0.546317739694303;43;97;2775;2159;0.015495495495495495;0.04492820750347383;.\data\pcb_defects_kaggle\images/Spur/09_spur_05.jpg;5
2297;spur;1140;433;1190;507;.\data\pcb_defects_kaggle\Annotations\Spur\09_spur_05;0.4198198198198198;0.2176933765632237;50;74;2775;2159;0.018018018018018018;0.03427512737378416;.\data\pcb_defects_kaggle\images/Spur/09_spur_05.jpg;5
2298;spur;1061;1112;1102;1177;.\data\pcb_defects_kaggle\Annotations\Spur\09_spur_05;0.38972972972972975;0.5301065308012969;41;65;2775;2159;0.014774774774774775;0.030106530801296896;.\data\pcb_defects_kaggle\images/Spur/09_spur_05.jpg;5
2299;spur;999;536;1071;597;.\data\pcb_defects_kaggle\Annotations\Spur\09_spur_06;0.372972972972973;0.26238999536822605;72;61;2775;2159;0.025945945945945945;0.02825382121352478;.\data\pcb_defects_kaggle\images/Spur/09_spur_06.jpg;5
2300;spur;1643;1113;1708;1156;.\data\pcb_defects_kaggle\Annotations\Spur\09_spur_06;0.6037837837837838;0.5254747568318666;65;43;2775;2159;0.023423423423423424;0.019916628068550254;.\data\pcb_defects_kaggle\images/Spur/09_spur_06.jpg;5
2301;spur;1831;1176;1881;1268;.\data\pcb_defects_kaggle\Annotations\Spur\09_spur_06;0.6688288288288289;0.5660027790643817;50;92;2775;2159;0.018018018018018018;0.042612320518758684;.\data\pcb_defects_kaggle\images/Spur/09_spur_06.jpg;5
2302;spur;1310;1497;1392;1540;.\data\pcb_defects_kaggle\Annotations\Spur\09_spur_06;0.48684684684684687;0.7033348772579898;82;43;2775;2159;0.02954954954954955;0.019916628068550254;.\data\pcb_defects_kaggle\images/Spur/09_spur_06.jpg;5
2303;spur;340;1666;438;1722;.\data\pcb_defects_kaggle\Annotations\Spur\09_spur_06;0.1401801801801802;0.7846225104214914;98;56;2775;2159;0.035315315315315315;0.025937934228809634;.\data\pcb_defects_kaggle\images/Spur/09_spur_06.jpg;5
2304;spur;1523;912;1630;969;.\data\pcb_defects_kaggle\Annotations\Spur\09_spur_07;0.5681081081081081;0.43561834182491893;107;57;2775;2159;0.03855855855855856;0.026401111625752663;.\data\pcb_defects_kaggle\images/Spur/09_spur_07.jpg;5
2305;spur;1986;1051;2048;1136;.\data\pcb_defects_kaggle\Annotations\Spur\09_spur_07;0.7268468468468469;0.5064844835572024;62;85;2775;2159;0.022342342342342343;0.03937007874015748;.\data\pcb_defects_kaggle\images/Spur/09_spur_07.jpg;5
2306;spur;1259;427;1305;502;.\data\pcb_defects_kaggle\Annotations\Spur\09_spur_07;0.461981981981982;0.21514590088003704;46;75;2775;2159;0.016576576576576577;0.03473830477072719;.\data\pcb_defects_kaggle\images/Spur/09_spur_07.jpg;5
2307;spur;2174;1390;2249;1440;.\data\pcb_defects_kaggle\Annotations\Spur\09_spur_07;0.7969369369369369;0.6553960166743863;75;50;2775;2159;0.02702702702702703;0.02315886984715146;.\data\pcb_defects_kaggle\images/Spur/09_spur_07.jpg;5
2308;spur;520;764;600;849;.\data\pcb_defects_kaggle\Annotations\Spur\09_spur_07;0.2018018018018018;0.37355257063455305;80;85;2775;2159;0.02882882882882883;0.03937007874015748;.\data\pcb_defects_kaggle\images/Spur/09_spur_07.jpg;5
2309;spur;1404;913;1486;966;.\data\pcb_defects_kaggle\Annotations\Spur\09_spur_08;0.5207207207207207;0.4351551644279759;82;53;2775;2159;0.02954954954954955;0.024548402037980546;.\data\pcb_defects_kaggle\images/Spur/09_spur_08.jpg;5
2310;spur;1182;859;1259;920;.\data\pcb_defects_kaggle\Annotations\Spur\09_spur_08;0.4398198198198198;0.41199629458082443;77;61;2775;2159;0.02774774774774775;0.02825382121352478;.\data\pcb_defects_kaggle\images/Spur/09_spur_08.jpg;5
2311;spur;628;543;725;615;.\data\pcb_defects_kaggle\Annotations\Spur\09_spur_08;0.2437837837837838;0.2681797128300139;97;72;2775;2159;0.03495495495495495;0.0333487725798981;.\data\pcb_defects_kaggle\images/Spur/09_spur_08.jpg;5
2312;spur;854;1112;904;1181;.\data\pcb_defects_kaggle\Annotations\Spur\09_spur_08;0.31675675675675674;0.5310328855951829;50;69;2775;2159;0.018018018018018018;0.03195924038906901;.\data\pcb_defects_kaggle\images/Spur/09_spur_08.jpg;5
2313;spur;2540;774;2630;851;.\data\pcb_defects_kaggle\Annotations\Spur\09_spur_08;0.9315315315315316;0.3763316350162112;90;77;2775;2159;0.032432432432432434;0.035664659564613246;.\data\pcb_defects_kaggle\images/Spur/09_spur_08.jpg;5
2314;spur;913;887;1017;948;.\data\pcb_defects_kaggle\Annotations\Spur\09_spur_09;0.34774774774774775;0.42496526169522925;104;61;2775;2159;0.037477477477477476;0.02825382121352478;.\data\pcb_defects_kaggle\images/Spur/09_spur_09.jpg;5
2315;spur;1810;1163;1874;1248;.\data\pcb_defects_kaggle\Annotations\Spur\09_spur_09;0.6637837837837838;0.5583603520148217;64;85;2775;2159;0.023063063063063063;0.03937007874015748;.\data\pcb_defects_kaggle\images/Spur/09_spur_09.jpg;5
2316;spur;1994;1049;2041;1159;.\data\pcb_defects_kaggle\Annotations\Spur\09_spur_09;0.727027027027027;0.5113478462251042;47;110;2775;2159;0.016936936936936937;0.05094951366373321;.\data\pcb_defects_kaggle\images/Spur/09_spur_09.jpg;5
2317;spur;1541;1520;1645;1571;.\data\pcb_defects_kaggle\Annotations\Spur\09_spur_09;0.5740540540540541;0.7158406669754516;104;51;2775;2159;0.037477477477477476;0.023622047244094488;.\data\pcb_defects_kaggle\images/Spur/09_spur_09.jpg;5
2318;spur;359;1668;449;1713;.\data\pcb_defects_kaggle\Annotations\Spur\09_spur_09;0.1455855855855856;0.7830013895321908;90;45;2775;2159;0.032432432432432434;0.020842982862436313;.\data\pcb_defects_kaggle\images/Spur/09_spur_09.jpg;5
2319;spur;1615;451;1656;522;.\data\pcb_defects_kaggle\Annotations\Spur\09_spur_10;0.5893693693693693;0.22533580361278369;41;71;2775;2159;0.014774774774774775;0.03288559518295507;.\data\pcb_defects_kaggle\images/Spur/09_spur_10.jpg;5
2320;spur;1151;553;1228;620;.\data\pcb_defects_kaggle\Annotations\Spur\09_spur_10;0.42864864864864866;0.27165354330708663;77;67;2775;2159;0.02774774774774775;0.031032885595182955;.\data\pcb_defects_kaggle\images/Spur/09_spur_10.jpg;5
2321;spur;1258;947;1334;1024;.\data\pcb_defects_kaggle\Annotations\Spur\09_spur_10;0.46702702702702703;0.45646132468735523;76;77;2775;2159;0.02738738738738739;0.035664659564613246;.\data\pcb_defects_kaggle\images/Spur/09_spur_10.jpg;5
2322;spur;1813;1225;1872;1289;.\data\pcb_defects_kaggle\Annotations\Spur\09_spur_10;0.663963963963964;0.5822139879573877;59;64;2775;2159;0.021261261261261263;0.029643353404353867;.\data\pcb_defects_kaggle\images/Spur/09_spur_10.jpg;5
2323;spur;2276;481;2351;541;.\data\pcb_defects_kaggle\Annotations\Spur\09_spur_10;0.8336936936936937;0.23668364983788792;75;60;2775;2159;0.02702702702702703;0.02779064381658175;.\data\pcb_defects_kaggle\images/Spur/09_spur_10.jpg;5
2324;spur;1134;722;1236;812;.\data\pcb_defects_kaggle\Annotations\Spur\10_spur_01;0.5290178571428571;0.3804563492063492;102;90;2240;2016;0.045535714285714284;0.044642857142857144;.\data\pcb_defects_kaggle\images/Spur/10_spur_01.jpg;5
2325;spur;1419;311;1521;374;.\data\pcb_defects_kaggle\Annotations\Spur\10_spur_01;0.65625;0.16989087301587302;102;63;2240;2016;0.045535714285714284;0.03125;.\data\pcb_defects_kaggle\images/Spur/10_spur_01.jpg;5
2326;spur;1984;473;2049;571;.\data\pcb_defects_kaggle\Annotations\Spur\10_spur_01;0.9002232142857143;0.25892857142857145;65;98;2240;2016;0.029017857142857144;0.04861111111111111;.\data\pcb_defects_kaggle\images/Spur/10_spur_01.jpg;5
2327;spur;1050;1061;1117;1179;.\data\pcb_defects_kaggle\Annotations\Spur\10_spur_01;0.4837053571428571;0.5555555555555556;67;118;2240;2016;0.029910714285714287;0.05853174603174603;.\data\pcb_defects_kaggle\images/Spur/10_spur_01.jpg;5
2328;spur;1514;1258;1584;1377;.\data\pcb_defects_kaggle\Annotations\Spur\10_spur_01;0.6915178571428572;0.6535218253968254;70;119;2240;2016;0.03125;0.059027777777777776;.\data\pcb_defects_kaggle\images/Spur/10_spur_01.jpg;5
2329;spur;874;785;991;842;.\data\pcb_defects_kaggle\Annotations\Spur\10_spur_02;0.41629464285714285;0.4035218253968254;117;57;2240;2016;0.05223214285714286;0.028273809523809524;.\data\pcb_defects_kaggle\images/Spur/10_spur_02.jpg;5
2330;spur;1004;1076;1084;1174;.\data\pcb_defects_kaggle\Annotations\Spur\10_spur_02;0.4660714285714286;0.5580357142857143;80;98;2240;2016;0.03571428571428571;0.04861111111111111;.\data\pcb_defects_kaggle\images/Spur/10_spur_02.jpg;5
2331;spur;1721;577;1801;658;.\data\pcb_defects_kaggle\Annotations\Spur\10_spur_02;0.7861607142857143;0.3062996031746032;80;81;2240;2016;0.03571428571428571;0.04017857142857143;.\data\pcb_defects_kaggle\images/Spur/10_spur_02.jpg;5
2332;spur;1519;1299;1585;1392;.\data\pcb_defects_kaggle\Annotations\Spur\10_spur_02;0.6928571428571428;0.6674107142857143;66;93;2240;2016;0.029464285714285714;0.046130952380952384;.\data\pcb_defects_kaggle\images/Spur/10_spur_02.jpg;5
2333;spur;1159;405;1259;464;.\data\pcb_defects_kaggle\Annotations\Spur\10_spur_02;0.5397321428571429;0.21552579365079366;100;59;2240;2016;0.044642857142857144;0.029265873015873016;.\data\pcb_defects_kaggle\images/Spur/10_spur_02.jpg;5
2334;spur;1801;1674;1910;1721;.\data\pcb_defects_kaggle\Annotations\Spur\10_spur_03;0.8283482142857143;0.8420138888888888;109;47;2240;2016;0.048660714285714286;0.023313492063492064;.\data\pcb_defects_kaggle\images/Spur/10_spur_03.jpg;5
2335;spur;1195;1679;1284;1731;.\data\pcb_defects_kaggle\Annotations\Spur\10_spur_03;0.5533482142857142;0.845734126984127;89;52;2240;2016;0.039732142857142855;0.025793650793650792;.\data\pcb_defects_kaggle\images/Spur/10_spur_03.jpg;5
2336;spur;1514;932;1640;986;.\data\pcb_defects_kaggle\Annotations\Spur\10_spur_03;0.7040178571428571;0.4756944444444444;126;54;2240;2016;0.05625;0.026785714285714284;.\data\pcb_defects_kaggle\images/Spur/10_spur_03.jpg;5
2337;spur;1488;1295;1543;1425;.\data\pcb_defects_kaggle\Annotations\Spur\10_spur_03;0.6765625;0.6746031746031746;55;130;2240;2016;0.024553571428571428;0.06448412698412699;.\data\pcb_defects_kaggle\images/Spur/10_spur_03.jpg;5
2338;spur;1781;1199;1866;1279;.\data\pcb_defects_kaggle\Annotations\Spur\10_spur_03;0.8140625;0.6145833333333334;85;80;2240;2016;0.03794642857142857;0.03968253968253968;.\data\pcb_defects_kaggle\images/Spur/10_spur_03.jpg;5
2339;spur;1127;719;1236;809;.\data\pcb_defects_kaggle\Annotations\Spur\10_spur_04;0.5274553571428572;0.37896825396825395;109;90;2240;2016;0.048660714285714286;0.044642857142857144;.\data\pcb_defects_kaggle\images/Spur/10_spur_04.jpg;5
2340;spur;1042;1035;1123;1150;.\data\pcb_defects_kaggle\Annotations\Spur\10_spur_04;0.48325892857142855;0.5419146825396826;81;115;2240;2016;0.03616071428571429;0.05704365079365079;.\data\pcb_defects_kaggle\images/Spur/10_spur_04.jpg;5
2341;spur;1682;556;1787;644;.\data\pcb_defects_kaggle\Annotations\Spur\10_spur_04;0.7743303571428571;0.2976190476190476;105;88;2240;2016;0.046875;0.04365079365079365;.\data\pcb_defects_kaggle\images/Spur/10_spur_04.jpg;5
2342;spur;1517;1290;1585;1388;.\data\pcb_defects_kaggle\Annotations\Spur\10_spur_04;0.6924107142857143;0.6641865079365079;68;98;2240;2016;0.030357142857142857;0.04861111111111111;.\data\pcb_defects_kaggle\images/Spur/10_spur_04.jpg;5
2343;spur;977;1427;1042;1516;.\data\pcb_defects_kaggle\Annotations\Spur\10_spur_04;0.45066964285714284;0.7299107142857143;65;89;2240;2016;0.029017857142857144;0.0441468253968254;.\data\pcb_defects_kaggle\images/Spur/10_spur_04.jpg;5
2344;spur;1258;889;1334;999;.\data\pcb_defects_kaggle\Annotations\Spur\10_spur_05;0.5785714285714286;0.46825396825396826;76;110;2240;2016;0.033928571428571426;0.054563492063492064;.\data\pcb_defects_kaggle\images/Spur/10_spur_05.jpg;5
2345;spur;1826;1754;1977;1819;.\data\pcb_defects_kaggle\Annotations\Spur\10_spur_05;0.8488839285714286;0.8861607142857143;151;65;2240;2016;0.06741071428571428;0.032242063492063495;.\data\pcb_defects_kaggle\images/Spur/10_spur_05.jpg;5
2346;spur;977;429;1058;550;.\data\pcb_defects_kaggle\Annotations\Spur\10_spur_05;0.45424107142857145;0.24280753968253968;81;121;2240;2016;0.03616071428571429;0.06001984126984127;.\data\pcb_defects_kaggle\images/Spur/10_spur_05.jpg;5
2347;spur;1482;1276;1539;1376;.\data\pcb_defects_kaggle\Annotations\Spur\10_spur_05;0.6743303571428572;0.6577380952380952;57;100;2240;2016;0.02544642857142857;0.0496031746031746;.\data\pcb_defects_kaggle\images/Spur/10_spur_05.jpg;5
2348;spur;1666;587;1766;658;.\data\pcb_defects_kaggle\Annotations\Spur\10_spur_05;0.7660714285714286;0.3087797619047619;100;71;2240;2016;0.044642857142857144;0.03521825396825397;.\data\pcb_defects_kaggle\images/Spur/10_spur_05.jpg;5
2349;spur;1512;1014;1596;1131;.\data\pcb_defects_kaggle\Annotations\Spur\11_spur_01;0.6809815950920245;0.47709074733096085;84;117;2282;2248;0.03680981595092025;0.05204626334519573;.\data\pcb_defects_kaggle\images/Spur/11_spur_01.jpg;5
2350;spur;1439;1588;1502;1703;.\data\pcb_defects_kaggle\Annotations\Spur\11_spur_01;0.6443908851884312;0.7319839857651246;63;115;2282;2248;0.027607361963190184;0.05115658362989324;.\data\pcb_defects_kaggle\images/Spur/11_spur_01.jpg;5
2351;spur;925;1476;997;1578;.\data\pcb_defects_kaggle\Annotations\Spur\11_spur_01;0.42112182296231376;0.6792704626334519;72;102;2282;2248;0.03155127081507449;0.045373665480427046;.\data\pcb_defects_kaggle\images/Spur/11_spur_01.jpg;5
2352;spur;1073;678;1153;776;.\data\pcb_defects_kaggle\Annotations\Spur\11_spur_01;0.48773006134969327;0.3233985765124555;80;98;2282;2248;0.035056967572304996;0.04359430604982206;.\data\pcb_defects_kaggle\images/Spur/11_spur_01.jpg;5
2353;spur;768;345;839;426;.\data\pcb_defects_kaggle\Annotations\Spur\11_spur_01;0.3521034180543383;0.17148576512455516;71;81;2282;2248;0.031113058720420684;0.03603202846975089;.\data\pcb_defects_kaggle\images/Spur/11_spur_01.jpg;5
2354;spur;745;339;850;426;.\data\pcb_defects_kaggle\Annotations\Spur\11_spur_02;0.3494741454864154;0.1701512455516014;105;87;2282;2248;0.046012269938650305;0.03870106761565836;.\data\pcb_defects_kaggle\images/Spur/11_spur_02.jpg;5
2355;spur;1057;637;1152;745;.\data\pcb_defects_kaggle\Annotations\Spur\11_spur_02;0.4840052585451358;0.30738434163701067;95;108;2282;2248;0.04163014899211218;0.04804270462633452;.\data\pcb_defects_kaggle\images/Spur/11_spur_02.jpg;5
2356;spur;1491;1063;1563;1155;.\data\pcb_defects_kaggle\Annotations\Spur\11_spur_02;0.6691498685363716;0.4933274021352313;72;92;2282;2248;0.03155127081507449;0.04092526690391459;.\data\pcb_defects_kaggle\images/Spur/11_spur_02.jpg;5
2357;spur;1139;1419;1199;1527;.\data\pcb_defects_kaggle\Annotations\Spur\11_spur_02;0.5122699386503068;0.6552491103202847;60;108;2282;2248;0.026292725679228746;0.04804270462633452;.\data\pcb_defects_kaggle\images/Spur/11_spur_02.jpg;5
2358;spur;430;1299;480;1399;.\data\pcb_defects_kaggle\Annotations\Spur\11_spur_02;0.19938650306748465;0.6000889679715302;50;100;2282;2248;0.021910604732690624;0.04448398576512456;.\data\pcb_defects_kaggle\images/Spur/11_spur_02.jpg;5
2359;spur;766;593;889;678;.\data\pcb_defects_kaggle\Annotations\Spur\11_spur_03;0.3626205083260298;0.28269572953736655;123;85;2282;2248;0.05390008764241893;0.037811387900355875;.\data\pcb_defects_kaggle\images/Spur/11_spur_03.jpg;5
2360;spur;1204;1099;1316;1162;.\data\pcb_defects_kaggle\Annotations\Spur\11_spur_03;0.5521472392638037;0.5028914590747331;112;63;2282;2248;0.049079754601226995;0.02802491103202847;.\data\pcb_defects_kaggle\images/Spur/11_spur_03.jpg;5
2361;spur;1663;1622;1791;1686;.\data\pcb_defects_kaggle\Annotations\Spur\11_spur_03;0.7567922874671341;0.7357651245551602;128;64;2282;2248;0.056091148115687994;0.028469750889679714;.\data\pcb_defects_kaggle\images/Spur/11_spur_03.jpg;5
2362;spur;916;1480;984;1581;.\data\pcb_defects_kaggle\Annotations\Spur\11_spur_03;0.4163014899211218;0.6808274021352313;68;101;2282;2248;0.029798422436459245;0.0449288256227758;.\data\pcb_defects_kaggle\images/Spur/11_spur_03.jpg;5
2363;spur;678;1388;747;1485;.\data\pcb_defects_kaggle\Annotations\Spur\11_spur_03;0.3122261174408414;0.6390124555160143;69;97;2282;2248;0.030236634531113058;0.04314946619217082;.\data\pcb_defects_kaggle\images/Spur/11_spur_03.jpg;5
2364;spur;968;668;1065;745;.\data\pcb_defects_kaggle\Annotations\Spur\11_spur_04;0.44544259421560034;0.314279359430605;97;77;2282;2248;0.04250657318141981;0.03425266903914591;.\data\pcb_defects_kaggle\images/Spur/11_spur_04.jpg;5
2365;spur;1501;1070;1555;1173;.\data\pcb_defects_kaggle\Annotations\Spur\11_spur_04;0.6695880806310254;0.4988879003558719;54;103;2282;2248;0.02366345311130587;0.04581850533807829;.\data\pcb_defects_kaggle\images/Spur/11_spur_04.jpg;5
2366;spur;770;1162;880;1221;.\data\pcb_defects_kaggle\Annotations\Spur\11_spur_04;0.36152497808939527;0.5300266903914591;110;59;2282;2248;0.04820333041191937;0.026245551601423486;.\data\pcb_defects_kaggle\images/Spur/11_spur_04.jpg;5
2367;spur;552;837;665;916;.\data\pcb_defects_kaggle\Annotations\Spur\11_spur_04;0.26665205959684485;0.3899021352313167;113;79;2282;2248;0.04951796669588081;0.035142348754448396;.\data\pcb_defects_kaggle\images/Spur/11_spur_04.jpg;5
2368;spur;743;590;880;688;.\data\pcb_defects_kaggle\Annotations\Spur\11_spur_04;0.3556091148115688;0.2842526690391459;137;98;2282;2248;0.0600350569675723;0.04359430604982206;.\data\pcb_defects_kaggle\images/Spur/11_spur_04.jpg;5
2369;spur;1171;1093;1329;1158;.\data\pcb_defects_kaggle\Annotations\Spur\11_spur_05;0.5477651183172656;0.5006672597864769;158;65;2282;2248;0.06923751095530237;0.02891459074733096;.\data\pcb_defects_kaggle\images/Spur/11_spur_05.jpg;5
2370;spur;1129;1452;1196;1575;.\data\pcb_defects_kaggle\Annotations\Spur\11_spur_05;0.509421560035057;0.6732651245551602;67;123;2282;2248;0.029360210341805432;0.0547153024911032;.\data\pcb_defects_kaggle\images/Spur/11_spur_05.jpg;5
2371;spur;1317;1955;1435;2014;.\data\pcb_defects_kaggle\Annotations\Spur\11_spur_05;0.6029798422436459;0.8827846975088968;118;59;2282;2248;0.051709027169149865;0.026245551601423486;.\data\pcb_defects_kaggle\images/Spur/11_spur_05.jpg;5
2372;spur;742;847;855;919;.\data\pcb_defects_kaggle\Annotations\Spur\11_spur_05;0.34991235758106926;0.3927935943060498;113;72;2282;2248;0.04951796669588081;0.03202846975088968;.\data\pcb_defects_kaggle\images/Spur/11_spur_05.jpg;5
2373;spur;955;359;1014;423;.\data\pcb_defects_kaggle\Annotations\Spur\11_spur_05;0.43141980718667833;0.17393238434163702;59;64;2282;2248;0.025854513584574933;0.028469750889679714;.\data\pcb_defects_kaggle\images/Spur/11_spur_05.jpg;5
2374;spur;980;1050;1093;1116;.\data\pcb_defects_kaggle\Annotations\Spur\11_spur_06;0.4542068361086766;0.4817615658362989;113;66;2282;2248;0.04951796669588081;0.029359430604982206;.\data\pcb_defects_kaggle\images/Spur/11_spur_06.jpg;5
2375;spur;1160;1098;1274;1160;.\data\pcb_defects_kaggle\Annotations\Spur\11_spur_06;0.5333041191936897;0.5022241992882562;114;62;2282;2248;0.04995617879053462;0.027580071174377226;.\data\pcb_defects_kaggle\images/Spur/11_spur_06.jpg;5
2376;spur;589;1150;694;1232;.\data\pcb_defects_kaggle\Annotations\Spur\11_spur_06;0.2811130587204207;0.5298042704626335;105;82;2282;2248;0.046012269938650305;0.036476868327402136;.\data\pcb_defects_kaggle\images/Spur/11_spur_06.jpg;5
2377;spur;1129;1486;1211;1603;.\data\pcb_defects_kaggle\Annotations\Spur\11_spur_06;0.5127081507449606;0.6870551601423488;82;117;2282;2248;0.03593339176161262;0.05204626334519573;.\data\pcb_defects_kaggle\images/Spur/11_spur_06.jpg;5
2378;spur;837;129;943;198;.\data\pcb_defects_kaggle\Annotations\Spur\11_spur_06;0.39000876424189307;0.07273131672597864;106;69;2282;2248;0.04645048203330412;0.03069395017793594;.\data\pcb_defects_kaggle\images/Spur/11_spur_06.jpg;5
2379;spur;1081;619;1168;726;.\data\pcb_defects_kaggle\Annotations\Spur\11_spur_07;0.4927695004382121;0.29915480427046265;87;107;2282;2248;0.03812445223488168;0.04759786476868327;.\data\pcb_defects_kaggle\images/Spur/11_spur_07.jpg;5
2380;spur;1432;1576;1514;1694;.\data\pcb_defects_kaggle\Annotations\Spur\11_spur_07;0.6454864154250657;0.7273131672597865;82;118;2282;2248;0.03593339176161262;0.05249110320284697;.\data\pcb_defects_kaggle\images/Spur/11_spur_07.jpg;5
2381;spur;302;850;401;980;.\data\pcb_defects_kaggle\Annotations\Spur\11_spur_07;0.15403155127081508;0.4070284697508897;99;130;2282;2248;0.043382997370727434;0.05782918149466192;.\data\pcb_defects_kaggle\images/Spur/11_spur_07.jpg;5
2382;spur;768;2006;889;2080;.\data\pcb_defects_kaggle\Annotations\Spur\11_spur_07;0.3630587204206836;0.9088078291814946;121;74;2282;2248;0.053023663453111304;0.03291814946619217;.\data\pcb_defects_kaggle\images/Spur/11_spur_07.jpg;5
2383;spur;481;1114;599;1203;.\data\pcb_defects_kaggle\Annotations\Spur\11_spur_07;0.2366345311130587;0.515346975088968;118;89;2282;2248;0.051709027169149865;0.03959074733096085;.\data\pcb_defects_kaggle\images/Spur/11_spur_07.jpg;5
2384;spur;452;235;576;345;.\data\pcb_defects_kaggle\Annotations\Spur\11_spur_08;0.2252410166520596;0.1290035587188612;124;110;2282;2248;0.05433829973707274;0.04893238434163701;.\data\pcb_defects_kaggle\images/Spur/11_spur_08.jpg;5
2385;spur;307;581;409;701;.\data\pcb_defects_kaggle\Annotations\Spur\11_spur_08;0.15687992988606486;0.2851423487544484;102;120;2282;2248;0.044697633654688866;0.05338078291814947;.\data\pcb_defects_kaggle\images/Spur/11_spur_08.jpg;5
2386;spur;1680;1611;1802;1690;.\data\pcb_defects_kaggle\Annotations\Spur\11_spur_08;0.7629272567922875;0.7342081850533808;122;79;2282;2248;0.05346187554776512;0.035142348754448396;.\data\pcb_defects_kaggle\images/Spur/11_spur_08.jpg;5
2387;spur;1181;837;1281;908;.\data\pcb_defects_kaggle\Annotations\Spur\11_spur_08;0.5394390885188431;0.38812277580071175;100;71;2282;2248;0.04382120946538125;0.03158362989323844;.\data\pcb_defects_kaggle\images/Spur/11_spur_08.jpg;5
2388;spur;1275;332;1412;425;.\data\pcb_defects_kaggle\Annotations\Spur\11_spur_08;0.588737949167397;0.16837188612099643;137;93;2282;2248;0.0600350569675723;0.041370106761565835;.\data\pcb_defects_kaggle\images/Spur/11_spur_08.jpg;5
2389;spur;1057;642;1124;757;.\data\pcb_defects_kaggle\Annotations\Spur\11_spur_09;0.4778702892199825;0.3111654804270463;67;115;2282;2248;0.029360210341805432;0.05115658362989324;.\data\pcb_defects_kaggle\images/Spur/11_spur_09.jpg;5
2390;spur;1035;375;1148;467;.\data\pcb_defects_kaggle\Annotations\Spur\11_spur_09;0.47830850131463626;0.18727758007117437;113;92;2282;2248;0.04951796669588081;0.04092526690391459;.\data\pcb_defects_kaggle\images/Spur/11_spur_09.jpg;5
2391;spur;1053;1152;1193;1201;.\data\pcb_defects_kaggle\Annotations\Spur\11_spur_09;0.4921121822962314;0.5233540925266904;140;49;2282;2248;0.06134969325153374;0.02179715302491103;.\data\pcb_defects_kaggle\images/Spur/11_spur_09.jpg;5
2392;spur;1514;985;1591;1109;.\data\pcb_defects_kaggle\Annotations\Spur\11_spur_09;0.6803242769500438;0.4657473309608541;77;124;2282;2248;0.03374233128834356;0.05516014234875445;.\data\pcb_defects_kaggle\images/Spur/11_spur_09.jpg;5
2393;spur;289;929;391;1083;.\data\pcb_defects_kaggle\Annotations\Spur\11_spur_09;0.14899211218229624;0.447508896797153;102;154;2282;2248;0.044697633654688866;0.06850533807829182;.\data\pcb_defects_kaggle\images/Spur/11_spur_09.jpg;5
2394;spur;768;594;893;688;.\data\pcb_defects_kaggle\Annotations\Spur\11_spur_10;0.3639351446099912;0.2851423487544484;125;94;2282;2248;0.054776511831726556;0.04181494661921708;.\data\pcb_defects_kaggle\images/Spur/11_spur_10.jpg;5
2395;spur;325;1094;401;1219;.\data\pcb_defects_kaggle\Annotations\Spur\11_spur_10;0.15907099035933392;0.5144572953736655;76;125;2282;2248;0.033304119193689745;0.055604982206405695;.\data\pcb_defects_kaggle\images/Spur/11_spur_10.jpg;5
2396;spur;666;1944;794;2008;.\data\pcb_defects_kaggle\Annotations\Spur\11_spur_10;0.31989482909728306;0.8790035587188612;128;64;2282;2248;0.056091148115687994;0.028469750889679714;.\data\pcb_defects_kaggle\images/Spur/11_spur_10.jpg;5
2397;spur;725;845;843;911;.\data\pcb_defects_kaggle\Annotations\Spur\11_spur_10;0.34355828220858897;0.3905693950177936;118;66;2282;2248;0.051709027169149865;0.029359430604982206;.\data\pcb_defects_kaggle\images/Spur/11_spur_10.jpg;5
2398;spur;866;331;939;429;.\data\pcb_defects_kaggle\Annotations\Spur\11_spur_10;0.39548641542506574;0.16903914590747332;73;98;2282;2248;0.031989482909728306;0.04359430604982206;.\data\pcb_defects_kaggle\images/Spur/11_spur_10.jpg;5
2399;spur;1687;470;1749;570;.\data\pcb_defects_kaggle\Annotations\Spur\12_spur_01;0.6793198892843021;0.20553359683794467;62;100;2529;2530;0.024515618821668642;0.039525691699604744;.\data\pcb_defects_kaggle\images/Spur/12_spur_01.jpg;5
2400;spur;1055;734;1167;794;.\data\pcb_defects_kaggle\Annotations\Spur\12_spur_01;0.43930407275603006;0.3019762845849802;112;60;2529;2530;0.044286279161724;0.023715415019762844;.\data\pcb_defects_kaggle\images/Spur/12_spur_01.jpg;5
2401;spur;1775;1228;1891;1277;.\data\pcb_defects_kaggle\Annotations\Spur\12_spur_01;0.7247924080664294;0.4950592885375494;116;49;2529;2530;0.04586793198892843;0.019367588932806323;.\data\pcb_defects_kaggle\images/Spur/12_spur_01.jpg;5
2402;spur;1686;1821;1795;1868;.\data\pcb_defects_kaggle\Annotations\Spur\12_spur_01;0.688216686437327;0.7290513833992095;109;47;2529;2530;0.04310003954132068;0.01857707509881423;.\data\pcb_defects_kaggle\images/Spur/12_spur_01.jpg;5
2403;spur;887;1615;1007;1668;.\data\pcb_defects_kaggle\Annotations\Spur\12_spur_01;0.37445630684064846;0.6488142292490119;120;53;2529;2530;0.04744958481613286;0.020948616600790514;.\data\pcb_defects_kaggle\images/Spur/12_spur_01.jpg;5
2404;spur;1904;624;1949;708;.\data\pcb_defects_kaggle\Annotations\Spur\12_spur_02;0.761763542902333;0.26324110671936757;45;84;2529;2530;0.017793594306049824;0.03320158102766799;.\data\pcb_defects_kaggle\images/Spur/12_spur_02.jpg;5
2405;spur;1748;1434;1795;1530;.\data\pcb_defects_kaggle\Annotations\Spur\12_spur_02;0.7004744958481613;0.5857707509881422;47;96;2529;2530;0.018584420719652037;0.037944664031620556;.\data\pcb_defects_kaggle\images/Spur/12_spur_02.jpg;5
2406;spur;379;1617;505;1671;.\data\pcb_defects_kaggle\Annotations\Spur\12_spur_02;0.17477263740608937;0.649802371541502;126;54;2529;2530;0.0498220640569395;0.021343873517786563;.\data\pcb_defects_kaggle\images/Spur/12_spur_02.jpg;5
2407;spur;1347;2157;1438;2208;.\data\pcb_defects_kaggle\Annotations\Spur\12_spur_02;0.5506128904705417;0.8626482213438735;91;51;2529;2530;0.03598260181890075;0.02015810276679842;.\data\pcb_defects_kaggle\images/Spur/12_spur_02.jpg;5
2408;spur;1958;1819;2067;1868;.\data\pcb_defects_kaggle\Annotations\Spur\12_spur_02;0.7957690786872281;0.7286561264822135;109;49;2529;2530;0.04310003954132068;0.019367588932806323;.\data\pcb_defects_kaggle\images/Spur/12_spur_02.jpg;5
2409;spur;1547;1784;1662;1835;.\data\pcb_defects_kaggle\Annotations\Spur\12_spur_03;0.6344404903123765;0.7152173913043478;115;51;2529;2530;0.045472518782127325;0.02015810276679842;.\data\pcb_defects_kaggle\images/Spur/12_spur_03.jpg;5
2410;spur;2067;1568;2157;1621;.\data\pcb_defects_kaggle\Annotations\Spur\12_spur_03;0.8351126927639383;0.6302371541501977;90;53;2529;2530;0.03558718861209965;0.020948616600790514;.\data\pcb_defects_kaggle\images/Spur/12_spur_03.jpg;5
2411;spur;2371;1668;2415;1766;.\data\pcb_defects_kaggle\Annotations\Spur\12_spur_03;0.9462238038750495;0.6786561264822134;44;98;2529;2530;0.017398181099248716;0.03873517786561265;.\data\pcb_defects_kaggle\images/Spur/12_spur_03.jpg;5
2412;spur;993;1621;1111;1677;.\data\pcb_defects_kaggle\Annotations\Spur\12_spur_03;0.41597469355476474;0.6517786561264822;118;56;2529;2530;0.04665875840253064;0.022134387351778657;.\data\pcb_defects_kaggle\images/Spur/12_spur_03.jpg;5
2413;spur;100;1803;157;1901;.\data\pcb_defects_kaggle\Annotations\Spur\12_spur_03;0.05081059707394227;0.7320158102766798;57;98;2529;2530;0.022538552787663108;0.03873517786561265;.\data\pcb_defects_kaggle\images/Spur/12_spur_03.jpg;5
2414;spur;884;1192;984;1241;.\data\pcb_defects_kaggle\Annotations\Spur\12_spur_04;0.3693159351522341;0.4808300395256917;100;49;2529;2530;0.039541320680110716;0.019367588932806323;.\data\pcb_defects_kaggle\images/Spur/12_spur_04.jpg;5
2415;spur;1271;1064;1371;1112;.\data\pcb_defects_kaggle\Annotations\Spur\12_spur_04;0.5223408461842626;0.4300395256916996;100;48;2529;2530;0.039541320680110716;0.018972332015810278;.\data\pcb_defects_kaggle\images/Spur/12_spur_04.jpg;5
2416;spur;618;1654;715;1694;.\data\pcb_defects_kaggle\Annotations\Spur\12_spur_04;0.2635429023329379;0.6616600790513834;97;40;2529;2530;0.03835508105970739;0.015810276679841896;.\data\pcb_defects_kaggle\images/Spur/12_spur_04.jpg;5
2417;spur;102;1746;157;1848;.\data\pcb_defects_kaggle\Annotations\Spur\12_spur_04;0.051206010280743376;0.7102766798418972;55;102;2529;2530;0.021747726374060895;0.04031620553359684;.\data\pcb_defects_kaggle\images/Spur/12_spur_04.jpg;5
2418;spur;597;1486;698;1537;.\data\pcb_defects_kaggle\Annotations\Spur\12_spur_04;0.2560300514037169;0.5974308300395257;101;51;2529;2530;0.039936733886911824;0.02015810276679842;.\data\pcb_defects_kaggle\images/Spur/12_spur_04.jpg;5
2419;spur;1738;1083;1853;1141;.\data\pcb_defects_kaggle\Annotations\Spur\12_spur_05;0.7099644128113879;0.43952569169960476;115;58;2529;2530;0.045472518782127325;0.02292490118577075;.\data\pcb_defects_kaggle\images/Spur/12_spur_05.jpg;5
2420;spur;1689;597;1760;704;.\data\pcb_defects_kaggle\Annotations\Spur\12_spur_05;0.6818900751285093;0.25711462450592887;71;107;2529;2530;0.02807433768287861;0.042292490118577074;.\data\pcb_defects_kaggle\images/Spur/12_spur_05.jpg;5
2421;spur;949;734;1069;794;.\data\pcb_defects_kaggle\Annotations\Spur\12_spur_05;0.3989719256623171;0.3019762845849802;120;60;2529;2530;0.04744958481613286;0.023715415019762844;.\data\pcb_defects_kaggle\images/Spur/12_spur_05.jpg;5
2422;spur;915;1541;1024;1594;.\data\pcb_defects_kaggle\Annotations\Spur\12_spur_05;0.3833531039936734;0.6195652173913043;109;53;2529;2530;0.04310003954132068;0.020948616600790514;.\data\pcb_defects_kaggle\images/Spur/12_spur_05.jpg;5
2423;spur;1744;1434;1795;1514;.\data\pcb_defects_kaggle\Annotations\Spur\12_spur_05;0.6996836694345591;0.5826086956521739;51;80;2529;2530;0.020166073546856466;0.03162055335968379;.\data\pcb_defects_kaggle\images/Spur/12_spur_05.jpg;5
2424;spur;1689;554;1749;639;.\data\pcb_defects_kaggle\Annotations\Spur\12_spur_06;0.6797153024911032;0.2357707509881423;60;85;2529;2530;0.02372479240806643;0.03359683794466403;.\data\pcb_defects_kaggle\images/Spur/12_spur_06.jpg;5
2425;spur;2227;676;2278;776;.\data\pcb_defects_kaggle\Annotations\Spur\12_spur_06;0.8906682483194939;0.28695652173913044;51;100;2529;2530;0.020166073546856466;0.039525691699604744;.\data\pcb_defects_kaggle\images/Spur/12_spur_06.jpg;5
2426;spur;1757;1237;1866;1288;.\data\pcb_defects_kaggle\Annotations\Spur\12_spur_06;0.7162910241202056;0.4990118577075099;109;51;2529;2530;0.04310003954132068;0.02015810276679842;.\data\pcb_defects_kaggle\images/Spur/12_spur_06.jpg;5
2427;spur;1809;1454;1858;1546;.\data\pcb_defects_kaggle\Annotations\Spur\12_spur_06;0.72499011466983;0.5928853754940712;49;92;2529;2530;0.01937524713325425;0.03636363636363636;.\data\pcb_defects_kaggle\images/Spur/12_spur_06.jpg;5
2428;spur;462;1614;562;1668;.\data\pcb_defects_kaggle\Annotations\Spur\12_spur_06;0.20245156188216687;0.6486166007905139;100;54;2529;2530;0.039541320680110716;0.021343873517786563;.\data\pcb_defects_kaggle\images/Spur/12_spur_06.jpg;5
2429;spur;1406;748;1453;823;.\data\pcb_defects_kaggle\Annotations\Spur\12_spur_07;0.5652431791221827;0.31047430830039524;47;75;2529;2530;0.018584420719652037;0.029644268774703556;.\data\pcb_defects_kaggle\images/Spur/12_spur_07.jpg;5
2430;spur;1951;644;2007;730;.\data\pcb_defects_kaggle\Annotations\Spur\12_spur_07;0.7825227362593911;0.27154150197628457;56;86;2529;2530;0.022143139580862;0.03399209486166008;.\data\pcb_defects_kaggle\images/Spur/12_spur_07.jpg;5
2431;spur;1698;1079;1784;1134;.\data\pcb_defects_kaggle\Annotations\Spur\12_spur_07;0.6884143930407276;0.43735177865612646;86;55;2529;2530;0.034005535784895215;0.021739130434782608;.\data\pcb_defects_kaggle\images/Spur/12_spur_07.jpg;5
2432;spur;1486;1575;1571;1621;.\data\pcb_defects_kaggle\Annotations\Spur\12_spur_07;0.6043890865954923;0.6316205533596838;85;46;2529;2530;0.033610122578094107;0.01818181818181818;.\data\pcb_defects_kaggle\images/Spur/12_spur_07.jpg;5
2433;spur;1584;1832;1700;1892;.\data\pcb_defects_kaggle\Annotations\Spur\12_spur_07;0.6492684855674179;0.7359683794466403;116;60;2529;2530;0.04586793198892843;0.023715415019762844;.\data\pcb_defects_kaggle\images/Spur/12_spur_07.jpg;5
2434;spur;1371;903;1431;972;.\data\pcb_defects_kaggle\Annotations\Spur\12_spur_08;0.5539739027283511;0.3705533596837945;60;69;2529;2530;0.02372479240806643;0.02727272727272727;.\data\pcb_defects_kaggle\images/Spur/12_spur_08.jpg;5
2435;spur;922;1619;1027;1675;.\data\pcb_defects_kaggle\Annotations\Spur\12_spur_08;0.38533017002767894;0.6509881422924901;105;56;2529;2530;0.04151838671411625;0.022134387351778657;.\data\pcb_defects_kaggle\images/Spur/12_spur_08.jpg;5
2436;spur;2080;2161;2162;2212;.\data\pcb_defects_kaggle\Annotations\Spur\12_spur_08;0.8386714116251482;0.8642292490118577;82;51;2529;2530;0.03242388295769079;0.02015810276679842;.\data\pcb_defects_kaggle\images/Spur/12_spur_08.jpg;5
2437;spur;1335;2234;1437;2294;.\data\pcb_defects_kaggle\Annotations\Spur\12_spur_08;0.5480427046263345;0.8948616600790514;102;60;2529;2530;0.04033214709371293;0.023715415019762844;.\data\pcb_defects_kaggle\images/Spur/12_spur_08.jpg;5
2438;spur;1891;1817;1987;1877;.\data\pcb_defects_kaggle\Annotations\Spur\12_spur_08;0.7667062079873468;0.7300395256916996;96;60;2529;2530;0.03795966785290629;0.023715415019762844;.\data\pcb_defects_kaggle\images/Spur/12_spur_08.jpg;5
2439;spur;1793;1230;1886;1275;.\data\pcb_defects_kaggle\Annotations\Spur\12_spur_09;0.7273625939106366;0.4950592885375494;93;45;2529;2530;0.036773428232502965;0.017786561264822136;.\data\pcb_defects_kaggle\images/Spur/12_spur_09.jpg;5
2440;spur;2267;421;2317;515;.\data\pcb_defects_kaggle\Annotations\Spur\12_spur_09;0.9062870699881376;0.18498023715415018;50;94;2529;2530;0.019770660340055358;0.03715415019762846;.\data\pcb_defects_kaggle\images/Spur/12_spur_09.jpg;5
2441;spur;849;1808;966;1874;.\data\pcb_defects_kaggle\Annotations\Spur\12_spur_09;0.35883748517200476;0.7276679841897233;117;66;2529;2530;0.046263345195729534;0.02608695652173913;.\data\pcb_defects_kaggle\images/Spur/12_spur_09.jpg;5
2442;spur;1382;1532;1493;1583;.\data\pcb_defects_kaggle\Annotations\Spur\12_spur_09;0.5684064847765915;0.6156126482213439;111;51;2529;2530;0.04389086595492289;0.02015810276679842;.\data\pcb_defects_kaggle\images/Spur/12_spur_09.jpg;5
2443;spur;1362;526;1415;614;.\data\pcb_defects_kaggle\Annotations\Spur\12_spur_09;0.5490312376433373;0.22529644268774704;53;88;2529;2530;0.02095689996045868;0.034782608695652174;.\data\pcb_defects_kaggle\images/Spur/12_spur_09.jpg;5
2444;spur;866;734;962;790;.\data\pcb_defects_kaggle\Annotations\Spur\12_spur_09;0.36140767101621196;0.3011857707509881;96;56;2529;2530;0.03795966785290629;0.022134387351778657;.\data\pcb_defects_kaggle\images/Spur/12_spur_09.jpg;5
2445;spur;1960;697;2007;784;.\data\pcb_defects_kaggle\Annotations\Spur\12_spur_10;0.7843020956899961;0.2926877470355731;47;87;2529;2530;0.018584420719652037;0.03438735177865613;.\data\pcb_defects_kaggle\images/Spur/12_spur_10.jpg;5
2446;spur;2093;1517;2171;1570;.\data\pcb_defects_kaggle\Annotations\Spur\12_spur_10;0.8430209568999605;0.6100790513833992;78;53;2529;2530;0.03084223013048636;0.020948616600790514;.\data\pcb_defects_kaggle\images/Spur/12_spur_10.jpg;5
2447;spur;1211;1790;1298;1835;.\data\pcb_defects_kaggle\Annotations\Spur\12_spur_10;0.4960458679319889;0.7164031620553359;87;45;2529;2530;0.03440094899169632;0.017786561264822136;.\data\pcb_defects_kaggle\images/Spur/12_spur_10.jpg;5
2448;spur;2073;1864;2175;1914;.\data\pcb_defects_kaggle\Annotations\Spur\12_spur_10;0.8398576512455516;0.7466403162055336;102;50;2529;2530;0.04033214709371293;0.019762845849802372;.\data\pcb_defects_kaggle\images/Spur/12_spur_10.jpg;5
2449;spur;1526;1644;1647;1706;.\data\pcb_defects_kaggle\Annotations\Spur\12_spur_10;0.6273230525899565;0.6620553359683794;121;62;2529;2530;0.04784499802293397;0.02450592885375494;.\data\pcb_defects_kaggle\images/Spur/12_spur_10.jpg;5
2450;spurious_copper;1639;1052;1711;1100;.\data\pcb_defects_kaggle\Annotations\Spurious_copper\01_spurious_copper_01;0.5520764667106131;0.6784363177805801;72;48;3034;1586;0.023731048121292023;0.03026481715006305;.\data\pcb_defects_kaggle\images/Spurious_copper/01_spurious_copper_01.jpg;6
2451;spurious_copper;2142;1123;2199;1165;.\data\pcb_defects_kaggle\Annotations\Spurious_copper\01_spurious_copper_01;0.7153922214897824;0.7213114754098361;57;42;3034;1586;0.018787079762689517;0.02648171500630517;.\data\pcb_defects_kaggle\images/Spurious_copper/01_spurious_copper_01.jpg;6
2452;spurious_copper;782;1096;840;1152;.\data\pcb_defects_kaggle\Annotations\Spurious_copper\01_spurious_copper_01;0.2673038892551088;0.7087011349306431;58;56;3034;1586;0.01911667765326302;0.03530895334174023;.\data\pcb_defects_kaggle\images/Spurious_copper/01_spurious_copper_01.jpg;6
2453;spurious_copper;1675;394;1732;419;.\data\pcb_defects_kaggle\Annotations\Spurious_copper\01_spurious_copper_02;0.5614700065919578;0.2563051702395965;57;25;3034;1586;0.018787079762689517;0.015762925598991173;.\data\pcb_defects_kaggle\images/Spurious_copper/01_spurious_copper_02.jpg;6
2454;spurious_copper;1460;1160;1541;1232;.\data\pcb_defects_kaggle\Annotations\Spurious_copper\01_spurious_copper_02;0.4945616348055372;0.7540983606557377;81;72;3034;1586;0.026697429136453527;0.04539722572509458;.\data\pcb_defects_kaggle\images/Spurious_copper/01_spurious_copper_02.jpg;6
2455;spurious_copper;711;1092;775;1119;.\data\pcb_defects_kaggle\Annotations\Spurious_copper\01_spurious_copper_02;0.24489123269611074;0.6970365699873896;64;27;3034;1586;0.02109426499670402;0.017023959646910468;.\data\pcb_defects_kaggle\images/Spurious_copper/01_spurious_copper_02.jpg;6
2456;spurious_copper;1539;866;1574;962;.\data\pcb_defects_kaggle\Annotations\Spurious_copper\01_spurious_copper_03;0.5130191166776532;0.5762925598991173;35;96;3034;1586;0.011535926170072512;0.0605296343001261;.\data\pcb_defects_kaggle\images/Spurious_copper/01_spurious_copper_03.jpg;6
2457;spurious_copper;1854;948;1904;1043;.\data\pcb_defects_kaggle\Annotations\Spurious_copper\01_spurious_copper_03;0.6193144363876071;0.6276796973518285;50;95;3034;1586;0.016479894528675015;0.05989911727616646;.\data\pcb_defects_kaggle\images/Spurious_copper/01_spurious_copper_03.jpg;6
2458;spurious_copper;1810;1289;1846;1374;.\data\pcb_defects_kaggle\Annotations\Spurious_copper\01_spurious_copper_03;0.6025049439683586;0.8395334174022698;36;85;3034;1586;0.011865524060646011;0.053593947036569986;.\data\pcb_defects_kaggle\images/Spurious_copper/01_spurious_copper_03.jpg;6
2459;spurious_copper;2134;1138;2212;1168;.\data\pcb_defects_kaggle\Annotations\Spurious_copper\01_spurious_copper_04;0.7162162162162162;0.7269861286254728;78;30;3034;1586;0.025708635464733027;0.018915510718789406;.\data\pcb_defects_kaggle\images/Spurious_copper/01_spurious_copper_04.jpg;6
2460;spurious_copper;1597;1232;1691;1325;.\data\pcb_defects_kaggle\Annotations\Spurious_copper\01_spurious_copper_04;0.5418589321028345;0.8061160151324086;94;93;3034;1586;0.03098220171390903;0.058638083228247165;.\data\pcb_defects_kaggle\images/Spurious_copper/01_spurious_copper_04.jpg;6
2461;spurious_copper;2134;724;2190;749;.\data\pcb_defects_kaggle\Annotations\Spurious_copper\01_spurious_copper_04;0.7125906394199077;0.46437578814627994;56;25;3034;1586;0.01845748187211602;0.015762925598991173;.\data\pcb_defects_kaggle\images/Spurious_copper/01_spurious_copper_04.jpg;6
2462;spurious_copper;537;985;637;1013;.\data\pcb_defects_kaggle\Annotations\Spurious_copper\01_spurious_copper_05;0.1934739617666447;0.6298865069356873;100;28;3034;1586;0.03295978905735003;0.017654476670870115;.\data\pcb_defects_kaggle\images/Spurious_copper/01_spurious_copper_05.jpg;6
2463;spurious_copper;740;1260;775;1332;.\data\pcb_defects_kaggle\Annotations\Spurious_copper\01_spurious_copper_05;0.2496704021094265;0.8171500630517023;35;72;3034;1586;0.011535926170072512;0.04539722572509458;.\data\pcb_defects_kaggle\images/Spurious_copper/01_spurious_copper_05.jpg;6
2464;spurious_copper;412;912;468;955;.\data\pcb_defects_kaggle\Annotations\Spurious_copper\01_spurious_copper_05;0.14502307185234015;0.5885876418663304;56;43;3034;1586;0.01845748187211602;0.02711223203026482;.\data\pcb_defects_kaggle\images/Spurious_copper/01_spurious_copper_05.jpg;6
2465;spurious_copper;751;1023;850;1125;.\data\pcb_defects_kaggle\Annotations\Spurious_copper\01_spurious_copper_06;0.263843111404087;0.6771752837326608;99;102;3034;1586;0.03263019116677653;0.06431273644388398;.\data\pcb_defects_kaggle\images/Spurious_copper/01_spurious_copper_06.jpg;6
2466;spurious_copper;1669;663;1732;694;.\data\pcb_defects_kaggle\Annotations\Spurious_copper\01_spurious_copper_06;0.5604812129202373;0.42780580075662045;63;31;3034;1586;0.02076466710613052;0.019546027742749054;.\data\pcb_defects_kaggle\images/Spurious_copper/01_spurious_copper_06.jpg;6
2467;spurious_copper;2597;467;2653;503;.\data\pcb_defects_kaggle\Annotations\Spurious_copper\01_spurious_copper_06;0.8651944627554383;0.30580075662042877;56;36;3034;1586;0.01845748187211602;0.02269861286254729;.\data\pcb_defects_kaggle\images/Spurious_copper/01_spurious_copper_06.jpg;6
2468;spurious_copper;2578;741;2642;770;.\data\pcb_defects_kaggle\Annotations\Spurious_copper\01_spurious_copper_07;0.8602504943968359;0.47635561160151324;64;29;3034;1586;0.02109426499670402;0.01828499369482976;.\data\pcb_defects_kaggle\images/Spurious_copper/01_spurious_copper_07.jpg;6
2469;spurious_copper;2613;863;2648;953;.\data\pcb_defects_kaggle\Annotations\Spurious_copper\01_spurious_copper_07;0.8670072511535926;0.5725094577553594;35;90;3034;1586;0.011535926170072512;0.05674653215636822;.\data\pcb_defects_kaggle\images/Spurious_copper/01_spurious_copper_07.jpg;6
2470;spurious_copper;1811;861;1961;917;.\data\pcb_defects_kaggle\Annotations\Spurious_copper\01_spurious_copper_07;0.6216216216216216;0.5605296343001261;150;56;3034;1586;0.049439683586025046;0.03530895334174023;.\data\pcb_defects_kaggle\images/Spurious_copper/01_spurious_copper_07.jpg;6
2471;spurious_copper;1532;1203;1637;1244;.\data\pcb_defects_kaggle\Annotations\Spurious_copper\01_spurious_copper_08;0.5222478576137113;0.771437578814628;105;41;3034;1586;0.034607778510217534;0.025851197982345524;.\data\pcb_defects_kaggle\images/Spurious_copper/01_spurious_copper_08.jpg;6
2472;spurious_copper;2696;921;2759;949;.\data\pcb_defects_kaggle\Annotations\Spurious_copper\01_spurious_copper_08;0.8989782465392222;0.5895334174022698;63;28;3034;1586;0.02076466710613052;0.017654476670870115;.\data\pcb_defects_kaggle\images/Spurious_copper/01_spurious_copper_08.jpg;6
2473;spurious_copper;2189;1056;2315;1179;.\data\pcb_defects_kaggle\Annotations\Spurious_copper\01_spurious_copper_08;0.7422544495715228;0.7046027742749055;126;123;3034;1586;0.04152933421226104;0.07755359394703656;.\data\pcb_defects_kaggle\images/Spurious_copper/01_spurious_copper_08.jpg;6
2474;spurious_copper;1537;870;1580;990;.\data\pcb_defects_kaggle\Annotations\Spurious_copper\01_spurious_copper_09;0.5136783124588002;0.5863808322824716;43;120;3034;1586;0.014172709294660513;0.07566204287515763;.\data\pcb_defects_kaggle\images/Spurious_copper/01_spurious_copper_09.jpg;6
2475;spurious_copper;2039;1164;2068;1288;.\data\pcb_defects_kaggle\Annotations\Spurious_copper\01_spurious_copper_09;0.676829268292683;0.7730138713745272;29;124;3034;1586;0.00955833882663151;0.07818411097099622;.\data\pcb_defects_kaggle\images/Spurious_copper/01_spurious_copper_09.jpg;6
2476;spurious_copper;1226;1091;1311;1124;.\data\pcb_defects_kaggle\Annotations\Spurious_copper\01_spurious_copper_09;0.4180949241924852;0.6982976040353089;85;33;3034;1586;0.02801582069874753;0.02080706179066835;.\data\pcb_defects_kaggle\images/Spurious_copper/01_spurious_copper_09.jpg;6
2477;spurious_copper;1611;1356;1730;1407;.\data\pcb_defects_kaggle\Annotations\Spurious_copper\01_spurious_copper_10;0.5505932762030323;0.8710592686002522;119;51;3034;1586;0.03922214897824654;0.03215636822194199;.\data\pcb_defects_kaggle\images/Spurious_copper/01_spurious_copper_10.jpg;6
2478;spurious_copper;1003;1317;1172;1381;.\data\pcb_defects_kaggle\Annotations\Spurious_copper\01_spurious_copper_10;0.35843770599868163;0.8505674653215637;169;64;3034;1586;0.05570204350692155;0.0403530895334174;.\data\pcb_defects_kaggle\images/Spurious_copper/01_spurious_copper_10.jpg;6
2479;spurious_copper;1684;321;1729;357;.\data\pcb_defects_kaggle\Annotations\Spurious_copper\01_spurious_copper_10;0.5624588002636783;0.2137452711223203;45;36;3034;1586;0.014831905075807514;0.02269861286254729;.\data\pcb_defects_kaggle\images/Spurious_copper/01_spurious_copper_10.jpg;6
2480;spurious_copper;714;1051;815;1118;.\data\pcb_defects_kaggle\Annotations\Spurious_copper\01_spurious_copper_11;0.251977587343441;0.6837957124842371;101;67;3034;1586;0.033289386947923535;0.04224464060529634;.\data\pcb_defects_kaggle\images/Spurious_copper/01_spurious_copper_11.jpg;6
2481;spurious_copper;1073;1102;1145;1149;.\data\pcb_defects_kaggle\Annotations\Spurious_copper\01_spurious_copper_11;0.36552406064601184;0.7096469104665826;72;47;3034;1586;0.023731048121292023;0.029634300126103404;.\data\pcb_defects_kaggle\images/Spurious_copper/01_spurious_copper_11.jpg;6
2482;spurious_copper;2795;1209;2837;1328;.\data\pcb_defects_kaggle\Annotations\Spurious_copper\01_spurious_copper_11;0.9281476598549769;0.7998108448928121;42;119;3034;1586;0.013843111404087014;0.07503152585119799;.\data\pcb_defects_kaggle\images/Spurious_copper/01_spurious_copper_11.jpg;6
2483;spurious_copper;2343;1122;2467;1181;.\data\pcb_defects_kaggle\Annotations\Spurious_copper\01_spurious_copper_12;0.7926829268292683;0.7260403530895334;124;59;3034;1586;0.04087013843111404;0.03720050441361917;.\data\pcb_defects_kaggle\images/Spurious_copper/01_spurious_copper_12.jpg;6
2484;spurious_copper;2690;1086;2764;1148;.\data\pcb_defects_kaggle\Annotations\Spurious_copper\01_spurious_copper_12;0.8988134475939354;0.7042875157629256;74;62;3034;1586;0.024390243902439025;0.03909205548549811;.\data\pcb_defects_kaggle\images/Spurious_copper/01_spurious_copper_12.jpg;6
2485;spurious_copper;2731;1213;2813;1300;.\data\pcb_defects_kaggle\Annotations\Spurious_copper\01_spurious_copper_12;0.9136453526697429;0.7922446406052963;82;87;3034;1586;0.02702702702702703;0.05485498108448928;.\data\pcb_defects_kaggle\images/Spurious_copper/01_spurious_copper_12.jpg;6
2486;spurious_copper;1840;1218;1977;1273;.\data\pcb_defects_kaggle\Annotations\Spurious_copper\01_spurious_copper_13;0.6290375741595253;0.7853089533417402;137;55;3034;1586;0.04515491100856955;0.03467843631778058;.\data\pcb_defects_kaggle\images/Spurious_copper/01_spurious_copper_13.jpg;6
2487;spurious_copper;2470;572;2534;619;.\data\pcb_defects_kaggle\Annotations\Spurious_copper\01_spurious_copper_13;0.8246539222148979;0.3754728877679697;64;47;3034;1586;0.02109426499670402;0.029634300126103404;.\data\pcb_defects_kaggle\images/Spurious_copper/01_spurious_copper_13.jpg;6
2488;spurious_copper;2093;269;2205;304;.\data\pcb_defects_kaggle\Annotations\Spurious_copper\01_spurious_copper_13;0.7083058668424522;0.18064312736443883;112;35;3034;1586;0.03691496374423204;0.022068095838587643;.\data\pcb_defects_kaggle\images/Spurious_copper/01_spurious_copper_13.jpg;6
2489;spurious_copper;1666;612;1746;652;.\data\pcb_defects_kaggle\Annotations\Spurious_copper\01_spurious_copper_14;0.5622940013183916;0.39848675914249687;80;40;3034;1586;0.026367831245880026;0.025220680958385876;.\data\pcb_defects_kaggle\images/Spurious_copper/01_spurious_copper_14.jpg;6
2490;spurious_copper;743;1190;805;1267;.\data\pcb_defects_kaggle\Annotations\Spurious_copper\01_spurious_copper_14;0.25510876730388926;0.7745901639344263;62;77;3034;1586;0.02043506921555702;0.048549810844892814;.\data\pcb_defects_kaggle\images/Spurious_copper/01_spurious_copper_14.jpg;6
2491;spurious_copper;1184;1091;1343;1156;.\data\pcb_defects_kaggle\Annotations\Spurious_copper\01_spurious_copper_14;0.4164469347396177;0.7083858764186634;159;65;3034;1586;0.052406064601186554;0.040983606557377046;.\data\pcb_defects_kaggle\images/Spurious_copper/01_spurious_copper_14.jpg;6
2492;spurious_copper;1375;1112;1456;1180;.\data\pcb_defects_kaggle\Annotations\Spurious_copper\01_spurious_copper_15;0.4665458141067897;0.7225725094577553;81;68;3034;1586;0.026697429136453527;0.04287515762925599;.\data\pcb_defects_kaggle\images/Spurious_copper/01_spurious_copper_15.jpg;6
2493;spurious_copper;602;995;641;1061;.\data\pcb_defects_kaggle\Annotations\Spurious_copper\01_spurious_copper_15;0.20484508899143045;0.648171500630517;39;66;3034;1586;0.012854317732366513;0.0416141235813367;.\data\pcb_defects_kaggle\images/Spurious_copper/01_spurious_copper_15.jpg;6
2494;spurious_copper;417;911;467;960;.\data\pcb_defects_kaggle\Annotations\Spurious_copper\01_spurious_copper_15;0.14568226763348716;0.5898486759142497;50;49;3034;1586;0.016479894528675015;0.0308953341740227;.\data\pcb_defects_kaggle\images/Spurious_copper/01_spurious_copper_15.jpg;6
2495;spurious_copper;2128;725;2165;764;.\data\pcb_defects_kaggle\Annotations\Spurious_copper\01_spurious_copper_16;0.7074818721160184;0.46941992433795715;37;39;3034;1586;0.012195121951219513;0.02459016393442623;.\data\pcb_defects_kaggle\images/Spurious_copper/01_spurious_copper_16.jpg;6
2496;spurious_copper;2629;532;2690;584;.\data\pcb_defects_kaggle\Annotations\Spurious_copper\01_spurious_copper_16;0.8765655899802242;0.35182849936948296;61;52;3034;1586;0.02010547132498352;0.03278688524590164;.\data\pcb_defects_kaggle\images/Spurious_copper/01_spurious_copper_16.jpg;6
2497;spurious_copper;1669;422;1740;479;.\data\pcb_defects_kaggle\Annotations\Spurious_copper\01_spurious_copper_16;0.5617996044825313;0.28404791929382095;71;57;3034;1586;0.023401450230718525;0.035939470365699874;.\data\pcb_defects_kaggle\images/Spurious_copper/01_spurious_copper_16.jpg;6
2498;spurious_copper;1780;898;1833;1003;.\data\pcb_defects_kaggle\Annotations\Spurious_copper\01_spurious_copper_17;0.5954185893210283;0.5993064312736444;53;105;3034;1586;0.01746868820039552;0.06620428751576292;.\data\pcb_defects_kaggle\images/Spurious_copper/01_spurious_copper_17.jpg;6
2499;spurious_copper;2124;1297;2198;1358;.\data\pcb_defects_kaggle\Annotations\Spurious_copper\01_spurious_copper_17;0.7122610415293342;0.8370113493064313;74;61;3034;1586;0.024390243902439025;0.038461538461538464;.\data\pcb_defects_kaggle\images/Spurious_copper/01_spurious_copper_17.jpg;6
2500;spurious_copper;1844;1383;2001;1435;.\data\pcb_defects_kaggle\Annotations\Spurious_copper\01_spurious_copper_17;0.6336519446275544;0.8883984867591425;157;52;3034;1586;0.05174686882003955;0.03278688524590164;.\data\pcb_defects_kaggle\images/Spurious_copper/01_spurious_copper_17.jpg;6
2501;spurious_copper;1680;886;1754;1012;.\data\pcb_defects_kaggle\Annotations\Spurious_copper\01_spurious_copper_18;0.5659195781147001;0.5983606557377049;74;126;3034;1586;0.024390243902439025;0.07944514501891552;.\data\pcb_defects_kaggle\images/Spurious_copper/01_spurious_copper_18.jpg;6
2502;spurious_copper;1181;1093;1366;1164;.\data\pcb_defects_kaggle\Annotations\Spurious_copper\01_spurious_copper_18;0.41974291364535266;0.7115384615384616;185;71;3034;1586;0.06097560975609756;0.04476670870113493;.\data\pcb_defects_kaggle\images/Spurious_copper/01_spurious_copper_18.jpg;6
2503;spurious_copper;754;1286;821;1359;.\data\pcb_defects_kaggle\Annotations\Spurious_copper\01_spurious_copper_18;0.2595583388266315;0.8338587641866331;67;73;3034;1586;0.022083058668424523;0.046027742749054225;.\data\pcb_defects_kaggle\images/Spurious_copper/01_spurious_copper_18.jpg;6
2504;spurious_copper;2147;1189;2250;1280;.\data\pcb_defects_kaggle\Annotations\Spurious_copper\01_spurious_copper_19;0.7246209624258405;0.7783732660781841;103;91;3034;1586;0.03394858272907053;0.05737704918032787;.\data\pcb_defects_kaggle\images/Spurious_copper/01_spurious_copper_19.jpg;6
2505;spurious_copper;1688;1274;1745;1375;.\data\pcb_defects_kaggle\Annotations\Spurious_copper\01_spurious_copper_19;0.5657547791694133;0.8351197982345523;57;101;3034;1586;0.018787079762689517;0.06368221941992434;.\data\pcb_defects_kaggle\images/Spurious_copper/01_spurious_copper_19.jpg;6
2506;spurious_copper;445;985;481;1066;.\data\pcb_defects_kaggle\Annotations\Spurious_copper\01_spurious_copper_19;0.15260382333553066;0.6465952080706179;36;81;3034;1586;0.011865524060646011;0.0510718789407314;.\data\pcb_defects_kaggle\images/Spurious_copper/01_spurious_copper_19.jpg;6
2507;spurious_copper;1626;869;1680;983;.\data\pcb_defects_kaggle\Annotations\Spurious_copper\01_spurious_copper_20;0.5448253131179961;0.5838587641866331;54;114;3034;1586;0.017798286090969017;0.07187894073139975;.\data\pcb_defects_kaggle\images/Spurious_copper/01_spurious_copper_20.jpg;6
2508;spurious_copper;1610;1124;1746;1180;.\data\pcb_defects_kaggle\Annotations\Spurious_copper\01_spurious_copper_20;0.5530652603823335;0.7263556116015133;136;56;3034;1586;0.04482531311799604;0.03530895334174023;.\data\pcb_defects_kaggle\images/Spurious_copper/01_spurious_copper_20.jpg;6
2509;spurious_copper;2783;783;2842;916;.\data\pcb_defects_kaggle\Annotations\Spurious_copper\01_spurious_copper_20;0.9269940672379697;0.53562421185372;59;133;3034;1586;0.01944627554383652;0.08385876418663304;.\data\pcb_defects_kaggle\images/Spurious_copper/01_spurious_copper_20.jpg;6
2510;spurious_copper;773;2085;880;2150;.\data\pcb_defects_kaggle\Annotations\Spurious_copper\04_spurious_copper_01;0.27045157068062825;0.859375;107;65;3056;2464;0.0350130890052356;0.026379870129870128;.\data\pcb_defects_kaggle\images/Spurious_copper/04_spurious_copper_01.jpg;6
2511;spurious_copper;654;1229;766;1275;.\data\pcb_defects_kaggle\Annotations\Spurious_copper\04_spurious_copper_01;0.23232984293193717;0.5081168831168831;112;46;3056;2464;0.03664921465968586;0.018668831168831168;.\data\pcb_defects_kaggle\images/Spurious_copper/04_spurious_copper_01.jpg;6
2512;spurious_copper;629;1325;660;1419;.\data\pcb_defects_kaggle\Annotations\Spurious_copper\04_spurious_copper_01;0.21089659685863874;0.5568181818181818;31;94;3056;2464;0.010143979057591623;0.03814935064935065;.\data\pcb_defects_kaggle\images/Spurious_copper/04_spurious_copper_01.jpg;6
2513;spurious_copper;819;1232;931;1270;.\data\pcb_defects_kaggle\Annotations\Spurious_copper\04_spurious_copper_02;0.2863219895287958;0.507711038961039;112;38;3056;2464;0.03664921465968586;0.015422077922077922;.\data\pcb_defects_kaggle\images/Spurious_copper/04_spurious_copper_02.jpg;6
2514;spurious_copper;1916;1787;1961;1851;.\data\pcb_defects_kaggle\Annotations\Spurious_copper\04_spurious_copper_02;0.6343259162303665;0.7382305194805194;45;64;3056;2464;0.014725130890052356;0.025974025974025976;.\data\pcb_defects_kaggle\images/Spurious_copper/04_spurious_copper_02.jpg;6
2515;spurious_copper;1165;1881;1203;1962;.\data\pcb_defects_kaggle\Annotations\Spurious_copper\04_spurious_copper_02;0.387434554973822;0.7798295454545454;38;81;3056;2464;0.012434554973821989;0.032873376623376624;.\data\pcb_defects_kaggle\images/Spurious_copper/04_spurious_copper_02.jpg;6
2516;spurious_copper;1790;1129;1912;1163;.\data\pcb_defects_kaggle\Annotations\Spurious_copper\04_spurious_copper_03;0.6056937172774869;0.4650974025974026;122;34;3056;2464;0.03992146596858639;0.013798701298701298;.\data\pcb_defects_kaggle\images/Spurious_copper/04_spurious_copper_03.jpg;6
2517;spurious_copper;2103;626;2133;717;.\data\pcb_defects_kaggle\Annotations\Spurious_copper\04_spurious_copper_03;0.6930628272251309;0.27252435064935066;30;91;3056;2464;0.00981675392670157;0.036931818181818184;.\data\pcb_defects_kaggle\images/Spurious_copper/04_spurious_copper_03.jpg;6
2518;spurious_copper;2189;832;2239;937;.\data\pcb_defects_kaggle\Annotations\Spurious_copper\04_spurious_copper_03;0.724476439790576;0.35896915584415584;50;105;3056;2464;0.016361256544502618;0.04261363636363636;.\data\pcb_defects_kaggle\images/Spurious_copper/04_spurious_copper_03.jpg;6
2519;spurious_copper;1796;1019;1839;1089;.\data\pcb_defects_kaggle\Annotations\Spurious_copper\04_spurious_copper_04;0.5947316753926701;0.4277597402597403;43;70;3056;2464;0.01407068062827225;0.028409090909090908;.\data\pcb_defects_kaggle\images/Spurious_copper/04_spurious_copper_04.jpg;6
2520;spurious_copper;474;1236;527;1382;.\data\pcb_defects_kaggle\Annotations\Spurious_copper\04_spurious_copper_04;0.1637761780104712;0.53125;53;146;3056;2464;0.017342931937172776;0.05925324675324675;.\data\pcb_defects_kaggle\images/Spurious_copper/04_spurious_copper_04.jpg;6
2521;spurious_copper;938;1106;1023;1176;.\data\pcb_defects_kaggle\Annotations\Spurious_copper\04_spurious_copper_04;0.32084424083769636;0.4630681818181818;85;70;3056;2464;0.027814136125654452;0.028409090909090908;.\data\pcb_defects_kaggle\images/Spurious_copper/04_spurious_copper_04.jpg;6
2522;spurious_copper;2190;837;2236;962;.\data\pcb_defects_kaggle\Annotations\Spurious_copper\04_spurious_copper_05;0.7241492146596858;0.3650568181818182;46;125;3056;2464;0.015052356020942409;0.05073051948051948;.\data\pcb_defects_kaggle\images/Spurious_copper/04_spurious_copper_05.jpg;6
2523;spurious_copper;2099;633;2143;750;.\data\pcb_defects_kaggle\Annotations\Spurious_copper\04_spurious_copper_05;0.694044502617801;0.2806412337662338;44;117;3056;2464;0.014397905759162303;0.04748376623376623;.\data\pcb_defects_kaggle\images/Spurious_copper/04_spurious_copper_05.jpg;6
2524;spurious_copper;2378;1015;2468;1095;.\data\pcb_defects_kaggle\Annotations\Spurious_copper\04_spurious_copper_05;0.7928664921465969;0.4281655844155844;90;80;3056;2464;0.029450261780104712;0.032467532467532464;.\data\pcb_defects_kaggle\images/Spurious_copper/04_spurious_copper_05.jpg;6
2525;spurious_copper;2618;991;2662;1091;.\data\pcb_defects_kaggle\Annotations\Spurious_copper\04_spurious_copper_06;0.8638743455497382;0.4224837662337662;44;100;3056;2464;0.014397905759162303;0.040584415584415584;.\data\pcb_defects_kaggle\images/Spurious_copper/04_spurious_copper_06.jpg;6
2526;spurious_copper;1922;1779;1953;1849;.\data\pcb_defects_kaggle\Annotations\Spurious_copper\04_spurious_copper_06;0.6339986910994765;0.7362012987012987;31;70;3056;2464;0.010143979057591623;0.028409090909090908;.\data\pcb_defects_kaggle\images/Spurious_copper/04_spurious_copper_06.jpg;6
2527;spurious_copper;2444;1360;2485;1446;.\data\pcb_defects_kaggle\Annotations\Spurious_copper\04_spurious_copper_06;0.806446335078534;0.5693993506493507;41;86;3056;2464;0.013416230366492147;0.0349025974025974;.\data\pcb_defects_kaggle\images/Spurious_copper/04_spurious_copper_06.jpg;6
2528;spurious_copper;1937;1257;1990;1399;.\data\pcb_defects_kaggle\Annotations\Spurious_copper\04_spurious_copper_07;0.6425065445026178;0.538961038961039;53;142;3056;2464;0.017342931937172776;0.05762987012987013;.\data\pcb_defects_kaggle\images/Spurious_copper/04_spurious_copper_07.jpg;6
2529;spurious_copper;1935;1422;1988;1577;.\data\pcb_defects_kaggle\Annotations\Spurious_copper\04_spurious_copper_07;0.6418520942408377;0.6085633116883117;53;155;3056;2464;0.017342931937172776;0.06290584415584416;.\data\pcb_defects_kaggle\images/Spurious_copper/04_spurious_copper_07.jpg;6
2530;spurious_copper;309;530;346;628;.\data\pcb_defects_kaggle\Annotations\Spurious_copper\04_spurious_copper_07;0.10716623036649214;0.23498376623376624;37;98;3056;2464;0.012107329842931938;0.03977272727272727;.\data\pcb_defects_kaggle\images/Spurious_copper/04_spurious_copper_07.jpg;6
2531;spurious_copper;802;2095;992;2138;.\data\pcb_defects_kaggle\Annotations\Spurious_copper\04_spurious_copper_08;0.29352094240837695;0.8589691558441559;190;43;3056;2464;0.06217277486910995;0.0174512987012987;.\data\pcb_defects_kaggle\images/Spurious_copper/04_spurious_copper_08.jpg;6
2532;spurious_copper;2433;1757;2533;1792;.\data\pcb_defects_kaggle\Annotations\Spurious_copper\04_spurious_copper_08;0.8125;0.7201704545454546;100;35;3056;2464;0.032722513089005235;0.014204545454545454;.\data\pcb_defects_kaggle\images/Spurious_copper/04_spurious_copper_08.jpg;6
2533;spurious_copper;2487;1438;2663;1471;.\data\pcb_defects_kaggle\Annotations\Spurious_copper\04_spurious_copper_08;0.8426047120418848;0.5903003246753247;176;33;3056;2464;0.05759162303664921;0.013392857142857142;.\data\pcb_defects_kaggle\images/Spurious_copper/04_spurious_copper_08.jpg;6
2534;spurious_copper;1947;1260;1987;1370;.\data\pcb_defects_kaggle\Annotations\Spurious_copper\04_spurious_copper_09;0.643651832460733;0.533685064935065;40;110;3056;2464;0.013089005235602094;0.044642857142857144;.\data\pcb_defects_kaggle\images/Spurious_copper/04_spurious_copper_09.jpg;6
2535;spurious_copper;2371;1028;2462;1100;.\data\pcb_defects_kaggle\Annotations\Spurious_copper\04_spurious_copper_09;0.7907395287958116;0.4318181818181818;91;72;3056;2464;0.029777486910994765;0.02922077922077922;.\data\pcb_defects_kaggle\images/Spurious_copper/04_spurious_copper_09.jpg;6
2536;spurious_copper;483;1234;513;1411;.\data\pcb_defects_kaggle\Annotations\Spurious_copper\04_spurious_copper_09;0.16295811518324607;0.5367288961038961;30;177;3056;2464;0.00981675392670157;0.07183441558441558;.\data\pcb_defects_kaggle\images/Spurious_copper/04_spurious_copper_09.jpg;6
2537;spurious_copper;1800;1017;1840;1093;.\data\pcb_defects_kaggle\Annotations\Spurious_copper\04_spurious_copper_10;0.5955497382198953;0.4281655844155844;40;76;3056;2464;0.013089005235602094;0.030844155844155844;.\data\pcb_defects_kaggle\images/Spurious_copper/04_spurious_copper_10.jpg;6
2538;spurious_copper;1626;714;1663;815;.\data\pcb_defects_kaggle\Annotations\Spurious_copper\04_spurious_copper_10;0.538121727748691;0.31026785714285715;37;101;3056;2464;0.012107329842931938;0.040990259740259744;.\data\pcb_defects_kaggle\images/Spurious_copper/04_spurious_copper_10.jpg;6
2539;spurious_copper;382;2220;529;2254;.\data\pcb_defects_kaggle\Annotations\Spurious_copper\04_spurious_copper_10;0.14905104712041886;0.9078733766233766;147;34;3056;2464;0.048102094240837695;0.013798701298701298;.\data\pcb_defects_kaggle\images/Spurious_copper/04_spurious_copper_10.jpg;6
2540;spurious_copper;2624;1683;2657;1848;.\data\pcb_defects_kaggle\Annotations\Spurious_copper\04_spurious_copper_11;0.8640379581151832;0.7165178571428571;33;165;3056;2464;0.010798429319371727;0.06696428571428571;.\data\pcb_defects_kaggle\images/Spurious_copper/04_spurious_copper_11.jpg;6
2541;spurious_copper;1168;1897;1204;2001;.\data\pcb_defects_kaggle\Annotations\Spurious_copper\04_spurious_copper_11;0.3880890052356021;0.7909902597402597;36;104;3056;2464;0.011780104712041885;0.04220779220779221;.\data\pcb_defects_kaggle\images/Spurious_copper/04_spurious_copper_11.jpg;6
2542;spurious_copper;2609;1020;2665;1235;.\data\pcb_defects_kaggle\Annotations\Spurious_copper\04_spurious_copper_11;0.862892670157068;0.4575892857142857;56;215;3056;2464;0.01832460732984293;0.0872564935064935;.\data\pcb_defects_kaggle\images/Spurious_copper/04_spurious_copper_11.jpg;6
2543;spurious_copper;2189;840;2226;952;.\data\pcb_defects_kaggle\Annotations\Spurious_copper\04_spurious_copper_12;0.7223494764397905;0.36363636363636365;37;112;3056;2464;0.012107329842931938;0.045454545454545456;.\data\pcb_defects_kaggle\images/Spurious_copper/04_spurious_copper_12.jpg;6
2544;spurious_copper;1946;1259;1984;1407;.\data\pcb_defects_kaggle\Annotations\Spurious_copper\04_spurious_copper_12;0.6429973821989529;0.5409902597402597;38;148;3056;2464;0.012434554973821989;0.060064935064935064;.\data\pcb_defects_kaggle\images/Spurious_copper/04_spurious_copper_12.jpg;6
2545;spurious_copper;670;1241;953;1268;.\data\pcb_defects_kaggle\Annotations\Spurious_copper\04_spurious_copper_12;0.26554319371727747;0.5091314935064936;283;27;3056;2464;0.09260471204188482;0.010957792207792208;.\data\pcb_defects_kaggle\images/Spurious_copper/04_spurious_copper_12.jpg;6
2546;spurious_copper;2101;633;2141;768;.\data\pcb_defects_kaggle\Annotations\Spurious_copper\04_spurious_copper_13;0.694044502617801;0.28429383116883117;40;135;3056;2464;0.013089005235602094;0.05478896103896104;.\data\pcb_defects_kaggle\images/Spurious_copper/04_spurious_copper_13.jpg;6
2547;spurious_copper;870;1086;946;1143;.\data\pcb_defects_kaggle\Annotations\Spurious_copper\04_spurious_copper_13;0.29712041884816753;0.4523133116883117;76;57;3056;2464;0.024869109947643978;0.023133116883116884;.\data\pcb_defects_kaggle\images/Spurious_copper/04_spurious_copper_13.jpg;6
2548;spurious_copper;944;1114;1015;1170;.\data\pcb_defects_kaggle\Annotations\Spurious_copper\04_spurious_copper_13;0.3205170157068063;0.463474025974026;71;56;3056;2464;0.023232984293193717;0.022727272727272728;.\data\pcb_defects_kaggle\images/Spurious_copper/04_spurious_copper_13.jpg;6
2549;spurious_copper;2182;831;2244;962;.\data\pcb_defects_kaggle\Annotations\Spurious_copper\04_spurious_copper_14;0.7241492146596858;0.3638392857142857;62;131;3056;2464;0.020287958115183247;0.053165584415584416;.\data\pcb_defects_kaggle\images/Spurious_copper/04_spurious_copper_14.jpg;6
2550;spurious_copper;1944;1364;1991;1528;.\data\pcb_defects_kaggle\Annotations\Spurious_copper\04_spurious_copper_14;0.643815445026178;0.5868506493506493;47;164;3056;2464;0.015379581151832461;0.06655844155844155;.\data\pcb_defects_kaggle\images/Spurious_copper/04_spurious_copper_14.jpg;6
2551;spurious_copper;1910;1775;1964;1861;.\data\pcb_defects_kaggle\Annotations\Spurious_copper\04_spurious_copper_14;0.6338350785340314;0.7378246753246753;54;86;3056;2464;0.01767015706806283;0.0349025974025974;.\data\pcb_defects_kaggle\images/Spurious_copper/04_spurious_copper_14.jpg;6
2552;spurious_copper;2613;1637;2664;1826;.\data\pcb_defects_kaggle\Annotations\Spurious_copper\04_spurious_copper_15;0.8633835078534031;0.7027191558441559;51;189;3056;2464;0.01668848167539267;0.07670454545454546;.\data\pcb_defects_kaggle\images/Spurious_copper/04_spurious_copper_15.jpg;6
2553;spurious_copper;633;1237;748;1291;.\data\pcb_defects_kaggle\Annotations\Spurious_copper\04_spurious_copper_15;0.22594895287958114;0.512987012987013;115;54;3056;2464;0.03763089005235602;0.021915584415584416;.\data\pcb_defects_kaggle\images/Spurious_copper/04_spurious_copper_15.jpg;6
2554;spurious_copper;369;2223;464;2258;.\data\pcb_defects_kaggle\Annotations\Spurious_copper\04_spurious_copper_15;0.13628926701570682;0.9092938311688312;95;35;3056;2464;0.031086387434554975;0.014204545454545454;.\data\pcb_defects_kaggle\images/Spurious_copper/04_spurious_copper_15.jpg;6
2555;spurious_copper;529;1966;600;2024;.\data\pcb_defects_kaggle\Annotations\Spurious_copper\04_spurious_copper_16;0.18471858638743455;0.8096590909090909;71;58;3056;2464;0.023232984293193717;0.02353896103896104;.\data\pcb_defects_kaggle\images/Spurious_copper/04_spurious_copper_16.jpg;6
2556;spurious_copper;479;1313;511;1462;.\data\pcb_defects_kaggle\Annotations\Spurious_copper\04_spurious_copper_16;0.1619764397905759;0.5631087662337663;32;149;3056;2464;0.010471204188481676;0.060470779220779224;.\data\pcb_defects_kaggle\images/Spurious_copper/04_spurious_copper_16.jpg;6
2557;spurious_copper;624;1255;666;1427;.\data\pcb_defects_kaggle\Annotations\Spurious_copper\04_spurious_copper_16;0.21106020942408377;0.544237012987013;42;172;3056;2464;0.0137434554973822;0.0698051948051948;.\data\pcb_defects_kaggle\images/Spurious_copper/04_spurious_copper_16.jpg;6
2558;spurious_copper;1163;1862;1209;1975;.\data\pcb_defects_kaggle\Annotations\Spurious_copper\04_spurious_copper_17;0.3880890052356021;0.778612012987013;46;113;3056;2464;0.015052356020942409;0.04586038961038961;.\data\pcb_defects_kaggle\images/Spurious_copper/04_spurious_copper_17.jpg;6
2559;spurious_copper;2362;1011;2457;1074;.\data\pcb_defects_kaggle\Annotations\Spurious_copper\04_spurious_copper_17;0.7884489528795812;0.4230925324675325;95;63;3056;2464;0.031086387434554975;0.02556818181818182;.\data\pcb_defects_kaggle\images/Spurious_copper/04_spurious_copper_17.jpg;6
2560;spurious_copper;2423;1756;2548;1792;.\data\pcb_defects_kaggle\Annotations\Spurious_copper\04_spurious_copper_17;0.8133180628272252;0.7199675324675324;125;36;3056;2464;0.04090314136125654;0.01461038961038961;.\data\pcb_defects_kaggle\images/Spurious_copper/04_spurious_copper_17.jpg;6
2561;spurious_copper;2100;629;2143;740;.\data\pcb_defects_kaggle\Annotations\Spurious_copper\04_spurious_copper_18;0.6942081151832461;0.2778003246753247;43;111;3056;2464;0.01407068062827225;0.045048701298701296;.\data\pcb_defects_kaggle\images/Spurious_copper/04_spurious_copper_18.jpg;6
2562;spurious_copper;2194;828;2232;959;.\data\pcb_defects_kaggle\Annotations\Spurious_copper\04_spurious_copper_18;0.7241492146596858;0.3626217532467532;38;131;3056;2464;0.012434554973821989;0.053165584415584416;.\data\pcb_defects_kaggle\images/Spurious_copper/04_spurious_copper_18.jpg;6
2563;spurious_copper;1625;716;1659;812;.\data\pcb_defects_kaggle\Annotations\Spurious_copper\04_spurious_copper_18;0.537303664921466;0.31006493506493504;34;96;3056;2464;0.01112565445026178;0.03896103896103896;.\data\pcb_defects_kaggle\images/Spurious_copper/04_spurious_copper_18.jpg;6
2564;spurious_copper;1778;775;1815;874;.\data\pcb_defects_kaggle\Annotations\Spurious_copper\04_spurious_copper_19;0.5878599476439791;0.3346185064935065;37;99;3056;2464;0.012107329842931938;0.04017857142857143;.\data\pcb_defects_kaggle\images/Spurious_copper/04_spurious_copper_19.jpg;6
2565;spurious_copper;2268;408;2407;459;.\data\pcb_defects_kaggle\Annotations\Spurious_copper\04_spurious_copper_19;0.7648887434554974;0.17593344155844157;139;51;3056;2464;0.04548429319371728;0.020698051948051948;.\data\pcb_defects_kaggle\images/Spurious_copper/04_spurious_copper_19.jpg;6
2566;spurious_copper;308;539;342;614;.\data\pcb_defects_kaggle\Annotations\Spurious_copper\04_spurious_copper_19;0.10634816753926701;0.23396915584415584;34;75;3056;2464;0.01112565445026178;0.030438311688311688;.\data\pcb_defects_kaggle\images/Spurious_copper/04_spurious_copper_19.jpg;6
2567;spurious_copper;2190;871;2235;1028;.\data\pcb_defects_kaggle\Annotations\Spurious_copper\04_spurious_copper_20;0.7239856020942408;0.385349025974026;45;157;3056;2464;0.014725130890052356;0.06371753246753246;.\data\pcb_defects_kaggle\images/Spurious_copper/04_spurious_copper_20.jpg;6
2568;spurious_copper;955;1230;1126;1277;.\data\pcb_defects_kaggle\Annotations\Spurious_copper\04_spurious_copper_20;0.3404777486910995;0.5087256493506493;171;47;3056;2464;0.05595549738219895;0.019074675324675324;.\data\pcb_defects_kaggle\images/Spurious_copper/04_spurious_copper_20.jpg;6
2569;spurious_copper;874;1091;947;1139;.\data\pcb_defects_kaggle\Annotations\Spurious_copper\04_spurious_copper_20;0.29793848167539266;0.4525162337662338;73;48;3056;2464;0.023887434554973823;0.01948051948051948;.\data\pcb_defects_kaggle\images/Spurious_copper/04_spurious_copper_20.jpg;6
2570;spurious_copper;1511;662;1597;701;.\data\pcb_defects_kaggle\Annotations\Spurious_copper\05_spurious_copper_01;0.6108490566037735;0.31609461966604824;86;39;2544;2156;0.03380503144654088;0.018089053803339517;.\data\pcb_defects_kaggle\images/Spurious_copper/05_spurious_copper_01.jpg;6
2571;spurious_copper;606;596;766;645;.\data\pcb_defects_kaggle\Annotations\Spurious_copper\05_spurious_copper_01;0.2696540880503145;0.28780148423005564;160;49;2544;2156;0.06289308176100629;0.022727272727272728;.\data\pcb_defects_kaggle\images/Spurious_copper/05_spurious_copper_01.jpg;6
2572;spurious_copper;1927;1349;2022;1398;.\data\pcb_defects_kaggle\Annotations\Spurious_copper\05_spurious_copper_01;0.7761399371069182;0.6370593692022264;95;49;2544;2156;0.03734276729559748;0.022727272727272728;.\data\pcb_defects_kaggle\images/Spurious_copper/05_spurious_copper_01.jpg;6
2573;spurious_copper;1642;293;1711;365;.\data\pcb_defects_kaggle\Annotations\Spurious_copper\05_spurious_copper_01;0.659001572327044;0.1525974025974026;69;72;2544;2156;0.027122641509433963;0.03339517625231911;.\data\pcb_defects_kaggle\images/Spurious_copper/05_spurious_copper_01.jpg;6
2574;spurious_copper;2111;1631;2153;1699;.\data\pcb_defects_kaggle\Annotations\Spurious_copper\05_spurious_copper_01;0.8380503144654088;0.7722634508348795;42;68;2544;2156;0.01650943396226415;0.03153988868274583;.\data\pcb_defects_kaggle\images/Spurious_copper/05_spurious_copper_01.jpg;6
2575;spurious_copper;977;832;1103;876;.\data\pcb_defects_kaggle\Annotations\Spurious_copper\05_spurious_copper_02;0.4088050314465409;0.3961038961038961;126;44;2544;2156;0.049528301886792456;0.02040816326530612;.\data\pcb_defects_kaggle\images/Spurious_copper/05_spurious_copper_02.jpg;6
2576;spurious_copper;1524;779;1652;818;.\data\pcb_defects_kaggle\Annotations\Spurious_copper\05_spurious_copper_02;0.6242138364779874;0.37036178107606677;128;39;2544;2156;0.050314465408805034;0.018089053803339517;.\data\pcb_defects_kaggle\images/Spurious_copper/05_spurious_copper_02.jpg;6
2577;spurious_copper;1836;1353;1938;1393;.\data\pcb_defects_kaggle\Annotations\Spurious_copper\05_spurious_copper_02;0.7417452830188679;0.6368274582560297;102;40;2544;2156;0.04009433962264151;0.01855287569573284;.\data\pcb_defects_kaggle\images/Spurious_copper/05_spurious_copper_02.jpg;6
2578;spurious_copper;172;1307;249;1373;.\data\pcb_defects_kaggle\Annotations\Spurious_copper\05_spurious_copper_02;0.0827437106918239;0.62152133580705;77;66;2544;2156;0.030267295597484277;0.030612244897959183;.\data\pcb_defects_kaggle\images/Spurious_copper/05_spurious_copper_02.jpg;6
2579;spurious_copper;1156;1351;1195;1448;.\data\pcb_defects_kaggle\Annotations\Spurious_copper\05_spurious_copper_02;0.4620676100628931;0.6491187384044527;39;97;2544;2156;0.015330188679245283;0.044990723562152134;.\data\pcb_defects_kaggle\images/Spurious_copper/05_spurious_copper_02.jpg;6
2580;spurious_copper;2020;1365;2086;1434;.\data\pcb_defects_kaggle\Annotations\Spurious_copper\05_spurious_copper_03;0.8069968553459119;0.6491187384044527;66;69;2544;2156;0.025943396226415096;0.03200371057513915;.\data\pcb_defects_kaggle\images/Spurious_copper/05_spurious_copper_03.jpg;6
2581;spurious_copper;1914;1460;2074;1501;.\data\pcb_defects_kaggle\Annotations\Spurious_copper\05_spurious_copper_03;0.7838050314465409;0.6866883116883117;160;41;2544;2156;0.06289308176100629;0.019016697588126158;.\data\pcb_defects_kaggle\images/Spurious_copper/05_spurious_copper_03.jpg;6
2582;spurious_copper;1172;1751;1280;1810;.\data\pcb_defects_kaggle\Annotations\Spurious_copper\05_spurious_copper_03;0.48191823899371067;0.825834879406308;108;59;2544;2156;0.04245283018867924;0.02736549165120594;.\data\pcb_defects_kaggle\images/Spurious_copper/05_spurious_copper_03.jpg;6
2583;spurious_copper;1544;1834;1695;1881;.\data\pcb_defects_kaggle\Annotations\Spurious_copper\05_spurious_copper_03;0.6365959119496856;0.8615491651205937;151;47;2544;2156;0.059355345911949686;0.021799628942486084;.\data\pcb_defects_kaggle\images/Spurious_copper/05_spurious_copper_03.jpg;6
2584;spurious_copper;2277;1553;2369;1598;.\data\pcb_defects_kaggle\Annotations\Spurious_copper\05_spurious_copper_03;0.91312893081761;0.7307513914656771;92;45;2544;2156;0.036163522012578615;0.020871985157699443;.\data\pcb_defects_kaggle\images/Spurious_copper/05_spurious_copper_03.jpg;6
2585;spurious_copper;1544;1099;1649;1204;.\data\pcb_defects_kaggle\Annotations\Spurious_copper\05_spurious_copper_04;0.6275550314465409;0.5340909090909091;105;105;2544;2156;0.041273584905660375;0.048701298701298704;.\data\pcb_defects_kaggle\images/Spurious_copper/05_spurious_copper_04.jpg;6
2586;spurious_copper;227;1345;347;1374;.\data\pcb_defects_kaggle\Annotations\Spurious_copper\05_spurious_copper_04;0.11281446540880503;0.6305658627087198;120;29;2544;2156;0.04716981132075472;0.013450834879406308;.\data\pcb_defects_kaggle\images/Spurious_copper/05_spurious_copper_04.jpg;6
2587;spurious_copper;1928;1454;2061;1496;.\data\pcb_defects_kaggle\Annotations\Spurious_copper\05_spurious_copper_04;0.784001572327044;0.6841372912801484;133;42;2544;2156;0.05227987421383648;0.01948051948051948;.\data\pcb_defects_kaggle\images/Spurious_copper/05_spurious_copper_04.jpg;6
2588;spurious_copper;2066;1809;2156;1882;.\data\pcb_defects_kaggle\Annotations\Spurious_copper\05_spurious_copper_04;0.8297955974842768;0.8559833024118738;90;73;2544;2156;0.03537735849056604;0.03385899814471243;.\data\pcb_defects_kaggle\images/Spurious_copper/05_spurious_copper_04.jpg;6
2589;spurious_copper;2053;1582;2103;1684;.\data\pcb_defects_kaggle\Annotations\Spurious_copper\05_spurious_copper_04;0.8168238993710691;0.7574211502782932;50;102;2544;2156;0.019654088050314465;0.04730983302411874;.\data\pcb_defects_kaggle\images/Spurious_copper/05_spurious_copper_04.jpg;6
2590;spurious_copper;745;892;906;935;.\data\pcb_defects_kaggle\Annotations\Spurious_copper\05_spurious_copper_05;0.32448899371069184;0.4237012987012987;161;43;2544;2156;0.06328616352201258;0.019944341372912802;.\data\pcb_defects_kaggle\images/Spurious_copper/05_spurious_copper_05.jpg;6
2591;spurious_copper;303;659;474;703;.\data\pcb_defects_kaggle\Annotations\Spurious_copper\05_spurious_copper_05;0.15271226415094338;0.31586270871985156;171;44;2544;2156;0.06721698113207547;0.02040816326530612;.\data\pcb_defects_kaggle\images/Spurious_copper/05_spurious_copper_05.jpg;6
2592;spurious_copper;660;318;836;373;.\data\pcb_defects_kaggle\Annotations\Spurious_copper\05_spurious_copper_05;0.2940251572327044;0.1602504638218924;176;55;2544;2156;0.06918238993710692;0.025510204081632654;.\data\pcb_defects_kaggle\images/Spurious_copper/05_spurious_copper_05.jpg;6
2593;spurious_copper;1810;1354;2010;1406;.\data\pcb_defects_kaggle\Annotations\Spurious_copper\05_spurious_copper_05;0.7507861635220126;0.640074211502783;200;52;2544;2156;0.07861635220125786;0.02411873840445269;.\data\pcb_defects_kaggle\images/Spurious_copper/05_spurious_copper_05.jpg;6
2594;spurious_copper;1506;1232;1544;1348;.\data\pcb_defects_kaggle\Annotations\Spurious_copper\05_spurious_copper_05;0.5994496855345912;0.5983302411873841;38;116;2544;2156;0.014937106918238994;0.05380333951762523;.\data\pcb_defects_kaggle\images/Spurious_copper/05_spurious_copper_05.jpg;6
2595;spurious_copper;1810;1345;1977;1401;.\data\pcb_defects_kaggle\Annotations\Spurious_copper\05_spurious_copper_06;0.7443003144654088;0.6368274582560297;167;56;2544;2156;0.06564465408805031;0.025974025974025976;.\data\pcb_defects_kaggle\images/Spurious_copper/05_spurious_copper_06.jpg;6
2596;spurious_copper;1933;363;2056;412;.\data\pcb_defects_kaggle\Annotations\Spurious_copper\05_spurious_copper_06;0.784001572327044;0.17973098330241188;123;49;2544;2156;0.04834905660377359;0.022727272727272728;.\data\pcb_defects_kaggle\images/Spurious_copper/05_spurious_copper_06.jpg;6
2597;spurious_copper;1519;653;1649;706;.\data\pcb_defects_kaggle\Annotations\Spurious_copper\05_spurious_copper_06;0.6226415094339622;0.3151669758812616;130;53;2544;2156;0.05110062893081761;0.02458256029684601;.\data\pcb_defects_kaggle\images/Spurious_copper/05_spurious_copper_06.jpg;6
2598;spurious_copper;1877;782;1980;824;.\data\pcb_defects_kaggle\Annotations\Spurious_copper\05_spurious_copper_06;0.758058176100629;0.37244897959183676;103;42;2544;2156;0.0404874213836478;0.01948051948051948;.\data\pcb_defects_kaggle\images/Spurious_copper/05_spurious_copper_06.jpg;6
2599;spurious_copper;1497;1240;1544;1354;.\data\pcb_defects_kaggle\Annotations\Spurious_copper\05_spurious_copper_06;0.5976808176100629;0.6015769944341373;47;114;2544;2156;0.018474842767295597;0.05287569573283859;.\data\pcb_defects_kaggle\images/Spurious_copper/05_spurious_copper_06.jpg;6
2600;spurious_copper;555;662;789;706;.\data\pcb_defects_kaggle\Annotations\Spurious_copper\05_spurious_copper_07;0.2641509433962264;0.3172541743970315;234;44;2544;2156;0.09198113207547169;0.02040816326530612;.\data\pcb_defects_kaggle\images/Spurious_copper/05_spurious_copper_07.jpg;6
2601;spurious_copper;1517;893;1627;934;.\data\pcb_defects_kaggle\Annotations\Spurious_copper\05_spurious_copper_07;0.6179245283018868;0.4237012987012987;110;41;2544;2156;0.04323899371069182;0.019016697588126158;.\data\pcb_defects_kaggle\images/Spurious_copper/05_spurious_copper_07.jpg;6
2602;spurious_copper;1803;878;1853;1029;.\data\pcb_defects_kaggle\Annotations\Spurious_copper\05_spurious_copper_07;0.7185534591194969;0.4422541743970315;50;151;2544;2156;0.019654088050314465;0.07003710575139147;.\data\pcb_defects_kaggle\images/Spurious_copper/05_spurious_copper_07.jpg;6
2603;spurious_copper;1319;1229;1370;1392;.\data\pcb_defects_kaggle\Annotations\Spurious_copper\05_spurious_copper_07;0.528498427672956;0.6078385899814471;51;163;2544;2156;0.020047169811320754;0.07560296846011132;.\data\pcb_defects_kaggle\images/Spurious_copper/05_spurious_copper_07.jpg;6
2604;spurious_copper;130;1337;200;1423;.\data\pcb_defects_kaggle\Annotations\Spurious_copper\05_spurious_copper_07;0.06485849056603774;0.640074211502783;70;86;2544;2156;0.027515723270440252;0.039888682745825604;.\data\pcb_defects_kaggle\images/Spurious_copper/05_spurious_copper_07.jpg;6
2605;spurious_copper;703;1340;850;1379;.\data\pcb_defects_kaggle\Annotations\Spurious_copper\05_spurious_copper_08;0.30522798742138363;0.6305658627087198;147;39;2544;2156;0.05778301886792453;0.018089053803339517;.\data\pcb_defects_kaggle\images/Spurious_copper/05_spurious_copper_08.jpg;6
2606;spurious_copper;1835;1309;1983;1349;.\data\pcb_defects_kaggle\Annotations\Spurious_copper\05_spurious_copper_08;0.7503930817610063;0.6164192949907236;148;40;2544;2156;0.05817610062893082;0.01855287569573284;.\data\pcb_defects_kaggle\images/Spurious_copper/05_spurious_copper_08.jpg;6
2607;spurious_copper;1755;1363;1902;1399;.\data\pcb_defects_kaggle\Annotations\Spurious_copper\05_spurious_copper_08;0.71875;0.6405380333951762;147;36;2544;2156;0.05778301886792453;0.016697588126159554;.\data\pcb_defects_kaggle\images/Spurious_copper/05_spurious_copper_08.jpg;6
2608;spurious_copper;152;1032;191;1171;.\data\pcb_defects_kaggle\Annotations\Spurious_copper\05_spurious_copper_08;0.06741352201257862;0.510899814471243;39;139;2544;2156;0.015330188679245283;0.06447124304267161;.\data\pcb_defects_kaggle\images/Spurious_copper/05_spurious_copper_08.jpg;6
2609;spurious_copper;2341;1640;2375;1751;.\data\pcb_defects_kaggle\Annotations\Spurious_copper\05_spurious_copper_08;0.9268867924528302;0.7864100185528757;34;111;2544;2156;0.013364779874213837;0.05148423005565863;.\data\pcb_defects_kaggle\images/Spurious_copper/05_spurious_copper_08.jpg;6
2610;spurious_copper;1145;370;1186;504;.\data\pcb_defects_kaggle\Annotations\Spurious_copper\05_spurious_copper_09;0.4581367924528302;0.20269016697588127;41;134;2544;2156;0.01611635220125786;0.06215213358070501;.\data\pcb_defects_kaggle\images/Spurious_copper/05_spurious_copper_09.jpg;6
2611;spurious_copper;1720;1460;1888;1499;.\data\pcb_defects_kaggle\Annotations\Spurious_copper\05_spurious_copper_09;0.7091194968553459;0.6862244897959183;168;39;2544;2156;0.0660377358490566;0.018089053803339517;.\data\pcb_defects_kaggle\images/Spurious_copper/05_spurious_copper_09.jpg;6
2612;spurious_copper;1883;1532;2089;1576;.\data\pcb_defects_kaggle\Annotations\Spurious_copper\05_spurious_copper_09;0.7806603773584906;0.7207792207792207;206;44;2544;2156;0.0809748427672956;0.02040816326530612;.\data\pcb_defects_kaggle\images/Spurious_copper/05_spurious_copper_09.jpg;6
2613;spurious_copper;2113;1592;2156;1712;.\data\pcb_defects_kaggle\Annotations\Spurious_copper\05_spurious_copper_09;0.8390330188679245;0.7662337662337663;43;120;2544;2156;0.01690251572327044;0.055658627087198514;.\data\pcb_defects_kaggle\images/Spurious_copper/05_spurious_copper_09.jpg;6
2614;spurious_copper;1399;1913;1563;1959;.\data\pcb_defects_kaggle\Annotations\Spurious_copper\05_spurious_copper_09;0.5821540880503144;0.8979591836734694;164;46;2544;2156;0.06446540880503145;0.021335807050092765;.\data\pcb_defects_kaggle\images/Spurious_copper/05_spurious_copper_09.jpg;6
2615;spurious_copper;641;315;861;368;.\data\pcb_defects_kaggle\Annotations\Spurious_copper\05_spurious_copper_10;0.2952044025157233;0.1583951762523191;220;53;2544;2156;0.08647798742138364;0.02458256029684601;.\data\pcb_defects_kaggle\images/Spurious_copper/05_spurious_copper_10.jpg;6
2616;spurious_copper;542;706;714;757;.\data\pcb_defects_kaggle\Annotations\Spurious_copper\05_spurious_copper_10;0.2468553459119497;0.3392857142857143;172;51;2544;2156;0.06761006289308176;0.02365491651205937;.\data\pcb_defects_kaggle\images/Spurious_copper/05_spurious_copper_10.jpg;6
2617;spurious_copper;1525;656;1669;707;.\data\pcb_defects_kaggle\Annotations\Spurious_copper\05_spurious_copper_10;0.627751572327044;0.31609461966604824;144;51;2544;2156;0.05660377358490566;0.02365491651205937;.\data\pcb_defects_kaggle\images/Spurious_copper/05_spurious_copper_10.jpg;6
2618;spurious_copper;1530;1078;1653;1201;.\data\pcb_defects_kaggle\Annotations\Spurious_copper\05_spurious_copper_10;0.6255896226415094;0.5285250463821892;123;123;2544;2156;0.04834905660377359;0.05705009276437848;.\data\pcb_defects_kaggle\images/Spurious_copper/05_spurious_copper_10.jpg;6
2619;spurious_copper;1867;1349;2027;1401;.\data\pcb_defects_kaggle\Annotations\Spurious_copper\05_spurious_copper_10;0.7653301886792453;0.6377551020408163;160;52;2544;2156;0.06289308176100629;0.02411873840445269;.\data\pcb_defects_kaggle\images/Spurious_copper/05_spurious_copper_10.jpg;6
2620;spurious_copper;2549;1522;2594;1644;.\data\pcb_defects_kaggle\Annotations\Spurious_copper\06_spurious_copper_01;0.8966178521617852;0.6835060449050087;45;122;2868;2316;0.015690376569037656;0.05267702936096719;.\data\pcb_defects_kaggle\images/Spurious_copper/06_spurious_copper_01.jpg;6
2621;spurious_copper;1455;1517;1552;1564;.\data\pcb_defects_kaggle\Annotations\Spurious_copper\06_spurious_copper_01;0.5242329149232915;0.6651554404145078;97;47;2868;2316;0.033821478382147836;0.020293609671848015;.\data\pcb_defects_kaggle\images/Spurious_copper/06_spurious_copper_01.jpg;6
2622;spurious_copper;2069;614;2111;715;.\data\pcb_defects_kaggle\Annotations\Spurious_copper\06_spurious_copper_01;0.7287308228730823;0.2869170984455959;42;101;2868;2316;0.014644351464435146;0.043609671848013815;.\data\pcb_defects_kaggle\images/Spurious_copper/06_spurious_copper_01.jpg;6
2623;spurious_copper;1052;1915;1120;1947;.\data\pcb_defects_kaggle\Annotations\Spurious_copper\06_spurious_copper_01;0.3786610878661088;0.8337651122625216;68;32;2868;2316;0.023709902370990237;0.013816925734024179;.\data\pcb_defects_kaggle\images/Spurious_copper/06_spurious_copper_01.jpg;6
2624;spurious_copper;1637;1867;1724;1900;.\data\pcb_defects_kaggle\Annotations\Spurious_copper\06_spurious_copper_01;0.5859483960948396;0.8132556131260794;87;33;2868;2316;0.030334728033472803;0.014248704663212436;.\data\pcb_defects_kaggle\images/Spurious_copper/06_spurious_copper_01.jpg;6
2625;spurious_copper;925;2146;1054;2192;.\data\pcb_defects_kaggle\Annotations\Spurious_copper\06_spurious_copper_02;0.3450139470013947;0.9365284974093264;129;46;2868;2316;0.04497907949790795;0.019861830742659757;.\data\pcb_defects_kaggle\images/Spurious_copper/06_spurious_copper_02.jpg;6
2626;spurious_copper;1272;1107;1313;1159;.\data\pcb_defects_kaggle\Annotations\Spurious_copper\06_spurious_copper_02;0.45066248256624825;0.4892055267702936;41;52;2868;2316;0.014295676429567642;0.022452504317789293;.\data\pcb_defects_kaggle\images/Spurious_copper/06_spurious_copper_02.jpg;6
2627;spurious_copper;993;1014;1089;1059;.\data\pcb_defects_kaggle\Annotations\Spurious_copper\06_spurious_copper_02;0.36297071129707115;0.4475388601036269;96;45;2868;2316;0.03347280334728033;0.019430051813471502;.\data\pcb_defects_kaggle\images/Spurious_copper/06_spurious_copper_02.jpg;6
2628;spurious_copper;849;1392;893;1473;.\data\pcb_defects_kaggle\Annotations\Spurious_copper\06_spurious_copper_02;0.30369595536959554;0.6185233160621761;44;81;2868;2316;0.015341701534170154;0.034974093264248704;.\data\pcb_defects_kaggle\images/Spurious_copper/06_spurious_copper_02.jpg;6
2629;spurious_copper;1384;647;1425;734;.\data\pcb_defects_kaggle\Annotations\Spurious_copper\06_spurious_copper_02;0.4897140864714086;0.2981433506044905;41;87;2868;2316;0.014295676429567642;0.03756476683937824;.\data\pcb_defects_kaggle\images/Spurious_copper/06_spurious_copper_02.jpg;6
2630;spurious_copper;1133;425;1291;470;.\data\pcb_defects_kaggle\Annotations\Spurious_copper\06_spurious_copper_03;0.4225941422594142;0.1932210708117444;158;45;2868;2316;0.05509065550906555;0.019430051813471502;.\data\pcb_defects_kaggle\images/Spurious_copper/06_spurious_copper_03.jpg;6
2631;spurious_copper;2060;846;2111;964;.\data\pcb_defects_kaggle\Annotations\Spurious_copper\06_spurious_copper_03;0.7271617852161785;0.3907599309153713;51;118;2868;2316;0.01778242677824268;0.05094991364421416;.\data\pcb_defects_kaggle\images/Spurious_copper/06_spurious_copper_03.jpg;6
2632;spurious_copper;1010;493;1047;573;.\data\pcb_defects_kaggle\Annotations\Spurious_copper\06_spurious_copper_03;0.35861227336122736;0.23013816925734024;37;80;2868;2316;0.01290097629009763;0.03454231433506045;.\data\pcb_defects_kaggle\images/Spurious_copper/06_spurious_copper_03.jpg;6
2633;spurious_copper;2057;322;2101;419;.\data\pcb_defects_kaggle\Annotations\Spurious_copper\06_spurious_copper_03;0.7248953974895398;0.15997409326424872;44;97;2868;2316;0.015341701534170154;0.041882556131260795;.\data\pcb_defects_kaggle\images/Spurious_copper/06_spurious_copper_03.jpg;6
2634;spurious_copper;1510;632;1560;737;.\data\pcb_defects_kaggle\Annotations\Spurious_copper\06_spurious_copper_03;0.5352161785216178;0.29555267702936094;50;105;2868;2316;0.017433751743375175;0.04533678756476684;.\data\pcb_defects_kaggle\images/Spurious_copper/06_spurious_copper_03.jpg;6
2635;spurious_copper;381;937;516;981;.\data\pcb_defects_kaggle\Annotations\Spurious_copper\06_spurious_copper_04;0.1563807531380753;0.41407599309153714;135;44;2868;2316;0.04707112970711297;0.018998272884283247;.\data\pcb_defects_kaggle\images/Spurious_copper/06_spurious_copper_04.jpg;6
2636;spurious_copper;1108;897;1210;932;.\data\pcb_defects_kaggle\Annotations\Spurious_copper\06_spurious_copper_04;0.4041143654114365;0.39486183074265974;102;35;2868;2316;0.03556485355648536;0.015112262521588947;.\data\pcb_defects_kaggle\images/Spurious_copper/06_spurious_copper_04.jpg;6
2637;spurious_copper;1111;841;1181;876;.\data\pcb_defects_kaggle\Annotations\Spurious_copper\06_spurious_copper_04;0.399581589958159;0.37068221070811747;70;35;2868;2316;0.024407252440725245;0.015112262521588947;.\data\pcb_defects_kaggle\images/Spurious_copper/06_spurious_copper_04.jpg;6
2638;spurious_copper;1393;646;1435;731;.\data\pcb_defects_kaggle\Annotations\Spurious_copper\06_spurious_copper_04;0.4930264993026499;0.297279792746114;42;85;2868;2316;0.014644351464435146;0.03670120898100173;.\data\pcb_defects_kaggle\images/Spurious_copper/06_spurious_copper_04.jpg;6
2639;spurious_copper;716;895;757;986;.\data\pcb_defects_kaggle\Annotations\Spurious_copper\06_spurious_copper_04;0.2567991631799163;0.4060880829015544;41;91;2868;2316;0.014295676429567642;0.03929188255613126;.\data\pcb_defects_kaggle\images/Spurious_copper/06_spurious_copper_04.jpg;6
2640;spurious_copper;2482;1831;2535;1949;.\data\pcb_defects_kaggle\Annotations\Spurious_copper\06_spurious_copper_05;0.8746513249651325;0.8160621761658031;53;118;2868;2316;0.018479776847977684;0.05094991364421416;.\data\pcb_defects_kaggle\images/Spurious_copper/06_spurious_copper_05.jpg;6
2641;spurious_copper;1365;1114;1399;1202;.\data\pcb_defects_kaggle\Annotations\Spurious_copper\06_spurious_copper_05;0.4818688981868898;0.5;34;88;2868;2316;0.011854951185495118;0.037996545768566495;.\data\pcb_defects_kaggle\images/Spurious_copper/06_spurious_copper_05.jpg;6
2642;spurious_copper;843;1398;891;1492;.\data\pcb_defects_kaggle\Annotations\Spurious_copper\06_spurious_copper_05;0.3023012552301255;0.6239205526770294;48;94;2868;2316;0.016736401673640166;0.04058721934369603;.\data\pcb_defects_kaggle\images/Spurious_copper/06_spurious_copper_05.jpg;6
2643;spurious_copper;1465;1517;1582;1559;.\data\pcb_defects_kaggle\Annotations\Spurious_copper\06_spurious_copper_05;0.5312064156206415;0.6640759930915371;117;42;2868;2316;0.04079497907949791;0.018134715025906734;.\data\pcb_defects_kaggle\images/Spurious_copper/06_spurious_copper_05.jpg;6
2644;spurious_copper;1640;1863;1728;1912;.\data\pcb_defects_kaggle\Annotations\Spurious_copper\06_spurious_copper_05;0.5871687587168759;0.8149827288428325;88;49;2868;2316;0.030683403068340307;0.021157167530224525;.\data\pcb_defects_kaggle\images/Spurious_copper/06_spurious_copper_05.jpg;6
2645;spurious_copper;2067;1144;2104;1239;.\data\pcb_defects_kaggle\Annotations\Spurious_copper\06_spurious_copper_06;0.7271617852161785;0.5144645941278065;37;95;2868;2316;0.01290097629009763;0.041018998272884286;.\data\pcb_defects_kaggle\images/Spurious_copper/06_spurious_copper_06.jpg;6
2646;spurious_copper;2559;1537;2594;1673;.\data\pcb_defects_kaggle\Annotations\Spurious_copper\06_spurious_copper_06;0.8983612273361228;0.6930051813471503;35;136;2868;2316;0.012203626220362623;0.05872193436960276;.\data\pcb_defects_kaggle\images/Spurious_copper/06_spurious_copper_06.jpg;6
2647;spurious_copper;296;703;399;756;.\data\pcb_defects_kaggle\Annotations\Spurious_copper\06_spurious_copper_06;0.12116457461645747;0.31498272884283246;103;53;2868;2316;0.035913528591352856;0.022884283246977548;.\data\pcb_defects_kaggle\images/Spurious_copper/06_spurious_copper_06.jpg;6
2648;spurious_copper;1106;839;1193;881;.\data\pcb_defects_kaggle\Annotations\Spurious_copper\06_spurious_copper_06;0.40080195258019524;0.37132987910189985;87;42;2868;2316;0.030334728033472803;0.018134715025906734;.\data\pcb_defects_kaggle\images/Spurious_copper/06_spurious_copper_06.jpg;6
2649;spurious_copper;2172;1449;2240;1581;.\data\pcb_defects_kaggle\Annotations\Spurious_copper\06_spurious_copper_06;0.7691771269177127;0.6541450777202072;68;132;2868;2316;0.023709902370990237;0.05699481865284974;.\data\pcb_defects_kaggle\images/Spurious_copper/06_spurious_copper_06.jpg;6
2650;spurious_copper;1145;663;1238;710;.\data\pcb_defects_kaggle\Annotations\Spurious_copper\06_spurious_copper_07;0.4154463040446304;0.2964162348877375;93;47;2868;2316;0.032426778242677826;0.020293609671848015;.\data\pcb_defects_kaggle\images/Spurious_copper/06_spurious_copper_07.jpg;6
2651;spurious_copper;1576;422;1689;464;.\data\pcb_defects_kaggle\Annotations\Spurious_copper\06_spurious_copper_07;0.5692119944211994;0.19127806563039723;113;42;2868;2316;0.03940027894002789;0.018134715025906734;.\data\pcb_defects_kaggle\images/Spurious_copper/06_spurious_copper_07.jpg;6
2652;spurious_copper;1911;2078;2045;2127;.\data\pcb_defects_kaggle\Annotations\Spurious_copper\06_spurious_copper_07;0.689679218967922;0.9078151986183074;134;49;2868;2316;0.046722454672245464;0.021157167530224525;.\data\pcb_defects_kaggle\images/Spurious_copper/06_spurious_copper_07.jpg;6
2653;spurious_copper;1055;788;1116;817;.\data\pcb_defects_kaggle\Annotations\Spurious_copper\06_spurious_copper_07;0.378486750348675;0.34650259067357514;61;29;2868;2316;0.021269177126917713;0.012521588946459413;.\data\pcb_defects_kaggle\images/Spurious_copper/06_spurious_copper_07.jpg;6
2654;spurious_copper;2052;315;2104;410;.\data\pcb_defects_kaggle\Annotations\Spurious_copper\06_spurious_copper_07;0.7245467224546722;0.15651986183074265;52;95;2868;2316;0.01813110181311018;0.041018998272884286;.\data\pcb_defects_kaggle\images/Spurious_copper/06_spurious_copper_07.jpg;6
2655;spurious_copper;2060;658;2108;786;.\data\pcb_defects_kaggle\Annotations\Spurious_copper\06_spurious_copper_08;0.7266387726638772;0.31174438687392053;48;128;2868;2316;0.016736401673640166;0.055267702936096716;.\data\pcb_defects_kaggle\images/Spurious_copper/06_spurious_copper_08.jpg;6
2656;spurious_copper;1810;1075;1842;1176;.\data\pcb_defects_kaggle\Annotations\Spurious_copper\06_spurious_copper_08;0.6366806136680614;0.4859671848013817;32;101;2868;2316;0.011157601115760111;0.043609671848013815;.\data\pcb_defects_kaggle\images/Spurious_copper/06_spurious_copper_08.jpg;6
2657;spurious_copper;1827;1368;1859;1447;.\data\pcb_defects_kaggle\Annotations\Spurious_copper\06_spurious_copper_08;0.6426080892608089;0.6077288428324698;32;79;2868;2316;0.011157601115760111;0.034110535405872194;.\data\pcb_defects_kaggle\images/Spurious_copper/06_spurious_copper_08.jpg;6
2658;spurious_copper;228;707;306;751;.\data\pcb_defects_kaggle\Annotations\Spurious_copper\06_spurious_copper_08;0.09309623430962342;0.31476683937823835;78;44;2868;2316;0.027196652719665274;0.018998272884283247;.\data\pcb_defects_kaggle\images/Spurious_copper/06_spurious_copper_08.jpg;6
2659;spurious_copper;1599;1442;1632;1535;.\data\pcb_defects_kaggle\Annotations\Spurious_copper\06_spurious_copper_08;0.5632845188284519;0.6427029360967185;33;93;2868;2316;0.011506276150627616;0.04015544041450777;.\data\pcb_defects_kaggle\images/Spurious_copper/06_spurious_copper_08.jpg;6
2660;spurious_copper;1172;429;1289;469;.\data\pcb_defects_kaggle\Annotations\Spurious_copper\06_spurious_copper_09;0.42904463040446306;0.19386873920552677;117;40;2868;2316;0.04079497907949791;0.017271157167530225;.\data\pcb_defects_kaggle\images/Spurious_copper/06_spurious_copper_09.jpg;6
2661;spurious_copper;1497;1515;1591;1555;.\data\pcb_defects_kaggle\Annotations\Spurious_copper\06_spurious_copper_09;0.5383542538354253;0.6627806563039723;94;40;2868;2316;0.03277545327754533;0.017271157167530225;.\data\pcb_defects_kaggle\images/Spurious_copper/06_spurious_copper_09.jpg;6
2662;spurious_copper;1108;834;1181;872;.\data\pcb_defects_kaggle\Annotations\Spurious_copper\06_spurious_copper_09;0.39905857740585776;0.36830742659758203;73;38;2868;2316;0.025453277545327755;0.016407599309153715;.\data\pcb_defects_kaggle\images/Spurious_copper/06_spurious_copper_09.jpg;6
2663;spurious_copper;706;892;741;991;.\data\pcb_defects_kaggle\Annotations\Spurious_copper\06_spurious_copper_09;0.2522663877266388;0.4065198618307427;35;99;2868;2316;0.012203626220362623;0.042746113989637305;.\data\pcb_defects_kaggle\images/Spurious_copper/06_spurious_copper_09.jpg;6
2664;spurious_copper;1055;1136;1114;1171;.\data\pcb_defects_kaggle\Annotations\Spurious_copper\06_spurious_copper_09;0.37813807531380755;0.49805699481865284;59;35;2868;2316;0.020571827057182707;0.015112262521588947;.\data\pcb_defects_kaggle\images/Spurious_copper/06_spurious_copper_09.jpg;6
2665;spurious_copper;1299;429;1393;461;.\data\pcb_defects_kaggle\Annotations\Spurious_copper\06_spurious_copper_10;0.46931659693165967;0.19214162348877376;94;32;2868;2316;0.03277545327754533;0.013816925734024179;.\data\pcb_defects_kaggle\images/Spurious_copper/06_spurious_copper_10.jpg;6
2666;spurious_copper;2068;804;2105;955;.\data\pcb_defects_kaggle\Annotations\Spurious_copper\06_spurious_copper_10;0.727510460251046;0.3797495682210708;37;151;2868;2316;0.01290097629009763;0.0651986183074266;.\data\pcb_defects_kaggle\images/Spurious_copper/06_spurious_copper_10.jpg;6
2667;spurious_copper;942;2155;1074;2192;.\data\pcb_defects_kaggle\Annotations\Spurious_copper\06_spurious_copper_10;0.3514644351464435;0.9384715025906736;132;37;2868;2316;0.04602510460251046;0.015975820379965457;.\data\pcb_defects_kaggle\images/Spurious_copper/06_spurious_copper_10.jpg;6
2668;spurious_copper;2409;1856;2448;1930;.\data\pcb_defects_kaggle\Annotations\Spurious_copper\06_spurious_copper_10;0.8467573221757322;0.8173575129533679;39;74;2868;2316;0.013598326359832637;0.03195164075993091;.\data\pcb_defects_kaggle\images/Spurious_copper/06_spurious_copper_10.jpg;6
2669;spurious_copper;2412;1301;2446;1389;.\data\pcb_defects_kaggle\Annotations\Spurious_copper\06_spurious_copper_10;0.846931659693166;0.5807426597582038;34;88;2868;2316;0.011854951185495118;0.037996545768566495;.\data\pcb_defects_kaggle\images/Spurious_copper/06_spurious_copper_10.jpg;6
2670;spurious_copper;975;244;1108;298;.\data\pcb_defects_kaggle\Annotations\Spurious_copper\07_spurious_copper_01;0.35864325068870523;0.14107235814679855;133;54;2904;1921;0.04579889807162534;0.028110359187922956;.\data\pcb_defects_kaggle\images/Spurious_copper/07_spurious_copper_01.jpg;6
2671;spurious_copper;930;988;1086;1041;.\data\pcb_defects_kaggle\Annotations\Spurious_copper\07_spurious_copper_01;0.34710743801652894;0.5281103591879229;156;53;2904;1921;0.05371900826446281;0.027589796980739198;.\data\pcb_defects_kaggle\images/Spurious_copper/07_spurious_copper_01.jpg;6
2672;spurious_copper;1451;879;1513;984;.\data\pcb_defects_kaggle\Annotations\Spurious_copper\07_spurious_copper_01;0.5103305785123967;0.484903695991671;62;105;2904;1921;0.02134986225895317;0.05465903175429464;.\data\pcb_defects_kaggle\images/Spurious_copper/07_spurious_copper_01.jpg;6
2673;spurious_copper;1591;819;1639;920;.\data\pcb_defects_kaggle\Annotations\Spurious_copper\07_spurious_copper_01;0.556129476584022;0.452628839146278;48;101;2904;1921;0.01652892561983471;0.052576782925559604;.\data\pcb_defects_kaggle\images/Spurious_copper/07_spurious_copper_01.jpg;6
2674;spurious_copper;1856;1001;1975;1046;.\data\pcb_defects_kaggle\Annotations\Spurious_copper\07_spurious_copper_01;0.6596074380165289;0.5327954190525768;119;45;2904;1921;0.040977961432506885;0.02342529932326913;.\data\pcb_defects_kaggle\images/Spurious_copper/07_spurious_copper_01.jpg;6
2675;spurious_copper;1163;386;1236;481;.\data\pcb_defects_kaggle\Annotations\Spurious_copper\07_spurious_copper_02;0.41305096418732784;0.22566371681415928;73;95;2904;1921;0.025137741046831957;0.04945340968245705;.\data\pcb_defects_kaggle\images/Spurious_copper/07_spurious_copper_02.jpg;6
2676;spurious_copper;1523;655;1630;710;.\data\pcb_defects_kaggle\Annotations\Spurious_copper\07_spurious_copper_02;0.5428719008264463;0.3552837064029151;107;55;2904;1921;0.03684573002754821;0.028630921395106715;.\data\pcb_defects_kaggle\images/Spurious_copper/07_spurious_copper_02.jpg;6
2677;spurious_copper;1022;922;1158;986;.\data\pcb_defects_kaggle\Annotations\Spurious_copper\07_spurious_copper_02;0.3753443526170799;0.4966163456533056;136;64;2904;1921;0.046831955922865015;0.03331598125976054;.\data\pcb_defects_kaggle\images/Spurious_copper/07_spurious_copper_02.jpg;6
2678;spurious_copper;1951;500;2036;586;.\data\pcb_defects_kaggle\Annotations\Spurious_copper\07_spurious_copper_02;0.6864669421487604;0.2826652785007808;85;86;2904;1921;0.029269972451790634;0.04476834981780323;.\data\pcb_defects_kaggle\images/Spurious_copper/07_spurious_copper_02.jpg;6
2679;spurious_copper;1173;1296;1318;1346;.\data\pcb_defects_kaggle\Annotations\Spurious_copper\07_spurious_copper_02;0.42889118457300274;0.6876626756897449;145;50;2904;1921;0.04993112947658402;0.026028110359187923;.\data\pcb_defects_kaggle\images/Spurious_copper/07_spurious_copper_02.jpg;6
2680;spurious_copper;1596;824;1637;936;.\data\pcb_defects_kaggle\Annotations\Spurious_copper\07_spurious_copper_03;0.5566460055096418;0.45809474232170744;41;112;2904;1921;0.014118457300275482;0.05830296720458095;.\data\pcb_defects_kaggle\images/Spurious_copper/07_spurious_copper_03.jpg;6
2681;spurious_copper;1873;789;1918;891;.\data\pcb_defects_kaggle\Annotations\Spurious_copper\07_spurious_copper_03;0.6527203856749312;0.4372722540343571;45;102;2904;1921;0.015495867768595042;0.05309734513274336;.\data\pcb_defects_kaggle\images/Spurious_copper/07_spurious_copper_03.jpg;6
2682;spurious_copper;684;746;737;865;.\data\pcb_defects_kaggle\Annotations\Spurious_copper\07_spurious_copper_03;0.2446625344352617;0.41931285788651745;53;119;2904;1921;0.01825068870523416;0.061946902654867256;.\data\pcb_defects_kaggle\images/Spurious_copper/07_spurious_copper_03.jpg;6
2683;spurious_copper;1444;877;1496;972;.\data\pcb_defects_kaggle\Annotations\Spurious_copper\07_spurious_copper_03;0.506198347107438;0.4812597605413847;52;95;2904;1921;0.01790633608815427;0.04945340968245705;.\data\pcb_defects_kaggle\images/Spurious_copper/07_spurious_copper_03.jpg;6
2684;spurious_copper;410;615;498;691;.\data\pcb_defects_kaggle\Annotations\Spurious_copper\07_spurious_copper_03;0.15633608815426997;0.3399271212909943;88;76;2904;1921;0.030303030303030304;0.03956272774596564;.\data\pcb_defects_kaggle\images/Spurious_copper/07_spurious_copper_03.jpg;6
2685;spurious_copper;1737;819;1782;936;.\data\pcb_defects_kaggle\Annotations\Spurious_copper\07_spurious_copper_04;0.6058884297520661;0.45679333680374806;45;117;2904;1921;0.015495867768595042;0.06090577824049974;.\data\pcb_defects_kaggle\images/Spurious_copper/07_spurious_copper_04.jpg;6
2686;spurious_copper;2146;936;2194;1032;.\data\pcb_defects_kaggle\Annotations\Spurious_copper\07_spurious_copper_04;0.7472451790633609;0.5122332118688183;48;96;2904;1921;0.01652892561983471;0.04997397188964081;.\data\pcb_defects_kaggle\images/Spurious_copper/07_spurious_copper_04.jpg;6
2687;spurious_copper;2144;793;2261;850;.\data\pcb_defects_kaggle\Annotations\Spurious_copper\07_spurious_copper_04;0.7584366391184573;0.4276418532014576;117;57;2904;1921;0.040289256198347105;0.029672045809474232;.\data\pcb_defects_kaggle\images/Spurious_copper/07_spurious_copper_04.jpg;6
2688;spurious_copper;1824;988;1947;1041;.\data\pcb_defects_kaggle\Annotations\Spurious_copper\07_spurious_copper_04;0.6492768595041323;0.5281103591879229;123;53;2904;1921;0.042355371900826444;0.027589796980739198;.\data\pcb_defects_kaggle\images/Spurious_copper/07_spurious_copper_04.jpg;6
2689;spurious_copper;720;448;829;500;.\data\pcb_defects_kaggle\Annotations\Spurious_copper\07_spurious_copper_04;0.26670110192837465;0.2467464862051015;109;52;2904;1921;0.03753443526170799;0.02706923477355544;.\data\pcb_defects_kaggle\images/Spurious_copper/07_spurious_copper_04.jpg;6
2690;spurious_copper;1541;660;1667;713;.\data\pcb_defects_kaggle\Annotations\Spurious_copper\07_spurious_copper_05;0.5523415977961432;0.35736595523165016;126;53;2904;1921;0.04338842975206612;0.027589796980739198;.\data\pcb_defects_kaggle\images/Spurious_copper/07_spurious_copper_05.jpg;6
2691;spurious_copper;2205;581;2263;667;.\data\pcb_defects_kaggle\Annotations\Spurious_copper\07_spurious_copper_05;0.7692837465564738;0.3248308172826653;58;86;2904;1921;0.01997245179063361;0.04476834981780323;.\data\pcb_defects_kaggle\images/Spurious_copper/07_spurious_copper_05.jpg;6
2692;spurious_copper;1460;874;1492;982;.\data\pcb_defects_kaggle\Annotations\Spurious_copper\07_spurious_copper_05;0.5082644628099173;0.48308172826652784;32;108;2904;1921;0.011019283746556474;0.05622071837584591;.\data\pcb_defects_kaggle\images/Spurious_copper/07_spurious_copper_05.jpg;6
2693;spurious_copper;934;993;1065;1036;.\data\pcb_defects_kaggle\Annotations\Spurious_copper\07_spurious_copper_05;0.34418044077134985;0.5281103591879229;131;43;2904;1921;0.04511019283746556;0.022384174908901613;.\data\pcb_defects_kaggle\images/Spurious_copper/07_spurious_copper_05.jpg;6
2694;spurious_copper;1939;484;2042;598;.\data\pcb_defects_kaggle\Annotations\Spurious_copper\07_spurious_copper_05;0.6854338842975206;0.28162415408641334;103;114;2904;1921;0.03546831955922865;0.059344091618948464;.\data\pcb_defects_kaggle\images/Spurious_copper/07_spurious_copper_05.jpg;6
2695;spurious_copper;1068;529;1129;651;.\data\pcb_defects_kaggle\Annotations\Spurious_copper\07_spurious_copper_06;0.37827134986225897;0.3071317022384175;61;122;2904;1921;0.02100550964187328;0.06350858927641853;.\data\pcb_defects_kaggle\images/Spurious_copper/07_spurious_copper_06.jpg;6
2696;spurious_copper;889;1107;1029;1151;.\data\pcb_defects_kaggle\Annotations\Spurious_copper\07_spurious_copper_06;0.33023415977961434;0.5877147319104633;140;44;2904;1921;0.048209366391184574;0.022904737116085372;.\data\pcb_defects_kaggle\images/Spurious_copper/07_spurious_copper_06.jpg;6
2697;spurious_copper;1796;781;1853;901;.\data\pcb_defects_kaggle\Annotations\Spurious_copper\07_spurious_copper_06;0.628271349862259;0.43779281624154087;57;120;2904;1921;0.01962809917355372;0.062467464862051014;.\data\pcb_defects_kaggle\images/Spurious_copper/07_spurious_copper_06.jpg;6
2698;spurious_copper;1591;827;1649;936;.\data\pcb_defects_kaggle\Annotations\Spurious_copper\07_spurious_copper_06;0.5578512396694215;0.4588755856324831;58;109;2904;1921;0.01997245179063361;0.05674128058302967;.\data\pcb_defects_kaggle\images/Spurious_copper/07_spurious_copper_06.jpg;6
2699;spurious_copper;1934;826;2013;908;.\data\pcb_defects_kaggle\Annotations\Spurious_copper\07_spurious_copper_06;0.6795798898071626;0.45132743362831856;79;82;2904;1921;0.027203856749311296;0.04268610098906819;.\data\pcb_defects_kaggle\images/Spurious_copper/07_spurious_copper_06.jpg;6
2700;spurious_copper;1870;777;1918;894;.\data\pcb_defects_kaggle\Annotations\Spurious_copper\07_spurious_copper_07;0.6522038567493113;0.4349297241020302;48;117;2904;1921;0.01652892561983471;0.06090577824049974;.\data\pcb_defects_kaggle\images/Spurious_copper/07_spurious_copper_07.jpg;6
2701;spurious_copper;2125;791;2279;857;.\data\pcb_defects_kaggle\Annotations\Spurious_copper\07_spurious_copper_07;0.7582644628099173;0.42894325871941696;154;66;2904;1921;0.05303030303030303;0.03435710567412806;.\data\pcb_defects_kaggle\images/Spurious_copper/07_spurious_copper_07.jpg;6
2702;spurious_copper;1029;927;1201;989;.\data\pcb_defects_kaggle\Annotations\Spurious_copper\07_spurious_copper_07;0.38395316804407714;0.4986985944820406;172;62;2904;1921;0.05922865013774105;0.032274856845393024;.\data\pcb_defects_kaggle\images/Spurious_copper/07_spurious_copper_07.jpg;6
2703;spurious_copper;2215;584;2267;669;.\data\pcb_defects_kaggle\Annotations\Spurious_copper\07_spurious_copper_07;0.7716942148760331;0.32613222280062465;52;85;2904;1921;0.01790633608815427;0.04424778761061947;.\data\pcb_defects_kaggle\images/Spurious_copper/07_spurious_copper_07.jpg;6
2704;spurious_copper;1982;439;2080;512;.\data\pcb_defects_kaggle\Annotations\Spurious_copper\07_spurious_copper_07;0.6993801652892562;0.24752732951587714;98;73;2904;1921;0.0337465564738292;0.03800104112441437;.\data\pcb_defects_kaggle\images/Spurious_copper/07_spurious_copper_07.jpg;6
2705;spurious_copper;1358;477;1449;529;.\data\pcb_defects_kaggle\Annotations\Spurious_copper\07_spurious_copper_08;0.48329889807162535;0.2618427902134305;91;52;2904;1921;0.03133608815426997;0.02706923477355544;.\data\pcb_defects_kaggle\images/Spurious_copper/07_spurious_copper_08.jpg;6
2706;spurious_copper;1029;936;1186;979;.\data\pcb_defects_kaggle\Annotations\Spurious_copper\07_spurious_copper_08;0.38137052341597794;0.49843831337844874;157;43;2904;1921;0.0540633608815427;0.022384174908901613;.\data\pcb_defects_kaggle\images/Spurious_copper/07_spurious_copper_08.jpg;6
2707;spurious_copper;1306;850;1460;903;.\data\pcb_defects_kaggle\Annotations\Spurious_copper\07_spurious_copper_08;0.4762396694214876;0.4562727745965643;154;53;2904;1921;0.05303030303030303;0.027589796980739198;.\data\pcb_defects_kaggle\images/Spurious_copper/07_spurious_copper_08.jpg;6
2708;spurious_copper;1736;851;1772;920;.\data\pcb_defects_kaggle\Annotations\Spurious_copper\07_spurious_copper_08;0.6039944903581267;0.46095783446121813;36;69;2904;1921;0.012396694214876033;0.03591879229567933;.\data\pcb_defects_kaggle\images/Spurious_copper/07_spurious_copper_08.jpg;6
2709;spurious_copper;1986;863;2122;910;.\data\pcb_defects_kaggle\Annotations\Spurious_copper\07_spurious_copper_08;0.7073002754820936;0.46147839666840185;136;47;2904;1921;0.046831955922865015;0.024466423737636647;.\data\pcb_defects_kaggle\images/Spurious_copper/07_spurious_copper_08.jpg;6
2710;spurious_copper;1532;665;1658;715;.\data\pcb_defects_kaggle\Annotations\Spurious_copper\07_spurious_copper_09;0.5492424242424242;0.35918792295679336;126;50;2904;1921;0.04338842975206612;0.026028110359187923;.\data\pcb_defects_kaggle\images/Spurious_copper/07_spurious_copper_09.jpg;6
2711;spurious_copper;2073;858;2203;903;.\data\pcb_defects_kaggle\Annotations\Spurious_copper\07_spurious_copper_09;0.7362258953168044;0.4583550234252993;130;45;2904;1921;0.044765840220385676;0.02342529932326913;.\data\pcb_defects_kaggle\images/Spurious_copper/07_spurious_copper_09.jpg;6
2712;spurious_copper;1455;881;1499;991;.\data\pcb_defects_kaggle\Annotations\Spurious_copper\07_spurious_copper_09;0.5086088154269972;0.4872462259239979;44;110;2904;1921;0.015151515151515152;0.05726184279021343;.\data\pcb_defects_kaggle\images/Spurious_copper/07_spurious_copper_09.jpg;6
2713;spurious_copper;1737;791;1787;907;.\data\pcb_defects_kaggle\Annotations\Spurious_copper\07_spurious_copper_09;0.6067493112947658;0.44195731389901094;50;116;2904;1921;0.01721763085399449;0.06038521603331598;.\data\pcb_defects_kaggle\images/Spurious_copper/07_spurious_copper_09.jpg;6
2714;spurious_copper;684;744;732;877;.\data\pcb_defects_kaggle\Annotations\Spurious_copper\07_spurious_copper_09;0.24380165289256198;0.4219156689224362;48;133;2904;1921;0.01652892561983471;0.06923477355543987;.\data\pcb_defects_kaggle\images/Spurious_copper/07_spurious_copper_09.jpg;6
2715;spurious_copper;1049;243;1146;294;.\data\pcb_defects_kaggle\Annotations\Spurious_copper\07_spurious_copper_10;0.3779269972451791;0.13977095262883915;97;51;2904;1921;0.03340220385674931;0.02654867256637168;.\data\pcb_defects_kaggle\images/Spurious_copper/07_spurious_copper_10.jpg;6
2716;spurious_copper;1634;662;1718;705;.\data\pcb_defects_kaggle\Annotations\Spurious_copper\07_spurious_copper_10;0.5771349862258953;0.3558042686100989;84;43;2904;1921;0.028925619834710745;0.022384174908901613;.\data\pcb_defects_kaggle\images/Spurious_copper/07_spurious_copper_10.jpg;6
2717;spurious_copper;1863;774;1922;889;.\data\pcb_defects_kaggle\Annotations\Spurious_copper\07_spurious_copper_10;0.6516873278236914;0.43284747527329515;59;115;2904;1921;0.0203168044077135;0.05986465382613222;.\data\pcb_defects_kaggle\images/Spurious_copper/07_spurious_copper_10.jpg;6
2718;spurious_copper;1515;874;1570;967;.\data\pcb_defects_kaggle\Annotations\Spurious_copper\07_spurious_copper_10;0.53116391184573;0.47917751171264966;55;93;2904;1921;0.01893939393939394;0.048412285268089536;.\data\pcb_defects_kaggle\images/Spurious_copper/07_spurious_copper_10.jpg;6
2719;spurious_copper;989;1098;1087;1148;.\data\pcb_defects_kaggle\Annotations\Spurious_copper\07_spurious_copper_10;0.3574380165289256;0.5845913586673608;98;50;2904;1921;0.0337465564738292;0.026028110359187923;.\data\pcb_defects_kaggle\images/Spurious_copper/07_spurious_copper_10.jpg;6
2720;spurious_copper;915;1226;1020;1277;.\data\pcb_defects_kaggle\Annotations\Spurious_copper\08_spurious_copper_01;0.35067053280173976;0.5810120705663882;105;51;2759;2154;0.038057267125770206;0.023676880222841225;.\data\pcb_defects_kaggle\images/Spurious_copper/08_spurious_copper_01.jpg;6
2721;spurious_copper;1778;1266;1907;1316;.\data\pcb_defects_kaggle\Annotations\Spurious_copper\08_spurious_copper_01;0.6678144255164915;0.5993500464252554;129;50;2759;2154;0.04675607104023197;0.02321262766945218;.\data\pcb_defects_kaggle\images/Spurious_copper/08_spurious_copper_01.jpg;6
2722;spurious_copper;797;892;845;1003;.\data\pcb_defects_kaggle\Annotations\Spurious_copper\08_spurious_copper_01;0.2975715839072128;0.43987929433611883;48;111;2759;2154;0.017397607828923523;0.05153203342618384;.\data\pcb_defects_kaggle\images/Spurious_copper/08_spurious_copper_01.jpg;6
2723;spurious_copper;2284;1028;2330;1131;.\data\pcb_defects_kaggle\Annotations\Spurious_copper\08_spurious_copper_01;0.8361725262776368;0.5011606313834726;46;103;2759;2154;0.016672707502718376;0.04781801299907149;.\data\pcb_defects_kaggle\images/Spurious_copper/08_spurious_copper_01.jpg;6
2724;spurious_copper;2063;716;2110;820;.\data\pcb_defects_kaggle\Annotations\Spurious_copper\08_spurious_copper_01;0.7562522653135194;0.3565459610027855;47;104;2759;2154;0.01703515766582095;0.04828226555246054;.\data\pcb_defects_kaggle\images/Spurious_copper/08_spurious_copper_01.jpg;6
2725;spurious_copper;932;911;991;1003;.\data\pcb_defects_kaggle\Annotations\Spurious_copper\08_spurious_copper_02;0.3484958318231243;0.44428969359331477;59;92;2759;2154;0.02138455962305183;0.04271123491179202;.\data\pcb_defects_kaggle\images/Spurious_copper/08_spurious_copper_02.jpg;6
2726;spurious_copper;1696;893;1745;998;.\data\pcb_defects_kaggle\Annotations\Spurious_copper\08_spurious_copper_02;0.6235955056179775;0.4389507892293408;49;105;2759;2154;0.017760057992026096;0.04874651810584958;.\data\pcb_defects_kaggle\images/Spurious_copper/08_spurious_copper_02.jpg;6
2727;spurious_copper;2363;1310;2404;1411;.\data\pcb_defects_kaggle\Annotations\Spurious_copper\08_spurious_copper_02;0.8638999637549837;0.6316155988857939;41;101;2759;2154;0.014860456687205509;0.04688950789229341;.\data\pcb_defects_kaggle\images/Spurious_copper/08_spurious_copper_02.jpg;6
2728;spurious_copper;433;1393;514;1464;.\data\pcb_defects_kaggle\Annotations\Spurious_copper\08_spurious_copper_02;0.1716201522290685;0.6631847725162489;81;71;2759;2154;0.029358463211308444;0.032961931290622096;.\data\pcb_defects_kaggle\images/Spurious_copper/08_spurious_copper_02.jpg;6
2729;spurious_copper;253;1752;304;1849;.\data\pcb_defects_kaggle\Annotations\Spurious_copper\08_spurious_copper_02;0.10094237042406669;0.835886722376973;51;97;2759;2154;0.018484958318231243;0.04503249767873723;.\data\pcb_defects_kaggle\images/Spurious_copper/08_spurious_copper_02.jpg;6
2730;spurious_copper;1386;1141;1440;1256;.\data\pcb_defects_kaggle\Annotations\Spurious_copper\08_spurious_copper_03;0.5121420804639362;0.5564066852367688;54;115;2759;2154;0.019572308807538963;0.05338904363974002;.\data\pcb_defects_kaggle\images/Spurious_copper/08_spurious_copper_03.jpg;6
2731;spurious_copper;1987;734;2038;851;.\data\pcb_defects_kaggle\Annotations\Spurious_copper\08_spurious_copper_03;0.7294309532439289;0.36792014856081706;51;117;2759;2154;0.018484958318231243;0.054317548746518104;.\data\pcb_defects_kaggle\images/Spurious_copper/08_spurious_copper_03.jpg;6
2732;spurious_copper;2414;1274;2507;1331;.\data\pcb_defects_kaggle\Annotations\Spurious_copper\08_spurious_copper_03;0.8918086263138818;0.6046889507892294;93;57;2759;2154;0.033707865168539325;0.026462395543175487;.\data\pcb_defects_kaggle\images/Spurious_copper/08_spurious_copper_03.jpg;6
2733;spurious_copper;1250;1788;1371;1851;.\data\pcb_defects_kaggle\Annotations\Spurious_copper\08_spurious_copper_03;0.4749909387459224;0.8447075208913649;121;63;2759;2154;0.04385646973541138;0.02924791086350975;.\data\pcb_defects_kaggle\images/Spurious_copper/08_spurious_copper_03.jpg;6
2734;spurious_copper;2430;977;2484;1080;.\data\pcb_defects_kaggle\Annotations\Spurious_copper\08_spurious_copper_03;0.8905400507430228;0.4774837511606314;54;103;2759;2154;0.019572308807538963;0.04781801299907149;.\data\pcb_defects_kaggle\images/Spurious_copper/08_spurious_copper_03.jpg;6
2735;spurious_copper;1763;962;1896;1018;.\data\pcb_defects_kaggle\Annotations\Spurious_copper\08_spurious_copper_04;0.6631025733961581;0.4596100278551532;133;56;2759;2154;0.04820587169264226;0.025998142989786442;.\data\pcb_defects_kaggle\images/Spurious_copper/08_spurious_copper_04.jpg;6
2736;spurious_copper;2041;1051;2100;1138;.\data\pcb_defects_kaggle\Annotations\Spurious_copper\08_spurious_copper_04;0.7504530627038782;0.5081244196843082;59;87;2759;2154;0.02138455962305183;0.0403899721448468;.\data\pcb_defects_kaggle\images/Spurious_copper/08_spurious_copper_04.jpg;6
2737;spurious_copper;2564;1257;2650;1310;.\data\pcb_defects_kaggle\Annotations\Spurious_copper\08_spurious_copper_04;0.9449075752084088;0.5958681522748375;86;53;2759;2154;0.03117071402682131;0.02460538532961931;.\data\pcb_defects_kaggle\images/Spurious_copper/08_spurious_copper_04.jpg;6
2738;spurious_copper;2248;1454;2387;1510;.\data\pcb_defects_kaggle\Annotations\Spurious_copper\08_spurious_copper_04;0.8399782529902139;0.6880222841225627;139;56;2759;2154;0.0503805726712577;0.025998142989786442;.\data\pcb_defects_kaggle\images/Spurious_copper/08_spurious_copper_04.jpg;6
2739;spurious_copper;1150;997;1258;1047;.\data\pcb_defects_kaggle\Annotations\Spurious_copper\08_spurious_copper_04;0.43638999637549836;0.4744661095636026;108;50;2759;2154;0.039144617615077926;0.02321262766945218;.\data\pcb_defects_kaggle\images/Spurious_copper/08_spurious_copper_04.jpg;6
2740;spurious_copper;2033;713;2094;833;.\data\pcb_defects_kaggle\Annotations\Spurious_copper\08_spurious_copper_05;0.7479159115621602;0.35886722376973074;61;120;2759;2154;0.022109459949256977;0.055710306406685235;.\data\pcb_defects_kaggle\images/Spurious_copper/08_spurious_copper_05.jpg;6
2741;spurious_copper;2268;1306;2328;1410;.\data\pcb_defects_kaggle\Annotations\Spurious_copper\08_spurious_copper_05;0.8329104748097137;0.6304549675023212;60;104;2759;2154;0.021747009786154403;0.04828226555246054;.\data\pcb_defects_kaggle\images/Spurious_copper/08_spurious_copper_05.jpg;6
2742;spurious_copper;1396;1298;1523;1347;.\data\pcb_defects_kaggle\Annotations\Spurious_copper\08_spurious_copper_05;0.5289960130482059;0.6139740018570102;127;49;2759;2154;0.04603117071402682;0.02274837511606314;.\data\pcb_defects_kaggle\images/Spurious_copper/08_spurious_copper_05.jpg;6
2743;spurious_copper;787;892;835;977;.\data\pcb_defects_kaggle\Annotations\Spurious_copper\08_spurious_copper_05;0.29394708227618704;0.4338440111420613;48;85;2759;2154;0.017397607828923523;0.03946146703806871;.\data\pcb_defects_kaggle\images/Spurious_copper/08_spurious_copper_05.jpg;6
2744;spurious_copper;2581;1602;2623;1695;.\data\pcb_defects_kaggle\Annotations\Spurious_copper\08_spurious_copper_05;0.943095324392896;0.7653203342618384;42;93;2759;2154;0.015222906850308082;0.04317548746518106;.\data\pcb_defects_kaggle\images/Spurious_copper/08_spurious_copper_05.jpg;6
2745;spurious_copper;1625;906;1682;1010;.\data\pcb_defects_kaggle\Annotations\Spurious_copper\08_spurious_copper_06;0.5993113446901052;0.4447539461467038;57;104;2759;2154;0.020659659296846683;0.04828226555246054;.\data\pcb_defects_kaggle\images/Spurious_copper/08_spurious_copper_06.jpg;6
2746;spurious_copper;663;1225;763;1270;.\data\pcb_defects_kaggle\Annotations\Spurious_copper\08_spurious_copper_06;0.25842696629213485;0.5791550603528319;100;45;2759;2154;0.03624501631025734;0.020891364902506964;.\data\pcb_defects_kaggle\images/Spurious_copper/08_spurious_copper_06.jpg;6
2747;spurious_copper;292;1813;340;1902;.\data\pcb_defects_kaggle\Annotations\Spurious_copper\08_spurious_copper_06;0.11453425154041319;0.8623491179201486;48;89;2759;2154;0.017397607828923523;0.04131847725162489;.\data\pcb_defects_kaggle\images/Spurious_copper/08_spurious_copper_06.jpg;6
2748;spurious_copper;2402;1293;2441;1415;.\data\pcb_defects_kaggle\Annotations\Spurious_copper\08_spurious_copper_06;0.8776730699528815;0.6285979572887651;39;122;2759;2154;0.014135556361000362;0.056638811513463325;.\data\pcb_defects_kaggle\images/Spurious_copper/08_spurious_copper_06.jpg;6
2749;spurious_copper;1989;1425;2032;1508;.\data\pcb_defects_kaggle\Annotations\Spurious_copper\08_spurious_copper_06;0.7287060529177238;0.6808263695450325;43;83;2759;2154;0.015585357013410656;0.038532961931290625;.\data\pcb_defects_kaggle\images/Spurious_copper/08_spurious_copper_06.jpg;6
2750;spurious_copper;1628;915;1681;998;.\data\pcb_defects_kaggle\Annotations\Spurious_copper\08_spurious_copper_07;0.5996737948532077;0.4440575673166202;53;83;2759;2154;0.01920985864443639;0.038532961931290625;.\data\pcb_defects_kaggle\images/Spurious_copper/08_spurious_copper_07.jpg;6
2751;spurious_copper;2423;962;2481;1052;.\data\pcb_defects_kaggle\Annotations\Spurious_copper\08_spurious_copper_07;0.8887277999275099;0.4675023212627669;58;90;2759;2154;0.021022109459949256;0.04178272980501393;.\data\pcb_defects_kaggle\images/Spurious_copper/08_spurious_copper_07.jpg;6
2752;spurious_copper;1981;1180;2032;1270;.\data\pcb_defects_kaggle\Annotations\Spurious_copper\08_spurious_copper_07;0.7272562522653135;0.5687093779015785;51;90;2759;2154;0.018484958318231243;0.04178272980501393;.\data\pcb_defects_kaggle\images/Spurious_copper/08_spurious_copper_07.jpg;6
2753;spurious_copper;663;1211;774;1275;.\data\pcb_defects_kaggle\Annotations\Spurious_copper\08_spurious_copper_07;0.26042044218919896;0.5770659238625813;111;64;2759;2154;0.040231968104385646;0.029712163416898793;.\data\pcb_defects_kaggle\images/Spurious_copper/08_spurious_copper_07.jpg;6
2754;spurious_copper;1645;1800;1759;1856;.\data\pcb_defects_kaggle\Annotations\Spurious_copper\08_spurious_copper_07;0.61689017760058;0.8486536675951718;114;56;2759;2154;0.041319318593693366;0.025998142989786442;.\data\pcb_defects_kaggle\images/Spurious_copper/08_spurious_copper_07.jpg;6
2755;spurious_copper;2035;716;2099;818;.\data\pcb_defects_kaggle\Annotations\Spurious_copper\08_spurious_copper_08;0.7491844871330192;0.35608170844939646;64;102;2759;2154;0.023196810438564697;0.04735376044568245;.\data\pcb_defects_kaggle\images/Spurious_copper/08_spurious_copper_08.jpg;6
2756;spurious_copper;1625;910;1679;1010;.\data\pcb_defects_kaggle\Annotations\Spurious_copper\08_spurious_copper_08;0.5987676694454512;0.4456824512534819;54;100;2759;2154;0.019572308807538963;0.04642525533890436;.\data\pcb_defects_kaggle\images/Spurious_copper/08_spurious_copper_08.jpg;6
2757;spurious_copper;2268;1023;2328;1129;.\data\pcb_defects_kaggle\Annotations\Spurious_copper\08_spurious_copper_08;0.8329104748097137;0.49953574744661094;60;106;2759;2154;0.021747009786154403;0.04921077065923862;.\data\pcb_defects_kaggle\images/Spurious_copper/08_spurious_copper_08.jpg;6
2758;spurious_copper;1378;1105;1504;1167;.\data\pcb_defects_kaggle\Annotations\Spurious_copper\08_spurious_copper_08;0.5222906850308082;0.5273909006499535;126;62;2759;2154;0.04566872055092425;0.028783658310120707;.\data\pcb_defects_kaggle\images/Spurious_copper/08_spurious_copper_08.jpg;6
2759;spurious_copper;555;1259;671;1339;.\data\pcb_defects_kaggle\Annotations\Spurious_copper\08_spurious_copper_08;0.22218194998187749;0.6030640668523677;116;80;2759;2154;0.04204421891989851;0.03714020427112349;.\data\pcb_defects_kaggle\images/Spurious_copper/08_spurious_copper_08.jpg;6
2760;spurious_copper;2014;667;2102;725;.\data\pcb_defects_kaggle\Annotations\Spurious_copper\08_spurious_copper_09;0.7459224356650961;0.3231197771587744;88;58;2759;2154;0.03189561435302646;0.02692664809656453;.\data\pcb_defects_kaggle\images/Spurious_copper/08_spurious_copper_09.jpg;6
2761;spurious_copper;1743;1152;1794;1236;.\data\pcb_defects_kaggle\Annotations\Spurious_copper\08_spurious_copper_09;0.640993113446901;0.5543175487465181;51;84;2759;2154;0.018484958318231243;0.03899721448467967;.\data\pcb_defects_kaggle\images/Spurious_copper/08_spurious_copper_09.jpg;6
2762;spurious_copper;2035;1046;2099;1134;.\data\pcb_defects_kaggle\Annotations\Spurious_copper\08_spurious_copper_09;0.7491844871330192;0.5060352831940576;64;88;2759;2154;0.023196810438564697;0.04085422469823584;.\data\pcb_defects_kaggle\images/Spurious_copper/08_spurious_copper_09.jpg;6
2763;spurious_copper;1359;1798;1464;1846;.\data\pcb_defects_kaggle\Annotations\Spurious_copper\08_spurious_copper_09;0.5115984052192823;0.8458681522748375;105;48;2759;2154;0.038057267125770206;0.022284122562674095;.\data\pcb_defects_kaggle\images/Spurious_copper/08_spurious_copper_09.jpg;6
2764;spurious_copper;796;838;855;925;.\data\pcb_defects_kaggle\Annotations\Spurious_copper\08_spurious_copper_09;0.29920260964117434;0.40923862581244197;59;87;2759;2154;0.02138455962305183;0.0403899721448468;.\data\pcb_defects_kaggle\images/Spurious_copper/08_spurious_copper_09.jpg;6
2765;spurious_copper;2069;1052;2110;1129;.\data\pcb_defects_kaggle\Annotations\Spurious_copper\08_spurious_copper_10;0.7573396158028272;0.5062674094707521;41;77;2759;2154;0.014860456687205509;0.03574744661095636;.\data\pcb_defects_kaggle\images/Spurious_copper/08_spurious_copper_10.jpg;6
2766;spurious_copper;2294;1046;2333;1125;.\data\pcb_defects_kaggle\Annotations\Spurious_copper\08_spurious_copper_10;0.8385284523378036;0.5039461467038069;39;79;2759;2154;0.014135556361000362;0.03667595171773445;.\data\pcb_defects_kaggle\images/Spurious_copper/08_spurious_copper_10.jpg;6
2767;spurious_copper;2410;1275;2487;1320;.\data\pcb_defects_kaggle\Annotations\Spurious_copper\08_spurious_copper_10;0.8874592243566509;0.6023676880222841;77;45;2759;2154;0.02790866255889815;0.020891364902506964;.\data\pcb_defects_kaggle\images/Spurious_copper/08_spurious_copper_10.jpg;6
2768;spurious_copper;1604;1157;1645;1266;.\data\pcb_defects_kaggle\Annotations\Spurious_copper\08_spurious_copper_10;0.5888002899601305;0.5624419684308264;41;109;2759;2154;0.014860456687205509;0.050603528319405754;.\data\pcb_defects_kaggle\images/Spurious_copper/08_spurious_copper_10.jpg;6
2769;spurious_copper;863;1225;955;1269;.\data\pcb_defects_kaggle\Annotations\Spurious_copper\08_spurious_copper_10;0.32946719826023924;0.5789229340761374;92;44;2759;2154;0.03334541500543675;0.02042711234911792;.\data\pcb_defects_kaggle\images/Spurious_copper/08_spurious_copper_10.jpg;6
2770;spurious_copper;1294;1022;1417;1079;.\data\pcb_defects_kaggle\Annotations\Spurious_copper\09_spurious_copper_01;0.4884684684684685;0.48656785548865217;123;57;2775;2159;0.04432432432432432;0.026401111625752663;.\data\pcb_defects_kaggle\images/Spurious_copper/09_spurious_copper_01.jpg;6
2771;spurious_copper;2171;1035;2223;1138;.\data\pcb_defects_kaggle\Annotations\Spurious_copper\09_spurious_copper_01;0.7917117117117117;0.5032422417786012;52;103;2775;2159;0.018738738738738738;0.047707271885132005;.\data\pcb_defects_kaggle\images/Spurious_copper/09_spurious_copper_01.jpg;6
2772;spurious_copper;2525;815;2587;928;.\data\pcb_defects_kaggle\Annotations\Spurious_copper\09_spurious_copper_01;0.9210810810810811;0.40365910143584993;62;113;2775;2159;0.022342342342342343;0.0523390458545623;.\data\pcb_defects_kaggle\images/Spurious_copper/09_spurious_copper_01.jpg;6
2773;spurious_copper;1935;161;1979;258;.\data\pcb_defects_kaggle\Annotations\Spurious_copper\09_spurious_copper_01;0.7052252252252252;0.09703566465956462;44;97;2775;2159;0.015855855855855857;0.04492820750347383;.\data\pcb_defects_kaggle\images/Spurious_copper/09_spurious_copper_01.jpg;6
2774;spurious_copper;808;413;866;502;.\data\pcb_defects_kaggle\Annotations\Spurious_copper\09_spurious_copper_01;0.3016216216216216;0.21190365910143585;58;89;2775;2159;0.020900900900900903;0.041222788327929596;.\data\pcb_defects_kaggle\images/Spurious_copper/09_spurious_copper_01.jpg;6
2775;spurious_copper;1294;417;1348;500;.\data\pcb_defects_kaggle\Annotations\Spurious_copper\09_spurious_copper_02;0.47603603603603606;0.21236683649837887;54;83;2775;2159;0.01945945945945946;0.03844372394627142;.\data\pcb_defects_kaggle\images/Spurious_copper/09_spurious_copper_02.jpg;6
2776;spurious_copper;948;876;1071;927;.\data\pcb_defects_kaggle\Annotations\Spurious_copper\09_spurious_copper_02;0.3637837837837838;0.4175544233441408;123;51;2775;2159;0.04432432432432432;0.023622047244094488;.\data\pcb_defects_kaggle\images/Spurious_copper/09_spurious_copper_02.jpg;6
2777;spurious_copper;1851;1412;1905;1527;.\data\pcb_defects_kaggle\Annotations\Spurious_copper\09_spurious_copper_02;0.6767567567567567;0.6806391848077814;54;115;2775;2159;0.01945945945945946;0.053265400648448355;.\data\pcb_defects_kaggle\images/Spurious_copper/09_spurious_copper_02.jpg;6
2778;spurious_copper;627;1554;692;1617;.\data\pcb_defects_kaggle\Annotations\Spurious_copper\09_spurious_copper_02;0.23765765765765764;0.7343677628531727;65;63;2775;2159;0.023423423423423424;0.029180176007410838;.\data\pcb_defects_kaggle\images/Spurious_copper/09_spurious_copper_02.jpg;6
2779;spurious_copper;318;1653;423;1705;.\data\pcb_defects_kaggle\Annotations\Spurious_copper\09_spurious_copper_02;0.1335135135135135;0.777674849467346;105;52;2775;2159;0.03783783783783784;0.024085224641037517;.\data\pcb_defects_kaggle\images/Spurious_copper/09_spurious_copper_02.jpg;6
2780;spurious_copper;1381;423;1431;538;.\data\pcb_defects_kaggle\Annotations\Spurious_copper\09_spurious_copper_03;0.5066666666666667;0.2225567392311255;50;115;2775;2159;0.018018018018018018;0.053265400648448355;.\data\pcb_defects_kaggle\images/Spurious_copper/09_spurious_copper_03.jpg;6
2781;spurious_copper;1576;415;1635;525;.\data\pcb_defects_kaggle\Annotations\Spurious_copper\09_spurious_copper_03;0.5785585585585585;0.2176933765632237;59;110;2775;2159;0.021261261261261263;0.05094951366373321;.\data\pcb_defects_kaggle\images/Spurious_copper/09_spurious_copper_03.jpg;6
2782;spurious_copper;2543;802;2628;897;.\data\pcb_defects_kaggle\Annotations\Spurious_copper\09_spurious_copper_03;0.9317117117117117;0.39346919870310326;85;95;2775;2159;0.03063063063063063;0.04400185270958777;.\data\pcb_defects_kaggle\images/Spurious_copper/09_spurious_copper_03.jpg;6
2783;spurious_copper;1725;1186;1781;1295;.\data\pcb_defects_kaggle\Annotations\Spurious_copper\09_spurious_copper_03;0.6317117117117117;0.5745715609078277;56;109;2775;2159;0.02018018018018018;0.05048633626679018;.\data\pcb_defects_kaggle\images/Spurious_copper/09_spurious_copper_03.jpg;6
2784;spurious_copper;2284;508;2376;558;.\data\pcb_defects_kaggle\Annotations\Spurious_copper\09_spurious_copper_03;0.8396396396396396;0.24687355257063456;92;50;2775;2159;0.033153153153153155;0.02315886984715146;.\data\pcb_defects_kaggle\images/Spurious_copper/09_spurious_copper_03.jpg;6
2785;spurious_copper;1018;413;1072;508;.\data\pcb_defects_kaggle\Annotations\Spurious_copper\09_spurious_copper_04;0.37657657657657656;0.21329319129226493;54;95;2775;2159;0.01945945945945946;0.04400185270958777;.\data\pcb_defects_kaggle\images/Spurious_copper/09_spurious_copper_04.jpg;6
2786;spurious_copper;2543;918;2627;994;.\data\pcb_defects_kaggle\Annotations\Spurious_copper\09_spurious_copper_04;0.9315315315315316;0.4427975914775359;84;76;2775;2159;0.03027027027027027;0.03520148216767022;.\data\pcb_defects_kaggle\images/Spurious_copper/09_spurious_copper_04.jpg;6
2787;spurious_copper;1382;977;1530;1030;.\data\pcb_defects_kaggle\Annotations\Spurious_copper\09_spurious_copper_04;0.5246846846846847;0.4647985178323298;148;53;2775;2159;0.05333333333333334;0.024548402037980546;.\data\pcb_defects_kaggle\images/Spurious_copper/09_spurious_copper_04.jpg;6
2788;spurious_copper;2281;423;2381;472;.\data\pcb_defects_kaggle\Annotations\Spurious_copper\09_spurious_copper_04;0.84;0.20727188513200556;100;49;2775;2159;0.036036036036036036;0.02269569245020843;.\data\pcb_defects_kaggle\images/Spurious_copper/09_spurious_copper_04.jpg;6
2789;spurious_copper;559;741;618;874;.\data\pcb_defects_kaggle\Annotations\Spurious_copper\09_spurious_copper_04;0.21207207207207207;0.37401574803149606;59;133;2775;2159;0.021261261261261263;0.06160259379342288;.\data\pcb_defects_kaggle\images/Spurious_copper/09_spurious_copper_04.jpg;6
2790;spurious_copper;812;413;856;523;.\data\pcb_defects_kaggle\Annotations\Spurious_copper\09_spurious_copper_05;0.3005405405405405;0.21676702176933765;44;110;2775;2159;0.015855855855855857;0.05094951366373321;.\data\pcb_defects_kaggle\images/Spurious_copper/09_spurious_copper_05.jpg;6
2791;spurious_copper;564;720;608;841;.\data\pcb_defects_kaggle\Annotations\Spurious_copper\09_spurious_copper_05;0.21117117117117118;0.36150995831403426;44;121;2775;2159;0.015855855855855857;0.05604446503010653;.\data\pcb_defects_kaggle\images/Spurious_copper/09_spurious_copper_05.jpg;6
2792;spurious_copper;908;725;951;833;.\data\pcb_defects_kaggle\Annotations\Spurious_copper\09_spurious_copper_05;0.334954954954955;0.36081519221861974;43;108;2775;2159;0.015495495495495495;0.05002315886984715;.\data\pcb_defects_kaggle\images/Spurious_copper/09_spurious_copper_05.jpg;6
2793;spurious_copper;1858;1186;1904;1320;.\data\pcb_defects_kaggle\Annotations\Spurious_copper\09_spurious_copper_05;0.6778378378378378;0.5803612783696156;46;134;2775;2159;0.016576576576576577;0.06206577119036591;.\data\pcb_defects_kaggle\images/Spurious_copper/09_spurious_copper_05.jpg;6
2794;spurious_copper;1754;1610;1881;1658;.\data\pcb_defects_kaggle\Annotations\Spurious_copper\09_spurious_copper_05;0.6549549549549549;0.7568318666049096;127;48;2775;2159;0.04576576576576576;0.0222325150532654;.\data\pcb_defects_kaggle\images/Spurious_copper/09_spurious_copper_05.jpg;6
2795;spurious_copper;1597;425;1645;541;.\data\pcb_defects_kaggle\Annotations\Spurious_copper\09_spurious_copper_06;0.5841441441441442;0.2237146827234831;48;116;2775;2159;0.017297297297297298;0.053728578045391384;.\data\pcb_defects_kaggle\images/Spurious_copper/09_spurious_copper_06.jpg;6
2796;spurious_copper;879;423;927;528;.\data\pcb_defects_kaggle\Annotations\Spurious_copper\09_spurious_copper_06;0.3254054054054054;0.22024085224641038;48;105;2775;2159;0.017297297297297298;0.04863362667901806;.\data\pcb_defects_kaggle\images/Spurious_copper/09_spurious_copper_06.jpg;6
2797;spurious_copper;1092;702;1145;810;.\data\pcb_defects_kaggle\Annotations\Spurious_copper\09_spurious_copper_06;0.40306306306306305;0.35016211208893006;53;108;2775;2159;0.0190990990990991;0.05002315886984715;.\data\pcb_defects_kaggle\images/Spurious_copper/09_spurious_copper_06.jpg;6
2798;spurious_copper;851;981;972;1045;.\data\pcb_defects_kaggle\Annotations\Spurious_copper\09_spurious_copper_06;0.32846846846846844;0.46919870310328854;121;64;2775;2159;0.0436036036036036;0.029643353404353867;.\data\pcb_defects_kaggle\images/Spurious_copper/09_spurious_copper_06.jpg;6
2799;spurious_copper;2018;1059;2061;1186;.\data\pcb_defects_kaggle\Annotations\Spurious_copper\09_spurious_copper_06;0.734954954954955;0.5199166280685502;43;127;2775;2159;0.015495495495495495;0.058823529411764705;.\data\pcb_defects_kaggle\images/Spurious_copper/09_spurious_copper_06.jpg;6
2800;spurious_copper;1249;1512;1366;1564;.\data\pcb_defects_kaggle\Annotations\Spurious_copper\09_spurious_copper_06;0.4711711711711712;0.7123668364983788;117;52;2775;2159;0.04216216216216216;0.024085224641037517;.\data\pcb_defects_kaggle\images/Spurious_copper/09_spurious_copper_06.jpg;6
2801;spurious_copper;1436;433;1484;531;.\data\pcb_defects_kaggle\Annotations\Spurious_copper\09_spurious_copper_07;0.5261261261261261;0.22325150532654006;48;98;2775;2159;0.017297297297297298;0.04539138490041686;.\data\pcb_defects_kaggle\images/Spurious_copper/09_spurious_copper_07.jpg;6
2802;spurious_copper;743;710;790;815;.\data\pcb_defects_kaggle\Annotations\Spurious_copper\09_spurious_copper_07;0.2762162162162162;0.35317276516905977;47;105;2775;2159;0.016936936936936937;0.04863362667901806;.\data\pcb_defects_kaggle\images/Spurious_copper/09_spurious_copper_07.jpg;6
2803;spurious_copper;2095;989;2225;1048;.\data\pcb_defects_kaggle\Annotations\Spurious_copper\09_spurious_copper_07;0.7783783783783784;0.47174617878647523;130;59;2775;2159;0.04684684684684685;0.02732746641963872;.\data\pcb_defects_kaggle\images/Spurious_copper/09_spurious_copper_07.jpg;6
2804;spurious_copper;1922;1128;1979;1269;.\data\pcb_defects_kaggle\Annotations\Spurious_copper\09_spurious_copper_07;0.7028828828828829;0.5551181102362205;57;141;2775;2159;0.02054054054054054;0.06530801296896711;.\data\pcb_defects_kaggle\images/Spurious_copper/09_spurious_copper_07.jpg;6
2805;spurious_copper;1577;1202;1667;1253;.\data\pcb_defects_kaggle\Annotations\Spurious_copper\09_spurious_copper_07;0.5845045045045045;0.5685502547475684;90;51;2775;2159;0.032432432432432434;0.023622047244094488;.\data\pcb_defects_kaggle\images/Spurious_copper/09_spurious_copper_07.jpg;6
2806;spurious_copper;1159;827;1289;894;.\data\pcb_defects_kaggle\Annotations\Spurious_copper\09_spurious_copper_08;0.4410810810810811;0.3985641500694766;130;67;2775;2159;0.04684684684684685;0.031032885595182955;.\data\pcb_defects_kaggle\images/Spurious_copper/09_spurious_copper_08.jpg;6
2807;spurious_copper;1784;1204;1849;1327;.\data\pcb_defects_kaggle\Annotations\Spurious_copper\09_spurious_copper_08;0.6545945945945946;0.5861509958314034;65;123;2775;2159;0.023423423423423424;0.05697081982399259;.\data\pcb_defects_kaggle\images/Spurious_copper/09_spurious_copper_08.jpg;6
2808;spurious_copper;1522;922;1692;994;.\data\pcb_defects_kaggle\Annotations\Spurious_copper\09_spurious_copper_08;0.5790990990990991;0.443723946271422;170;72;2775;2159;0.06126126126126126;0.0333487725798981;.\data\pcb_defects_kaggle\images/Spurious_copper/09_spurious_copper_08.jpg;6
2809;spurious_copper;2256;1027;2364;1086;.\data\pcb_defects_kaggle\Annotations\Spurious_copper\09_spurious_copper_08;0.8324324324324325;0.4893469198703103;108;59;2775;2159;0.03891891891891892;0.02732746641963872;.\data\pcb_defects_kaggle\images/Spurious_copper/09_spurious_copper_08.jpg;6
2810;spurious_copper;1159;1113;1215;1179;.\data\pcb_defects_kaggle\Annotations\Spurious_copper\09_spurious_copper_08;0.42774774774774776;0.5308012968967114;56;66;2775;2159;0.02018018018018018;0.030569708198239925;.\data\pcb_defects_kaggle\images/Spurious_copper/09_spurious_copper_08.jpg;6
2811;spurious_copper;1077;536;1189;625;.\data\pcb_defects_kaggle\Annotations\Spurious_copper\09_spurious_copper_09;0.4082882882882883;0.26887447892542843;112;89;2775;2159;0.04036036036036036;0.041222788327929596;.\data\pcb_defects_kaggle\images/Spurious_copper/09_spurious_copper_09.jpg;6
2812;spurious_copper;1584;425;1653;543;.\data\pcb_defects_kaggle\Annotations\Spurious_copper\09_spurious_copper_09;0.5832432432432433;0.22417786012042612;69;118;2775;2159;0.024864864864864864;0.05465493283927744;.\data\pcb_defects_kaggle\images/Spurious_copper/09_spurious_copper_09.jpg;6
2813;spurious_copper;1100;1110;1146;1181;.\data\pcb_defects_kaggle\Annotations\Spurious_copper\09_spurious_copper_09;0.40468468468468466;0.5305697081982399;46;71;2775;2159;0.016576576576576577;0.03288559518295507;.\data\pcb_defects_kaggle\images/Spurious_copper/09_spurious_copper_09.jpg;6
2814;spurious_copper;2533;799;2617;890;.\data\pcb_defects_kaggle\Annotations\Spurious_copper\09_spurious_copper_09;0.9279279279279279;0.39115331171838813;84;91;2775;2159;0.03027027027027027;0.042149143121815655;.\data\pcb_defects_kaggle\images/Spurious_copper/09_spurious_copper_09.jpg;6
2815;spurious_copper;681;405;730;502;.\data\pcb_defects_kaggle\Annotations\Spurious_copper\09_spurious_copper_09;0.25423423423423425;0.21005094951366374;49;97;2775;2159;0.017657657657657658;0.04492820750347383;.\data\pcb_defects_kaggle\images/Spurious_copper/09_spurious_copper_09.jpg;6
2816;spurious_copper;2004;1038;2069;1148;.\data\pcb_defects_kaggle\Annotations\Spurious_copper\09_spurious_copper_10;0.7338738738738739;0.5062528948587309;65;110;2775;2159;0.023423423423423424;0.05094951366373321;.\data\pcb_defects_kaggle\images/Spurious_copper/09_spurious_copper_10.jpg;6
2817;spurious_copper;1927;1405;1971;1482;.\data\pcb_defects_kaggle\Annotations\Spurious_copper\09_spurious_copper_10;0.7023423423423424;0.6685965724872627;44;77;2775;2159;0.015855855855855857;0.035664659564613246;.\data\pcb_defects_kaggle\images/Spurious_copper/09_spurious_copper_10.jpg;6
2818;spurious_copper;1777;1446;1835;1541;.\data\pcb_defects_kaggle\Annotations\Spurious_copper\09_spurious_copper_10;0.6508108108108108;0.6917554423344141;58;95;2775;2159;0.020900900900900903;0.04400185270958777;.\data\pcb_defects_kaggle\images/Spurious_copper/09_spurious_copper_10.jpg;6
2819;spurious_copper;1313;1310;1405;1371;.\data\pcb_defects_kaggle\Annotations\Spurious_copper\09_spurious_copper_10;0.4897297297297297;0.6208893006021307;92;61;2775;2159;0.033153153153153155;0.02825382121352478;.\data\pcb_defects_kaggle\images/Spurious_copper/09_spurious_copper_10.jpg;6
2820;spurious_copper;776;1548;877;1617;.\data\pcb_defects_kaggle\Annotations\Spurious_copper\09_spurious_copper_10;0.29783783783783785;0.7329782306623437;101;69;2775;2159;0.0363963963963964;0.03195924038906901;.\data\pcb_defects_kaggle\images/Spurious_copper/09_spurious_copper_10.jpg;6
2821;spurious_copper;1832;460;1930;519;.\data\pcb_defects_kaggle\Annotations\Spurious_copper\10_spurious_copper_01;0.8397321428571428;0.24280753968253968;98;59;2240;2016;0.04375;0.029265873015873016;.\data\pcb_defects_kaggle\images/Spurious_copper/10_spurious_copper_01.jpg;6
2822;spurious_copper;1229;861;1290;974;.\data\pcb_defects_kaggle\Annotations\Spurious_copper\10_spurious_copper_01;0.5622767857142857;0.455109126984127;61;113;2240;2016;0.027232142857142858;0.056051587301587304;.\data\pcb_defects_kaggle\images/Spurious_copper/10_spurious_copper_01.jpg;6
2823;spurious_copper;910;1403;962;1508;.\data\pcb_defects_kaggle\Annotations\Spurious_copper\10_spurious_copper_01;0.41785714285714287;0.7219742063492064;52;105;2240;2016;0.023214285714285715;0.052083333333333336;.\data\pcb_defects_kaggle\images/Spurious_copper/10_spurious_copper_01.jpg;6
2824;spurious_copper;1181;1512;1301;1569;.\data\pcb_defects_kaggle\Annotations\Spurious_copper\10_spurious_copper_01;0.5540178571428571;0.7641369047619048;120;57;2240;2016;0.05357142857142857;0.028273809523809524;.\data\pcb_defects_kaggle\images/Spurious_copper/10_spurious_copper_01.jpg;6
2825;spurious_copper;1469;1266;1526;1385;.\data\pcb_defects_kaggle\Annotations\Spurious_copper\10_spurious_copper_01;0.6685267857142857;0.6574900793650794;57;119;2240;2016;0.02544642857142857;0.059027777777777776;.\data\pcb_defects_kaggle\images/Spurious_copper/10_spurious_copper_01.jpg;6
2826;spurious_copper;1492;573;1556;666;.\data\pcb_defects_kaggle\Annotations\Spurious_copper\10_spurious_copper_02;0.6803571428571429;0.3072916666666667;64;93;2240;2016;0.02857142857142857;0.046130952380952384;.\data\pcb_defects_kaggle\images/Spurious_copper/10_spurious_copper_02.jpg;6
2827;spurious_copper;1397;160;1526;219;.\data\pcb_defects_kaggle\Annotations\Spurious_copper\10_spurious_copper_02;0.6524553571428572;0.09399801587301587;129;59;2240;2016;0.05758928571428571;0.029265873015873016;.\data\pcb_defects_kaggle\images/Spurious_copper/10_spurious_copper_02.jpg;6
2828;spurious_copper;1075;1016;1124;1127;.\data\pcb_defects_kaggle\Annotations\Spurious_copper\10_spurious_copper_02;0.4908482142857143;0.5314980158730159;49;111;2240;2016;0.021875;0.05505952380952381;.\data\pcb_defects_kaggle\images/Spurious_copper/10_spurious_copper_02.jpg;6
2829;spurious_copper;1543;922;1652;973;.\data\pcb_defects_kaggle\Annotations\Spurious_copper\10_spurious_copper_02;0.7131696428571429;0.46999007936507936;109;51;2240;2016;0.048660714285714286;0.025297619047619048;.\data\pcb_defects_kaggle\images/Spurious_copper/10_spurious_copper_02.jpg;6
2830;spurious_copper;948;402;991;499;.\data\pcb_defects_kaggle\Annotations\Spurious_copper\10_spurious_copper_02;0.4328125;0.2234623015873016;43;97;2240;2016;0.019196428571428573;0.04811507936507937;.\data\pcb_defects_kaggle\images/Spurious_copper/10_spurious_copper_02.jpg;6
2831;spurious_copper;1595;585;1640;669;.\data\pcb_defects_kaggle\Annotations\Spurious_copper\10_spurious_copper_03;0.7220982142857143;0.31101190476190477;45;84;2240;2016;0.020089285714285716;0.041666666666666664;.\data\pcb_defects_kaggle\images/Spurious_copper/10_spurious_copper_03.jpg;6
2832;spurious_copper;1719;1032;1774;1121;.\data\pcb_defects_kaggle\Annotations\Spurious_copper\10_spurious_copper_03;0.7796875;0.5339781746031746;55;89;2240;2016;0.024553571428571428;0.0441468253968254;.\data\pcb_defects_kaggle\images/Spurious_copper/10_spurious_copper_03.jpg;6
2833;spurious_copper;1152;754;1223;832;.\data\pcb_defects_kaggle\Annotations\Spurious_copper\10_spurious_copper_03;0.5301339285714286;0.3933531746031746;71;78;2240;2016;0.03169642857142857;0.03869047619047619;.\data\pcb_defects_kaggle\images/Spurious_copper/10_spurious_copper_03.jpg;6
2834;spurious_copper;1197;1695;1316;1747;.\data\pcb_defects_kaggle\Annotations\Spurious_copper\10_spurious_copper_03;0.5609375;0.8536706349206349;119;52;2240;2016;0.053125;0.025793650793650792;.\data\pcb_defects_kaggle\images/Spurious_copper/10_spurious_copper_03.jpg;6
2835;spurious_copper;716;821;808;890;.\data\pcb_defects_kaggle\Annotations\Spurious_copper\10_spurious_copper_03;0.34017857142857144;0.4243551587301587;92;69;2240;2016;0.04107142857142857;0.03422619047619048;.\data\pcb_defects_kaggle\images/Spurious_copper/10_spurious_copper_03.jpg;6
2836;spurious_copper;1272;557;1316;641;.\data\pcb_defects_kaggle\Annotations\Spurious_copper\10_spurious_copper_04;0.5776785714285714;0.29712301587301587;44;84;2240;2016;0.019642857142857142;0.041666666666666664;.\data\pcb_defects_kaggle\images/Spurious_copper/10_spurious_copper_04.jpg;6
2837;spurious_copper;1246;231;1355;279;.\data\pcb_defects_kaggle\Annotations\Spurious_copper\10_spurious_copper_04;0.5805803571428572;0.12648809523809523;109;48;2240;2016;0.048660714285714286;0.023809523809523808;.\data\pcb_defects_kaggle\images/Spurious_copper/10_spurious_copper_04.jpg;6
2838;spurious_copper;1636;1050;1679;1137;.\data\pcb_defects_kaggle\Annotations\Spurious_copper\10_spurious_copper_04;0.7399553571428571;0.5424107142857143;43;87;2240;2016;0.019196428571428573;0.043154761904761904;.\data\pcb_defects_kaggle\images/Spurious_copper/10_spurious_copper_04.jpg;6
2839;spurious_copper;1868;996;1921;1071;.\data\pcb_defects_kaggle\Annotations\Spurious_copper\10_spurious_copper_04;0.8457589285714285;0.5126488095238095;53;75;2240;2016;0.023660714285714285;0.03720238095238095;.\data\pcb_defects_kaggle\images/Spurious_copper/10_spurious_copper_04.jpg;6
2840;spurious_copper;1978;1419;2017;1493;.\data\pcb_defects_kaggle\Annotations\Spurious_copper\10_spurious_copper_04;0.8917410714285714;0.7222222222222222;39;74;2240;2016;0.017410714285714286;0.03670634920634921;.\data\pcb_defects_kaggle\images/Spurious_copper/10_spurious_copper_04.jpg;6
2841;spurious_copper;1142;389;1236;435;.\data\pcb_defects_kaggle\Annotations\Spurious_copper\10_spurious_copper_05;0.5308035714285714;0.20436507936507936;94;46;2240;2016;0.04196428571428571;0.022817460317460316;.\data\pcb_defects_kaggle\images/Spurious_copper/10_spurious_copper_05.jpg;6
2842;spurious_copper;1434;834;1519;880;.\data\pcb_defects_kaggle\Annotations\Spurious_copper\10_spurious_copper_05;0.6591517857142857;0.42509920634920634;85;46;2240;2016;0.03794642857142857;0.022817460317460316;.\data\pcb_defects_kaggle\images/Spurious_copper/10_spurious_copper_05.jpg;6
2843;spurious_copper;1719;1022;1759;1121;.\data\pcb_defects_kaggle\Annotations\Spurious_copper\10_spurious_copper_05;0.7763392857142857;0.5314980158730159;40;99;2240;2016;0.017857142857142856;0.049107142857142856;.\data\pcb_defects_kaggle\images/Spurious_copper/10_spurious_copper_05.jpg;6
2844;spurious_copper;907;771;1010;821;.\data\pcb_defects_kaggle\Annotations\Spurious_copper\10_spurious_copper_05;0.4279017857142857;0.3948412698412698;103;50;2240;2016;0.04598214285714286;0.0248015873015873;.\data\pcb_defects_kaggle\images/Spurious_copper/10_spurious_copper_05.jpg;6
2845;spurious_copper;1237;874;1291;992;.\data\pcb_defects_kaggle\Annotations\Spurious_copper\10_spurious_copper_05;0.5642857142857143;0.46279761904761907;54;118;2240;2016;0.024107142857142858;0.05853174603174603;.\data\pcb_defects_kaggle\images/Spurious_copper/10_spurious_copper_05.jpg;6
2846;spurious_copper;1365;1293;1414;1377;.\data\pcb_defects_kaggle\Annotations\Spurious_copper\10_spurious_copper_05;0.6203125;0.6622023809523809;49;84;2240;2016;0.021875;0.041666666666666664;.\data\pcb_defects_kaggle\images/Spurious_copper/10_spurious_copper_05.jpg;6
2847;spurious_copper;1527;993;1633;1054;.\data\pcb_defects_kaggle\Annotations\Spurious_copper\10_spurious_copper_06;0.7053571428571429;0.5076884920634921;106;61;2240;2016;0.04732142857142857;0.030257936507936508;.\data\pcb_defects_kaggle\images/Spurious_copper/10_spurious_copper_06.jpg;6
2848;spurious_copper;1769;1005;1820;1071;.\data\pcb_defects_kaggle\Annotations\Spurious_copper\10_spurious_copper_06;0.8011160714285714;0.5148809523809523;51;66;2240;2016;0.022767857142857142;0.03273809523809524;.\data\pcb_defects_kaggle\images/Spurious_copper/10_spurious_copper_06.jpg;6
2849;spurious_copper;1968;999;2024;1070;.\data\pcb_defects_kaggle\Annotations\Spurious_copper\10_spurious_copper_06;0.8910714285714286;0.5131448412698413;56;71;2240;2016;0.025;0.03521825396825397;.\data\pcb_defects_kaggle\images/Spurious_copper/10_spurious_copper_06.jpg;6
2850;spurious_copper;1072;1015;1124;1108;.\data\pcb_defects_kaggle\Annotations\Spurious_copper\10_spurious_copper_06;0.4901785714285714;0.5265376984126984;52;93;2240;2016;0.023214285714285715;0.046130952380952384;.\data\pcb_defects_kaggle\images/Spurious_copper/10_spurious_copper_06.jpg;6
2851;spurious_copper;1471;1244;1514;1353;.\data\pcb_defects_kaggle\Annotations\Spurious_copper\10_spurious_copper_06;0.6662946428571429;0.6440972222222222;43;109;2240;2016;0.019196428571428573;0.05406746031746032;.\data\pcb_defects_kaggle\images/Spurious_copper/10_spurious_copper_06.jpg;6
2852;spurious_copper;904;350;958;434;.\data\pcb_defects_kaggle\Annotations\Spurious_copper\11_spurious_copper_01;0.40797546012269936;0.17437722419928825;54;84;2282;2248;0.02366345311130587;0.037366548042704624;.\data\pcb_defects_kaggle\images/Spurious_copper/11_spurious_copper_01.jpg;6
2853;spurious_copper;1117;642;1163;739;.\data\pcb_defects_kaggle\Annotations\Spurious_copper\11_spurious_copper_01;0.49956178790534617;0.30716192170818507;46;97;2282;2248;0.020157756354075372;0.04314946619217082;.\data\pcb_defects_kaggle\images/Spurious_copper/11_spurious_copper_01.jpg;6
2854;spurious_copper;1222;1088;1296;1131;.\data\pcb_defects_kaggle\Annotations\Spurious_copper\11_spurious_copper_01;0.5517090271691498;0.49354982206405695;74;43;2282;2248;0.03242769500438212;0.01912811387900356;.\data\pcb_defects_kaggle\images/Spurious_copper/11_spurious_copper_01.jpg;6
2855;spurious_copper;1170;1422;1206;1494;.\data\pcb_defects_kaggle\Annotations\Spurious_copper\11_spurious_copper_01;0.5205959684487291;0.6485765124555161;36;72;2282;2248;0.015775635407537247;0.03202846975088968;.\data\pcb_defects_kaggle\images/Spurious_copper/11_spurious_copper_01.jpg;6
2856;spurious_copper;827;1363;883;1411;.\data\pcb_defects_kaggle\Annotations\Spurious_copper\11_spurious_copper_01;0.37467134092900967;0.6169928825622776;56;48;2282;2248;0.024539877300613498;0.021352313167259787;.\data\pcb_defects_kaggle\images/Spurious_copper/11_spurious_copper_01.jpg;6
2857;spurious_copper;755;840;832;888;.\data\pcb_defects_kaggle\Annotations\Spurious_copper\11_spurious_copper_02;0.3477212971078002;0.38434163701067614;77;48;2282;2248;0.03374233128834356;0.021352313167259787;.\data\pcb_defects_kaggle\images/Spurious_copper/11_spurious_copper_02.jpg;6
2858;spurious_copper;547;850;620;906;.\data\pcb_defects_kaggle\Annotations\Spurious_copper\11_spurious_copper_02;0.25569675723049956;0.3905693950177936;73;56;2282;2248;0.031989482909728306;0.02491103202846975;.\data\pcb_defects_kaggle\images/Spurious_copper/11_spurious_copper_02.jpg;6
2859;spurious_copper;501;1381;545;1472;.\data\pcb_defects_kaggle\Annotations\Spurious_copper\11_spurious_copper_02;0.2291849255039439;0.6345640569395018;44;91;2282;2248;0.019281332164767746;0.04048042704626335;.\data\pcb_defects_kaggle\images/Spurious_copper/11_spurious_copper_02.jpg;6
2860;spurious_copper;711;1591;788;1681;.\data\pcb_defects_kaggle\Annotations\Spurious_copper\11_spurious_copper_02;0.3284399649430324;0.7277580071174378;77;90;2282;2248;0.03374233128834356;0.0400355871886121;.\data\pcb_defects_kaggle\images/Spurious_copper/11_spurious_copper_02.jpg;6
2861;spurious_copper;1411;1606;1458;1699;.\data\pcb_defects_kaggle\Annotations\Spurious_copper\11_spurious_copper_02;0.628615249780894;0.7350978647686833;47;93;2282;2248;0.020595968448729185;0.041370106761565835;.\data\pcb_defects_kaggle\images/Spurious_copper/11_spurious_copper_02.jpg;6
2862;spurious_copper;640;604;719;670;.\data\pcb_defects_kaggle\Annotations\Spurious_copper\11_spurious_copper_03;0.29776511831726554;0.2833629893238434;79;66;2282;2248;0.034618755477651184;0.029359430604982206;.\data\pcb_defects_kaggle\images/Spurious_copper/11_spurious_copper_03.jpg;6
2863;spurious_copper;414;1311;463;1424;.\data\pcb_defects_kaggle\Annotations\Spurious_copper\11_spurious_copper_03;0.19215600350569675;0.6083185053380783;49;113;2282;2248;0.02147239263803681;0.050266903914590745;.\data\pcb_defects_kaggle\images/Spurious_copper/11_spurious_copper_03.jpg;6
2864;spurious_copper;1424;1160;1488;1234;.\data\pcb_defects_kaggle\Annotations\Spurious_copper\11_spurious_copper_03;0.6380368098159509;0.5324733096085409;64;74;2282;2248;0.028045574057843997;0.03291814946619217;.\data\pcb_defects_kaggle\images/Spurious_copper/11_spurious_copper_03.jpg;6
2865;spurious_copper;1463;1565;1520;1655;.\data\pcb_defects_kaggle\Annotations\Spurious_copper\11_spurious_copper_03;0.6535933391761612;0.7161921708185054;57;90;2282;2248;0.02497808939526731;0.0400355871886121;.\data\pcb_defects_kaggle\images/Spurious_copper/11_spurious_copper_03.jpg;6
2866;spurious_copper;1739;1613;1820;1670;.\data\pcb_defects_kaggle\Annotations\Spurious_copper\11_spurious_copper_03;0.7797984224364592;0.7302046263345195;81;57;2282;2248;0.03549517966695881;0.025355871886120998;.\data\pcb_defects_kaggle\images/Spurious_copper/11_spurious_copper_03.jpg;6
2867;spurious_copper;1109;678;1161;778;.\data\pcb_defects_kaggle\Annotations\Spurious_copper\11_spurious_copper_04;0.4973707274320771;0.3238434163701068;52;100;2282;2248;0.022787028921998246;0.04448398576512456;.\data\pcb_defects_kaggle\images/Spurious_copper/11_spurious_copper_04.jpg;6
2868;spurious_copper;773;642;891;691;.\data\pcb_defects_kaggle\Annotations\Spurious_copper\11_spurious_copper_04;0.36459246275197194;0.29648576512455516;118;49;2282;2248;0.051709027169149865;0.02179715302491103;.\data\pcb_defects_kaggle\images/Spurious_copper/11_spurious_copper_04.jpg;6
2869;spurious_copper;1407;873;1452;965;.\data\pcb_defects_kaggle\Annotations\Spurious_copper\11_spurious_copper_04;0.6264241893076249;0.40880782918149466;45;92;2282;2248;0.01971954425942156;0.04092526690391459;.\data\pcb_defects_kaggle\images/Spurious_copper/11_spurious_copper_04.jpg;6
2870;spurious_copper;1184;1222;1286;1268;.\data\pcb_defects_kaggle\Annotations\Spurious_copper\11_spurious_copper_04;0.5411919368974584;0.5538256227758007;102;46;2282;2248;0.044697633654688866;0.020462633451957295;.\data\pcb_defects_kaggle\images/Spurious_copper/11_spurious_copper_04.jpg;6
2871;spurious_copper;1804;1839;1858;1926;.\data\pcb_defects_kaggle\Annotations\Spurious_copper\11_spurious_copper_04;0.8023663453111306;0.8374110320284698;54;87;2282;2248;0.02366345311130587;0.03870106761565836;.\data\pcb_defects_kaggle\images/Spurious_copper/11_spurious_copper_04.jpg;6
2872;spurious_copper;812;152;916;211;.\data\pcb_defects_kaggle\Annotations\Spurious_copper\11_spurious_copper_05;0.37861524978089395;0.08073843416370106;104;59;2282;2248;0.04557405784399649;0.026245551601423486;.\data\pcb_defects_kaggle\images/Spurious_copper/11_spurious_copper_05.jpg;6
2873;spurious_copper;1389;344;1468;431;.\data\pcb_defects_kaggle\Annotations\Spurious_copper\11_spurious_copper_05;0.6259859772129711;0.17237544483985764;79;87;2282;2248;0.034618755477651184;0.03870106761565836;.\data\pcb_defects_kaggle\images/Spurious_copper/11_spurious_copper_05.jpg;6
2874;spurious_copper;798;1042;894;1096;.\data\pcb_defects_kaggle\Annotations\Spurious_copper\11_spurious_copper_05;0.37072743207712533;0.4755338078291815;96;54;2282;2248;0.042068361086765996;0.02402135231316726;.\data\pcb_defects_kaggle\images/Spurious_copper/11_spurious_copper_05.jpg;6
2875;spurious_copper;1155;1088;1266;1132;.\data\pcb_defects_kaggle\Annotations\Spurious_copper\11_spurious_copper_05;0.5304557405784399;0.49377224199288255;111;44;2282;2248;0.04864154250657318;0.019572953736654804;.\data\pcb_defects_kaggle\images/Spurious_copper/11_spurious_copper_05.jpg;6
2876;spurious_copper;1371;1204;1445;1275;.\data\pcb_defects_kaggle\Annotations\Spurious_copper\11_spurious_copper_05;0.6170026292725679;0.5513790035587188;74;71;2282;2248;0.03242769500438212;0.03158362989323844;.\data\pcb_defects_kaggle\images/Spurious_copper/11_spurious_copper_05.jpg;6
2877;spurious_copper;1089;342;1158;413;.\data\pcb_defects_kaggle\Annotations\Spurious_copper\11_spurious_copper_06;0.49233128834355827;0.1679270462633452;69;71;2282;2248;0.030236634531113058;0.03158362989323844;.\data\pcb_defects_kaggle\images/Spurious_copper/11_spurious_copper_06.jpg;6
2878;spurious_copper;1314;375;1376;452;.\data\pcb_defects_kaggle\Annotations\Spurious_copper\11_spurious_copper_06;0.5893952673093777;0.18394128113879005;62;77;2282;2248;0.02716914986853637;0.03425266903914591;.\data\pcb_defects_kaggle\images/Spurious_copper/11_spurious_copper_06.jpg;6
2879;spurious_copper;1634;757;1686;870;.\data\pcb_defects_kaggle\Annotations\Spurious_copper\11_spurious_copper_06;0.7274320771253286;0.36187722419928825;52;113;2282;2248;0.022787028921998246;0.050266903914590745;.\data\pcb_defects_kaggle\images/Spurious_copper/11_spurious_copper_06.jpg;6
2880;spurious_copper;752;1185;863;1237;.\data\pcb_defects_kaggle\Annotations\Spurious_copper\11_spurious_copper_06;0.35385626643295354;0.5387010676156584;111;52;2282;2248;0.04864154250657318;0.023131672597864767;.\data\pcb_defects_kaggle\images/Spurious_copper/11_spurious_copper_06.jpg;6
2881;spurious_copper;1806;1942;1907;2022;.\data\pcb_defects_kaggle\Annotations\Spurious_copper\11_spurious_copper_06;0.8135407537248028;0.8816725978647687;101;80;2282;2248;0.04425942156003506;0.03558718861209965;.\data\pcb_defects_kaggle\images/Spurious_copper/11_spurious_copper_06.jpg;6
2882;spurious_copper;709;547;771;614;.\data\pcb_defects_kaggle\Annotations\Spurious_copper\11_spurious_copper_07;0.32427695004382123;0.258229537366548;62;67;2282;2248;0.02716914986853637;0.029804270462633453;.\data\pcb_defects_kaggle\images/Spurious_copper/11_spurious_copper_07.jpg;6
2883;spurious_copper;1453;540;1547;629;.\data\pcb_defects_kaggle\Annotations\Spurious_copper\11_spurious_copper_07;0.6573181419807187;0.260008896797153;94;89;2282;2248;0.04119193689745837;0.03959074733096085;.\data\pcb_defects_kaggle\images/Spurious_copper/11_spurious_copper_07.jpg;6
2884;spurious_copper;1163;842;1235;921;.\data\pcb_defects_kaggle\Annotations\Spurious_copper\11_spurious_copper_07;0.5254163014899211;0.39212633451957296;72;79;2282;2248;0.03155127081507449;0.035142348754448396;.\data\pcb_defects_kaggle\images/Spurious_copper/11_spurious_copper_07.jpg;6
2885;spurious_copper;455;788;557;844;.\data\pcb_defects_kaggle\Annotations\Spurious_copper\11_spurious_copper_07;0.22173531989482909;0.36298932384341637;102;56;2282;2248;0.044697633654688866;0.02491103202846975;.\data\pcb_defects_kaggle\images/Spurious_copper/11_spurious_copper_07.jpg;6
2886;spurious_copper;953;1372;1035;1494;.\data\pcb_defects_kaggle\Annotations\Spurious_copper\11_spurious_copper_07;0.43558282208588955;0.6374555160142349;82;122;2282;2248;0.03593339176161262;0.054270462633451956;.\data\pcb_defects_kaggle\images/Spurious_copper/11_spurious_copper_07.jpg;6
2887;spurious_copper;491;231;640;340;.\data\pcb_defects_kaggle\Annotations\Spurious_copper\11_spurious_copper_08;0.24780893952673094;0.1270017793594306;149;109;2282;2248;0.06529360210341806;0.04848754448398576;.\data\pcb_defects_kaggle\images/Spurious_copper/11_spurious_copper_08.jpg;6
2888;spurious_copper;1034;124;1117;209;.\data\pcb_defects_kaggle\Annotations\Spurious_copper\11_spurious_copper_08;0.4712971078001753;0.07406583629893239;83;85;2282;2248;0.036371603856266435;0.037811387900355875;.\data\pcb_defects_kaggle\images/Spurious_copper/11_spurious_copper_08.jpg;6
2889;spurious_copper;350;906;424;1050;.\data\pcb_defects_kaggle\Annotations\Spurious_copper\11_spurious_copper_08;0.16958808063102543;0.43505338078291816;74;144;2282;2248;0.03242769500438212;0.06405693950177936;.\data\pcb_defects_kaggle\images/Spurious_copper/11_spurious_copper_08.jpg;6
2890;spurious_copper;647;1150;737;1235;.\data\pcb_defects_kaggle\Annotations\Spurious_copper\11_spurious_copper_08;0.3032427695004382;0.5304715302491103;90;85;2282;2248;0.03943908851884312;0.037811387900355875;.\data\pcb_defects_kaggle\images/Spurious_copper/11_spurious_copper_08.jpg;6
2891;spurious_copper;466;1363;525;1503;.\data\pcb_defects_kaggle\Annotations\Spurious_copper\11_spurious_copper_08;0.21713409290096405;0.6374555160142349;59;140;2282;2248;0.025854513584574933;0.06227758007117438;.\data\pcb_defects_kaggle\images/Spurious_copper/11_spurious_copper_08.jpg;6
2892;spurious_copper;776;581;902;631;.\data\pcb_defects_kaggle\Annotations\Spurious_copper\11_spurious_copper_09;0.36765994741454866;0.2695729537366548;126;50;2282;2248;0.05521472392638037;0.02224199288256228;.\data\pcb_defects_kaggle\images/Spurious_copper/11_spurious_copper_09.jpg;6
2893;spurious_copper;1407;867;1457;958;.\data\pcb_defects_kaggle\Annotations\Spurious_copper\11_spurious_copper_09;0.6275197195442594;0.40591637010676157;50;91;2282;2248;0.021910604732690624;0.04048042704626335;.\data\pcb_defects_kaggle\images/Spurious_copper/11_spurious_copper_09.jpg;6
2894;spurious_copper;870;862;932;926;.\data\pcb_defects_kaggle\Annotations\Spurious_copper\11_spurious_copper_09;0.394829097283085;0.39768683274021355;62;64;2282;2248;0.02716914986853637;0.028469750889679714;.\data\pcb_defects_kaggle\images/Spurious_copper/11_spurious_copper_09.jpg;6
2895;spurious_copper;1402;1594;1463;1694;.\data\pcb_defects_kaggle\Annotations\Spurious_copper\11_spurious_copper_09;0.6277388255915863;0.7313167259786477;61;100;2282;2248;0.02673093777388256;0.04448398576512456;.\data\pcb_defects_kaggle\images/Spurious_copper/11_spurious_copper_09.jpg;6
2896;spurious_copper;1125;1686;1209;1758;.\data\pcb_defects_kaggle\Annotations\Spurious_copper\11_spurious_copper_09;0.5113935144609991;0.7660142348754448;84;72;2282;2248;0.03680981595092025;0.03202846975088968;.\data\pcb_defects_kaggle\images/Spurious_copper/11_spurious_copper_09.jpg;6
2897;spurious_copper;925;2045;1068;2106;.\data\pcb_defects_kaggle\Annotations\Spurious_copper\11_spurious_copper_09;0.4366783523225241;0.9232651245551602;143;61;2282;2248;0.06266432953549518;0.027135231316725978;.\data\pcb_defects_kaggle\images/Spurious_copper/11_spurious_copper_09.jpg;6
2898;spurious_copper;757;1181;858;1234;.\data\pcb_defects_kaggle\Annotations\Spurious_copper\11_spurious_copper_10;0.35385626643295354;0.537144128113879;101;53;2282;2248;0.04425942156003506;0.023576512455516015;.\data\pcb_defects_kaggle\images/Spurious_copper/11_spurious_copper_10.jpg;6
2899;spurious_copper;1058;1465;1106;1578;.\data\pcb_defects_kaggle\Annotations\Spurious_copper\11_spurious_copper_10;0.4741454864154251;0.6768238434163701;48;113;2282;2248;0.021034180543382998;0.050266903914590745;.\data\pcb_defects_kaggle\images/Spurious_copper/11_spurious_copper_10.jpg;6
2900;spurious_copper;673;1632;760;1726;.\data\pcb_defects_kaggle\Annotations\Spurious_copper\11_spurious_copper_10;0.3139789658194566;0.7468861209964412;87;94;2282;2248;0.03812445223488168;0.04181494661921708;.\data\pcb_defects_kaggle\images/Spurious_copper/11_spurious_copper_10.jpg;6
2901;spurious_copper;1416;1940;1534;1998;.\data\pcb_defects_kaggle\Annotations\Spurious_copper\11_spurious_copper_10;0.6463628396143734;0.8758896797153025;118;58;2282;2248;0.051709027169149865;0.025800711743772242;.\data\pcb_defects_kaggle\images/Spurious_copper/11_spurious_copper_10.jpg;6
2902;spurious_copper;1661;2040;1804;2104;.\data\pcb_defects_kaggle\Annotations\Spurious_copper\11_spurious_copper_10;0.75920245398773;0.9217081850533808;143;64;2282;2248;0.06266432953549518;0.028469750889679714;.\data\pcb_defects_kaggle\images/Spurious_copper/11_spurious_copper_10.jpg;6
2903;spurious_copper;1629;577;1680;654;.\data\pcb_defects_kaggle\Annotations\Spurious_copper\12_spurious_copper_01;0.6542111506524317;0.2432806324110672;51;77;2529;2530;0.020166073546856466;0.030434782608695653;.\data\pcb_defects_kaggle\images/Spurious_copper/12_spurious_copper_01.jpg;6
2904;spurious_copper;1842;1419;1880;1521;.\data\pcb_defects_kaggle\Annotations\Spurious_copper\12_spurious_copper_01;0.7358639778568604;0.5810276679841897;38;102;2529;2530;0.015025701858442072;0.04031620553359684;.\data\pcb_defects_kaggle\images/Spurious_copper/12_spurious_copper_01.jpg;6
2905;spurious_copper;727;1639;842;1683;.\data\pcb_defects_kaggle\Annotations\Spurious_copper\12_spurious_copper_01;0.31020166073546857;0.6565217391304348;115;44;2529;2530;0.045472518782127325;0.017391304347826087;.\data\pcb_defects_kaggle\images/Spurious_copper/12_spurious_copper_01.jpg;6
2906;spurious_copper;1666;1859;1791;1908;.\data\pcb_defects_kaggle\Annotations\Spurious_copper\12_spurious_copper_01;0.6834717279557138;0.7444664031620554;125;49;2529;2530;0.04942665085013839;0.019367588932806323;.\data\pcb_defects_kaggle\images/Spurious_copper/12_spurious_copper_01.jpg;6
2907;spurious_copper;1489;2263;1607;2312;.\data\pcb_defects_kaggle\Annotations\Spurious_copper\12_spurious_copper_01;0.6120996441281139;0.9041501976284585;118;49;2529;2530;0.04665875840253064;0.019367588932806323;.\data\pcb_defects_kaggle\images/Spurious_copper/12_spurious_copper_01.jpg;6
2908;spurious_copper;1346;248;1397;359;.\data\pcb_defects_kaggle\Annotations\Spurious_copper\12_spurious_copper_02;0.5423092131277185;0.1199604743083004;51;111;2529;2530;0.020166073546856466;0.04387351778656127;.\data\pcb_defects_kaggle\images/Spurious_copper/12_spurious_copper_02.jpg;6
2909;spurious_copper;1962;124;2080;168;.\data\pcb_defects_kaggle\Annotations\Spurious_copper\12_spurious_copper_02;0.7991300909450376;0.057707509881422925;118;44;2529;2530;0.04665875840253064;0.017391304347826087;.\data\pcb_defects_kaggle\images/Spurious_copper/12_spurious_copper_02.jpg;6
2910;spurious_copper;913;1050;1006;1090;.\data\pcb_defects_kaggle\Annotations\Spurious_copper\12_spurious_copper_02;0.3793989719256623;0.42292490118577075;93;40;2529;2530;0.036773428232502965;0.015810276679841896;.\data\pcb_defects_kaggle\images/Spurious_copper/12_spurious_copper_02.jpg;6
2911;spurious_copper;1984;1415;2037;1501;.\data\pcb_defects_kaggle\Annotations\Spurious_copper\12_spurious_copper_02;0.794978252273626;0.5762845849802372;53;86;2529;2530;0.02095689996045868;0.03399209486166008;.\data\pcb_defects_kaggle\images/Spurious_copper/12_spurious_copper_02.jpg;6
2912;spurious_copper;2295;997;2347;1081;.\data\pcb_defects_kaggle\Annotations\Spurious_copper\12_spurious_copper_02;0.9177540529853697;0.4106719367588933;52;84;2529;2530;0.02056148675365757;0.03320158102766799;.\data\pcb_defects_kaggle\images/Spurious_copper/12_spurious_copper_02.jpg;6
2913;spurious_copper;2197;323;2240;399;.\data\pcb_defects_kaggle\Annotations\Spurious_copper\12_spurious_copper_03;0.8772241992882562;0.14268774703557313;43;76;2529;2530;0.017002767892447607;0.030039525691699605;.\data\pcb_defects_kaggle\images/Spurious_copper/12_spurious_copper_03.jpg;6
2914;spurious_copper;907;1041;1006;1097;.\data\pcb_defects_kaggle\Annotations\Spurious_copper\12_spurious_copper_03;0.378212732305259;0.4225296442687747;99;56;2529;2530;0.03914590747330961;0.022134387351778657;.\data\pcb_defects_kaggle\images/Spurious_copper/12_spurious_copper_03.jpg;6
2915;spurious_copper;2091;1221;2184;1261;.\data\pcb_defects_kaggle\Annotations\Spurious_copper\12_spurious_copper_03;0.8451957295373665;0.49051383399209486;93;40;2529;2530;0.036773428232502965;0.015810276679841896;.\data\pcb_defects_kaggle\images/Spurious_copper/12_spurious_copper_03.jpg;6
2916;spurious_copper;2358;1654;2397;1735;.\data\pcb_defects_kaggle\Annotations\Spurious_copper\12_spurious_copper_03;0.9400948991696323;0.6697628458498024;39;81;2529;2530;0.01542111506524318;0.032015810276679844;.\data\pcb_defects_kaggle\images/Spurious_copper/12_spurious_copper_03.jpg;6
2917;spurious_copper;609;706;707;764;.\data\pcb_defects_kaggle\Annotations\Spurious_copper\12_spurious_copper_03;0.2601818900751285;0.29051383399209485;98;58;2529;2530;0.0387504942665085;0.02292490118577075;.\data\pcb_defects_kaggle\images/Spurious_copper/12_spurious_copper_03.jpg;6
2918;spurious_copper;1391;686;1447;790;.\data\pcb_defects_kaggle\Annotations\Spurious_copper\12_spurious_copper_04;0.561091340450771;0.291699604743083;56;104;2529;2530;0.022143139580862;0.04110671936758893;.\data\pcb_defects_kaggle\images/Spurious_copper/12_spurious_copper_04.jpg;6
2919;spurious_copper;1935;750;1986;854;.\data\pcb_defects_kaggle\Annotations\Spurious_copper\12_spurious_copper_04;0.7752075919335706;0.31699604743083004;51;104;2529;2530;0.020166073546856466;0.04110671936758893;.\data\pcb_defects_kaggle\images/Spurious_copper/12_spurious_copper_04.jpg;6
2920;spurious_copper;984;1646;1095;1688;.\data\pcb_defects_kaggle\Annotations\Spurious_copper\12_spurious_copper_04;0.4110320284697509;0.658893280632411;111;42;2529;2530;0.04389086595492289;0.016600790513833993;.\data\pcb_defects_kaggle\images/Spurious_copper/12_spurious_copper_04.jpg;6
2921;spurious_copper;591;1508;677;1557;.\data\pcb_defects_kaggle\Annotations\Spurious_copper\12_spurious_copper_04;0.25069197311190194;0.6057312252964426;86;49;2529;2530;0.034005535784895215;0.019367588932806323;.\data\pcb_defects_kaggle\images/Spurious_copper/12_spurious_copper_04.jpg;6
2922;spurious_copper;427;1063;509;1123;.\data\pcb_defects_kaggle\Annotations\Spurious_copper\12_spurious_copper_04;0.18505338078291814;0.43201581027667985;82;60;2529;2530;0.03242388295769079;0.023715415019762844;.\data\pcb_defects_kaggle\images/Spurious_copper/12_spurious_copper_04.jpg;6
2923;spurious_copper;1491;1550;1600;1595;.\data\pcb_defects_kaggle\Annotations\Spurious_copper\12_spurious_copper_05;0.6111111111111112;0.6215415019762845;109;45;2529;2530;0.04310003954132068;0.017786561264822136;.\data\pcb_defects_kaggle\images/Spurious_copper/12_spurious_copper_05.jpg;6
2924;spurious_copper;1169;1648;1287;1694;.\data\pcb_defects_kaggle\Annotations\Spurious_copper\12_spurious_copper_05;0.48556741795175956;0.6604743083003952;118;46;2529;2530;0.04665875840253064;0.01818181818181818;.\data\pcb_defects_kaggle\images/Spurious_copper/12_spurious_copper_05.jpg;6
2925;spurious_copper;1933;1435;1973;1519;.\data\pcb_defects_kaggle\Annotations\Spurious_copper\12_spurious_copper_05;0.7722419928825622;0.583794466403162;40;84;2529;2530;0.015816528272044286;0.03320158102766799;.\data\pcb_defects_kaggle\images/Spurious_copper/12_spurious_copper_05.jpg;6
2926;spurious_copper;1086;1854;1180;1901;.\data\pcb_defects_kaggle\Annotations\Spurious_copper\12_spurious_copper_05;0.44800316330565443;0.7420948616600791;94;47;2529;2530;0.03716884143930407;0.01857707509881423;.\data\pcb_defects_kaggle\images/Spurious_copper/12_spurious_copper_05.jpg;6
2927;spurious_copper;84;1844;142;1954;.\data\pcb_defects_kaggle\Annotations\Spurious_copper\12_spurious_copper_05;0.04468169236852511;0.7505928853754941;58;110;2529;2530;0.022933965994464216;0.043478260869565216;.\data\pcb_defects_kaggle\images/Spurious_copper/12_spurious_copper_05.jpg;6
2928;spurious_copper;1337;495;1400;599;.\data\pcb_defects_kaggle\Annotations\Spurious_copper\12_spurious_copper_06;0.5411229735073152;0.21620553359683795;63;104;2529;2530;0.02491103202846975;0.04110671936758893;.\data\pcb_defects_kaggle\images/Spurious_copper/12_spurious_copper_06.jpg;6
2929;spurious_copper;1724;1415;1780;1510;.\data\pcb_defects_kaggle\Annotations\Spurious_copper\12_spurious_copper_06;0.6927639383155397;0.5780632411067194;56;95;2529;2530;0.022143139580862;0.037549407114624504;.\data\pcb_defects_kaggle\images/Spurious_copper/12_spurious_copper_06.jpg;6
2930;spurious_copper;2346;1641;2404;1768;.\data\pcb_defects_kaggle\Annotations\Spurious_copper\12_spurious_copper_06;0.9391063661526295;0.6737154150197628;58;127;2529;2530;0.022933965994464216;0.050197628458498025;.\data\pcb_defects_kaggle\images/Spurious_copper/12_spurious_copper_06.jpg;6
2931;spurious_copper;2144;1855;2251;1906;.\data\pcb_defects_kaggle\Annotations\Spurious_copper\12_spurious_copper_06;0.868920521945433;0.7432806324110672;107;51;2529;2530;0.042309213127718466;0.02015810276679842;.\data\pcb_defects_kaggle\images/Spurious_copper/12_spurious_copper_06.jpg;6
2932;spurious_copper;2151;1063;2247;1121;.\data\pcb_defects_kaggle\Annotations\Spurious_copper\12_spurious_copper_06;0.8695136417556346;0.4316205533596838;96;58;2529;2530;0.03795966785290629;0.02292490118577075;.\data\pcb_defects_kaggle\images/Spurious_copper/12_spurious_copper_06.jpg;6
2933;spurious_copper;1115;1643;1182;1686;.\data\pcb_defects_kaggle\Annotations\Spurious_copper\12_spurious_copper_07;0.4541320680110716;0.6579051383399209;67;43;2529;2530;0.02649268485567418;0.01699604743083004;.\data\pcb_defects_kaggle\images/Spurious_copper/12_spurious_copper_07.jpg;6
2934;spurious_copper;257;1595;357;1646;.\data\pcb_defects_kaggle\Annotations\Spurious_copper\12_spurious_copper_07;0.12139185448793989;0.6405138339920948;100;51;2529;2530;0.039541320680110716;0.02015810276679842;.\data\pcb_defects_kaggle\images/Spurious_copper/12_spurious_copper_07.jpg;6
2935;spurious_copper;2106;1810;2231;1861;.\data\pcb_defects_kaggle\Annotations\Spurious_copper\12_spurious_copper_07;0.8574535389482009;0.7254940711462451;125;51;2529;2530;0.04942665085013839;0.02015810276679842;.\data\pcb_defects_kaggle\images/Spurious_copper/12_spurious_copper_07.jpg;6
2936;spurious_copper;1677;1428;1726;1506;.\data\pcb_defects_kaggle\Annotations\Spurious_copper\12_spurious_copper_07;0.6727955713720838;0.5798418972332016;49;78;2529;2530;0.01937524713325425;0.0308300395256917;.\data\pcb_defects_kaggle\images/Spurious_copper/12_spurious_copper_07.jpg;6
2937;spurious_copper;2035;1215;2137;1266;.\data\pcb_defects_kaggle\Annotations\Spurious_copper\12_spurious_copper_07;0.8248319493871096;0.49031620553359684;102;51;2529;2530;0.04033214709371293;0.02015810276679842;.\data\pcb_defects_kaggle\images/Spurious_copper/12_spurious_copper_07.jpg;6
2938;spurious_copper;2253;679;2293;777;.\data\pcb_defects_kaggle\Annotations\Spurious_copper\12_spurious_copper_08;0.8987742190589165;0.28774703557312253;40;98;2529;2530;0.015816528272044286;0.03873517786561265;.\data\pcb_defects_kaggle\images/Spurious_copper/12_spurious_copper_08.jpg;6
2939;spurious_copper;1829;1424;1880;1514;.\data\pcb_defects_kaggle\Annotations\Spurious_copper\12_spurious_copper_08;0.7332937920126532;0.5806324110671937;51;90;2529;2530;0.020166073546856466;0.03557312252964427;.\data\pcb_defects_kaggle\images/Spurious_copper/12_spurious_copper_08.jpg;6
2940;spurious_copper;2364;1801;2395;1886;.\data\pcb_defects_kaggle\Annotations\Spurious_copper\12_spurious_copper_08;0.9408857255832345;0.7286561264822135;31;85;2529;2530;0.012257809410834321;0.03359683794466403;.\data\pcb_defects_kaggle\images/Spurious_copper/12_spurious_copper_08.jpg;6
2941;spurious_copper;1726;2266;1827;2319;.\data\pcb_defects_kaggle\Annotations\Spurious_copper\12_spurious_copper_08;0.7024515618821668;0.9061264822134387;101;53;2529;2530;0.039936733886911824;0.020948616600790514;.\data\pcb_defects_kaggle\images/Spurious_copper/12_spurious_copper_08.jpg;6
2942;spurious_copper;795;1174;878;1221;.\data\pcb_defects_kaggle\Annotations\Spurious_copper\12_spurious_copper_08;0.33076314748912616;0.4733201581027668;83;47;2529;2530;0.0328192961644919;0.01857707509881423;.\data\pcb_defects_kaggle\images/Spurious_copper/12_spurious_copper_08.jpg;6
2943;spurious_copper;1938;388;1986;490;.\data\pcb_defects_kaggle\Annotations\Spurious_copper\12_spurious_copper_09;0.7758007117437722;0.17351778656126482;48;102;2529;2530;0.018979833926453145;0.04031620553359684;.\data\pcb_defects_kaggle\images/Spurious_copper/12_spurious_copper_09.jpg;6
2944;spurious_copper;2044;1515;2153;1563;.\data\pcb_defects_kaggle\Annotations\Spurious_copper\12_spurious_copper_09;0.8297746144721234;0.608300395256917;109;48;2529;2530;0.04310003954132068;0.018972332015810278;.\data\pcb_defects_kaggle\images/Spurious_copper/12_spurious_copper_09.jpg;6
2945;spurious_copper;1580;1804;1726;1855;.\data\pcb_defects_kaggle\Annotations\Spurious_copper\12_spurious_copper_09;0.6536180308422301;0.7231225296442688;146;51;2529;2530;0.057730328192961644;0.02015810276679842;.\data\pcb_defects_kaggle\images/Spurious_copper/12_spurious_copper_09.jpg;6
2946;spurious_copper;537;1635;635;1684;.\data\pcb_defects_kaggle\Annotations\Spurious_copper\12_spurious_copper_09;0.2317121391854488;0.6559288537549407;98;49;2529;2530;0.0387504942665085;0.019367588932806323;.\data\pcb_defects_kaggle\images/Spurious_copper/12_spurious_copper_09.jpg;6
2947;spurious_copper;2300;994;2349;1084;.\data\pcb_defects_kaggle\Annotations\Spurious_copper\12_spurious_copper_09;0.9191379992091736;0.4106719367588933;49;90;2529;2530;0.01937524713325425;0.03557312252964427;.\data\pcb_defects_kaggle\images/Spurious_copper/12_spurious_copper_09.jpg;6
2948;spurious_copper;1777;334;1831;426;.\data\pcb_defects_kaggle\Annotations\Spurious_copper\12_spurious_copper_10;0.7133254250691973;0.15019762845849802;54;92;2529;2530;0.021352313167259787;0.03636363636363636;.\data\pcb_defects_kaggle\images/Spurious_copper/12_spurious_copper_10.jpg;6
2949;spurious_copper;1395;935;1457;992;.\data\pcb_defects_kaggle\Annotations\Spurious_copper\12_spurious_copper_10;0.5638592328983788;0.3808300395256917;62;57;2529;2530;0.024515618821668642;0.022529644268774702;.\data\pcb_defects_kaggle\images/Spurious_copper/12_spurious_copper_10.jpg;6
2950;spurious_copper;1837;1441;1871;1530;.\data\pcb_defects_kaggle\Annotations\Spurious_copper\12_spurious_copper_10;0.7330960854092526;0.5871541501976285;34;89;2529;2530;0.013444049031237644;0.03517786561264822;.\data\pcb_defects_kaggle\images/Spurious_copper/12_spurious_copper_10.jpg;6
2951;spurious_copper;1078;1854;1171;1901;.\data\pcb_defects_kaggle\Annotations\Spurious_copper\12_spurious_copper_10;0.444642151047845;0.7420948616600791;93;47;2529;2530;0.036773428232502965;0.01857707509881423;.\data\pcb_defects_kaggle\images/Spurious_copper/12_spurious_copper_10.jpg;6
2952;spurious_copper;311;1632;395;1684;.\data\pcb_defects_kaggle\Annotations\Spurious_copper\12_spurious_copper_10;0.13958086200079084;0.6553359683794466;84;52;2529;2530;0.033214709371293;0.020553359683794466;.\data\pcb_defects_kaggle\images/Spurious_copper/12_spurious_copper_10.jpg;6
